hive,treatment,tray,dish,start_touch,end_touch,touch_duration,notes
Garden,Solvent control,20,2,65,69,4,
Garden,Solvent control,20,2,118,119,1,
Garden,Solvent control,20,2,167,167,0,"bee sort of pushed in to paper, not sure if it counts"
Garden,Solvent control,20,2,219,220,1,
Garden,Solvent control,20,2,287,293,6,
Garden,Solvent control,20,2,309,310,1,
Garden,Solvent control,20,2,516,516,0,
Garden,Solvent control,20,2,532,532,0,
Garden,Solvent control,20,2,549,558,9,
Garden,Solvent control,20,2,625,627,2,
Garden,Solvent control,20,2,643,643,0,
Garden,Solvent control,20,2,676,678,2,
Garden,Solvent control,20,2,701,701,0,
Garden,Solvent control,20,2,840,842,2,
Garden,Solvent control,20,2,906,907,1,
Garden,Solvent control,20,2,910,911,1,
Garden,Solvent control,20,2,1027,1028,1,bee sort of walks over the paper
Garden,Solvent control,20,2,1082,1083,1,
Garden,Solvent control,20,2,1154,1154,0,
Garden,Solvent control,20,2,1169,1169,0,
Garden,Solvent control,20,2,1182,1194,12,
Garden,Solvent control,20,2,1137,1148,11,bee sitting on top of paper
Garden,Solvent control,20,2,1217,1218,1,
Garden,Solvent control,20,2,1241,1241,0,
Garden,Solvent control,20,2,1407,1407,0,
Garden,Solvent control,20,2,1490,1491,1,
Garden,Solvent control,20,2,1591,1601,10,bee sits on paper for most of this time
Garden,Solvent control,20,2,1607,1616,9,
Garden,Solvent control,20,2,1618,1619,1,
Garden,Solvent control,20,2,1660,1661,1,
Garden,Solvent control,20,2,1666,1678,12,
Garden,Solvent control,20,2,1679,1681,2,
Garden,Solvent control,20,2,1755,1758,3,
Garden,Solvent control,21,12,23,23,0,
Garden,Solvent control,21,12,57,58,1,
Garden,Solvent control,21,12,69,70,1,
Garden,Solvent control,21,12,110,112,2,
Garden,Solvent control,21,12,149,151,2,
Garden,Solvent control,21,12,167,168,1,
Garden,Solvent control,21,12,286,292,6,
Garden,Solvent control,21,12,292,292,0,
Garden,Solvent control,21,12,295,298,3,
Garden,Solvent control,21,12,324,327,3,"bee sits at a distance facing paper, sort of seems interrested, not sure if it counts"
Garden,Solvent control,21,12,340,341,1,
Garden,Solvent control,21,12,380,380,0,
Garden,Solvent control,21,12,617,617,0,
Garden,Solvent control,21,12,755,755,0,
Garden,Solvent control,21,12,756,758,2,
Garden,Solvent control,21,12,873,881,8,
Garden,Solvent control,21,12,952,954,2,
Garden,Solvent control,21,12,1054,1054,0,
Garden,Solvent control,21,12,1078,1079,1,
Garden,Solvent control,21,12,1214,1214,0,
Garden,Solvent control,21,12,1402,1405,3,
Garden,Solvent control,21,12,1525,1525,0,
Garden,Solvent control,21,12,1545,1546,1,
Garden,Solvent control,21,12,1657,1657,0,
Garden,Solvent control,22,2,0,22,22,bee sitting on top of paper
Garden,Solvent control,22,2,19,19,0,
Garden,Solvent control,22,2,132,135,3,
Garden,Solvent control,22,2,142,143,1,
Garden,Solvent control,22,2,200,201,1,
Garden,Solvent control,22,2,233,234,1,
Garden,Solvent control,22,2,317,317,0,
Garden,Solvent control,22,2,408,408,0,
Garden,Solvent control,22,2,597,600,3,
Garden,Solvent control,22,2,676,678,2,
Garden,Solvent control,22,2,903,903,0,
Garden,Solvent control,22,2,969,971,2,
Garden,Solvent control,22,2,978,979,1,
Garden,Solvent control,22,2,1295,1297,2,bee not touching but seems interrested
Garden,Solvent control,22,2,1665,1672,7,
Garden,Solvent control,22,2,1766,1766,0,
Garden,Solvent control,24,11,6,7,1,
Garden,Solvent control,24,11,15,15,0,
Garden,Solvent control,24,11,19,22,3,
Garden,Solvent control,24,11,28,28,0,
Garden,Solvent control,24,11,40,41,1,
Garden,Solvent control,24,11,72,72,0,
Garden,Solvent control,24,11,90,90,0,
Garden,Solvent control,24,11,101,101,0,
Garden,Solvent control,24,11,120,120,0,
Garden,Solvent control,24,11,123,125,2,
Garden,Solvent control,24,11,166,166,0,
Garden,Solvent control,24,11,168,170,2,
Garden,Solvent control,24,11,181,181,0,
Garden,Solvent control,24,11,207,207,0,
Garden,Solvent control,24,11,214,228,14,
Garden,Solvent control,24,11,356,356,0,
Garden,Solvent control,24,11,370,426,56,
Garden,Solvent control,24,11,441,480,39,
Garden,Solvent control,24,11,486,486,0,
Garden,Solvent control,24,11,497,499,2,
Garden,Solvent control,24,11,499,499,0,
Garden,Solvent control,24,11,522,522,0,
Garden,Solvent control,24,11,542,543,1,
Garden,Solvent control,24,11,606,606,0,
Garden,Solvent control,24,11,664,665,1,
Garden,Solvent control,24,11,693,695,2,
Garden,Solvent control,24,11,695,695,0,
Garden,Solvent control,24,11,787,787,0,
Garden,Solvent control,24,11,865,865,0,
Garden,Solvent control,24,11,893,895,2,
Garden,Solvent control,24,11,908,910,2,
Garden,Solvent control,24,11,933,936,3,
Garden,Solvent control,24,11,980,980,0,
Garden,Solvent control,24,11,1009,1009,0,
Garden,Solvent control,24,11,1019,1019,0,
Garden,Solvent control,24,11,1071,1072,1,
Garden,Solvent control,24,11,1246,1246,0,
Garden,Solvent control,24,11,1254,1254,0,
Garden,Solvent control,24,11,1261,1262,1,
Garden,Solvent control,24,11,1274,1280,6,
Garden,Solvent control,24,11,1296,1298,2,
Garden,Solvent control,24,11,1329,1329,0,
Garden,Solvent control,24,11,1393,1393,0,
Garden,Solvent control,24,11,1470,1471,1,
Garden,Solvent control,24,11,1506,1506,0,
Garden,Solvent control,24,11,1541,1543,2,
Garden,Solvent control,24,11,1545,1555,10,
Garden,Solvent control,24,11,1597,1599,2,
Garden,Solvent control,24,11,1680,1680,0,
Garden,Solvent control,24,11,1739,1741,2,
Garden,Solvent control,24,11,1789,1789,0,
Garden,Solvent control,25,7,67,68,1,
Garden,Solvent control,25,7,325,328,3,
Garden,Solvent control,25,7,346,351,5,
Garden,Solvent control,25,7,389,393,4,
Garden,Solvent control,25,7,531,537,6,bee sort of far away from paper but sniffing it I think
Garden,Solvent control,25,7,657,657,0,
Garden,Solvent control,25,7,658,658,0,
Garden,Solvent control,25,7,689,692,3,bee sort of far away from paper but sniffing it I think
Garden,Solvent control,25,7,724,725,1,
Garden,Solvent control,25,7,777,778,1,
Garden,Solvent control,25,7,848,849,1,
Garden,Solvent control,25,7,876,877,1,
Garden,Solvent control,25,7,907,907,0,
Garden,Solvent control,25,7,1048,1048,0,
Garden,Solvent control,25,7,1165,1165,0,
Garden,Solvent control,25,7,1289,1291,2,
Garden,Solvent control,25,7,1446,1446,0,
Garden,Solvent control,25,7,1458,1460,2,
Garden,Solvent control,25,7,1522,1522,0,
Garden,Solvent control,25,7,1560,1561,1,
Garden,Solvent control,25,7,1574,1574,0,
Garden,Solvent control,25,7,1597,1597,0,
Garden,Solvent control,25,7,1639,1639,0,
Garden,Solvent control,25,7,1643,1644,1,
Garden,Solvent control,25,7,1660,1660,0,
Garden,Solvent control,25,7,1692,1692,0,
Garden,Solvent control,25,7,1712,1712,0,
Garden,Solvent control,25,7,1742,1746,4,
Garden,Solvent control,25,7,1750,1750,0,
Garden,Solvent control,25,7,1753,1754,1,
Garden,Solvent control,25,7,1755,1756,1,
Garden,Solvent control,25,7,1763,1763,0,
Garden,Solvent control,26,12,13,27,14,
Garden,Solvent control,26,12,40,43,3,
Garden,Solvent control,26,12,46,62,16,from 0:52 to 1:02 the bee sort of just sits on the paper - it does move around bit it is not sniffing
Garden,Solvent control,26,12,57,70,13,
Garden,Solvent control,26,12,79,86,7,moves around on top of paper
Garden,Solvent control,26,12,89,116,27,sniffs and them moves around on paper or really close next to it
Garden,Solvent control,26,12,111,121,10,
Garden,Solvent control,26,12,144,146,2,
Garden,Solvent control,26,12,167,169,2,
Garden,Solvent control,26,12,224,235,11,
Garden,Solvent control,26,12,225,226,1,
Garden,Solvent control,26,12,238,244,6,
Garden,Solvent control,26,12,240,251,11,
Garden,Solvent control,26,12,256,260,4,
Garden,Solvent control,26,12,271,281,10,
Garden,Solvent control,26,12,408,409,1,
Garden,Solvent control,26,12,450,458,8,
Garden,Solvent control,26,12,455,459,4,
Garden,Solvent control,26,12,464,466,2,
Garden,Solvent control,26,12,500,508,8,
Garden,Solvent control,26,12,553,555,2,
Garden,Solvent control,26,12,560,563,3,
Garden,Solvent control,26,12,647,647,0,
Garden,Solvent control,26,12,686,689,3,
Garden,Solvent control,26,12,726,728,2,
Garden,Solvent control,26,12,745,746,1,
Garden,Solvent control,26,12,749,751,2,
Garden,Solvent control,26,12,794,794,0,
Garden,Solvent control,26,12,830,830,0,
Garden,Solvent control,26,12,850,851,1,
Garden,Solvent control,26,12,982,984,2,
Garden,Solvent control,26,12,988,990,2,
Garden,Solvent control,26,12,1009,1009,0,
Garden,Solvent control,26,12,1044,1046,2,
Garden,Solvent control,26,12,1084,1084,0,
Garden,Solvent control,26,12,1189,1191,2,
Garden,Solvent control,26,12,1246,1248,2,
Garden,Solvent control,26,12,1266,1267,1,
Garden,Solvent control,26,12,1294,1295,1,
Garden,Solvent control,26,12,1309,1309,0,
Garden,Solvent control,26,12,1291,1291,0,
Garden,Solvent control,26,12,1355,1359,4,
Garden,Solvent control,26,12,1362,1364,2,
Garden,Solvent control,26,12,1368,1370,2,
Garden,Solvent control,26,12,1425,1426,1,
Garden,Solvent control,26,12,1484,1484,0,
Garden,Solvent control,26,12,1591,1592,1,
Garden,Solvent control,26,12,1637,1637,0,
Garden,Solvent control,26,12,1652,1652,0,
Garden,Solvent control,26,12,1658,1660,2,
Garden,Solvent control,26,12,1762,1762,0,
Garden,Solvent control,28,2,259,261,2,
Garden,Solvent control,28,2,322,323,1,
Garden,Solvent control,28,2,415,415,0,
Garden,Solvent control,28,2,493,494,1,
Garden,Solvent control,28,2,552,552,0,
Garden,Solvent control,28,2,921,923,2,
Garden,Solvent control,28,2,1237,1237,0,
Garden,Solvent control,28,2,1248,1250,2,
Garden,Solvent control,28,2,1297,1297,0,
Garden,Solvent control,28,2,1301,1302,1,
Garden,Solvent control,28,2,1792,1792,0,
Garden,Solvent control,29,4,19,19,0,
Garden,Solvent control,29,4,102,102,0,
Garden,Solvent control,29,4,106,106,0,
Garden,Solvent control,29,4,174,174,0,
Garden,Solvent control,29,4,212,212,0,
Garden,Solvent control,29,4,231,231,0,
Garden,Solvent control,29,4,285,285,0,
Garden,Solvent control,29,4,371,371,0,
Garden,Solvent control,29,4,392,394,2,
Garden,Solvent control,29,4,392,396,4,
Garden,Solvent control,29,4,445,445,0,
Garden,Solvent control,29,4,470,470,0,
Garden,Solvent control,29,4,472,472,0,
Garden,Solvent control,29,4,554,557,3,
Garden,Solvent control,29,4,605,605,0,
Garden,Solvent control,29,4,667,667,0,
Garden,Solvent control,29,4,677,677,0,
Garden,Solvent control,29,4,720,720,0,
Garden,Solvent control,29,4,760,760,0,
Garden,Solvent control,29,4,762,762,0,
Garden,Solvent control,29,4,956,956,0,
Garden,Solvent control,29,4,959,959,0,
Garden,Solvent control,29,4,1085,1087,2,
Garden,Solvent control,29,4,1177,1178,1,
Garden,Solvent control,29,4,1185,1186,1,
Garden,Solvent control,29,4,1206,1207,1,
Garden,Solvent control,29,4,1301,1301,0,
Garden,Solvent control,29,4,1334,1335,1,
Garden,Solvent control,29,4,1359,1361,2,
Garden,Solvent control,29,4,1385,1387,2,
Garden,Solvent control,29,4,1446,1447,1,
Garden,Solvent control,29,4,1459,1460,1,
Garden,Solvent control,29,4,1471,1472,1,
Garden,Solvent control,29,4,1505,1506,1,
Garden,Solvent control,29,4,1544,1544,0,
Garden,Solvent control,29,4,1590,1592,2,
Garden,Solvent control,29,4,1648,1649,1,
Garden,Solvent control,29,4,1731,1732,1,
Garden,Solvent control,29,4,1746,1746,0,
Garden,Solvent control,29,4,1772,1781,9,
Garden,Solvent control,30,6,46,46,0,
Garden,Solvent control,30,6,150,150,0,
Garden,Solvent control,30,6,290,290,0,
Garden,Solvent control,30,6,298,301,3,
Garden,Solvent control,30,6,349,349,0,
Garden,Solvent control,30,6,439,442,3,
Garden,Solvent control,30,6,450,450,0,
Garden,Solvent control,30,6,519,519,0,
Garden,Solvent control,30,6,574,574,0,
Garden,Solvent control,30,6,619,620,1,
Garden,Solvent control,30,6,678,687,9,
Garden,Solvent control,30,6,711,713,2,
Garden,Solvent control,30,6,982,986,4,
Garden,Solvent control,30,6,1044,1050,6,
Garden,Solvent control,30,6,1398,1398,0,
Garden,Solvent control,30,6,1484,1484,0,
Garden,Solvent control,30,6,1631,1651,20,
Garden,Solvent control,30,6,1697,1702,5,
Garden,Solvent control,30,6,1783,1783,0,
Garden,Solvent control,31,12,11,11,0,
Garden,Solvent control,31,12,52,52,0,
Garden,Solvent control,31,12,68,70,2,
Garden,Solvent control,31,12,281,284,3,
Garden,Solvent control,31,12,393,393,0,
Garden,Solvent control,31,12,430,430,0,
Garden,Solvent control,31,12,439,439,0,
Garden,Solvent control,31,12,526,526,0,
Garden,Solvent control,31,12,538,539,1,
Garden,Solvent control,31,12,571,571,0,
Garden,Solvent control,31,12,544,544,0,
Garden,Solvent control,31,12,551,567,16,mucking round right near the paper
Garden,Solvent control,31,12,591,594,3,
Garden,Solvent control,31,12,621,623,2,
Garden,Solvent control,31,12,663,665,2,
Garden,Solvent control,31,12,686,686,0,
Garden,Solvent control,31,12,799,799,0,
Garden,Solvent control,31,12,818,818,0,
Garden,Solvent control,31,12,833,833,0,
Garden,Solvent control,31,12,1247,1247,0,
Garden,Solvent control,31,12,1431,1431,0,
Garden,Solvent control,31,12,1462,1462,0,
Garden,Solvent control,31,12,1508,1508,0,
Garden,Solvent control,31,12,1579,1582,3,
Garden,Solvent control,31,12,1707,1709,2,
Garden,Solvent control,31,12,1794,1795,1,
Garden,Solvent control,31,12,1140,1143,3,"seems interrested, not too sure though. Not actually touching"
Garden,Solvent control,33,2,5,5,0,
Garden,Solvent control,33,2,17,18,1,
Garden,Solvent control,33,2,34,36,2,
Garden,Solvent control,33,2,174,180,6,
Garden,Solvent control,33,2,210,210,0,
Garden,Solvent control,33,2,238,238,0,7:58 Trophallaxis
Garden,Solvent control,33,2,556,557,1,bee brushes past paper - definitely touched don't know if it counts
Garden,Solvent control,33,2,587,587,0,
Garden,Solvent control,33,2,662,662,0,
Garden,Solvent control,33,2,695,698,3,bee brushes past paper - definitely touched don't know if it counts
Garden,Solvent control,33,2,772,772,0,bee brushes past paper - definitely touched don't know if it counts
Garden,Solvent control,33,2,812,813,1,bee brushes past paper - definitely touched don't know if it counts
Garden,Solvent control,33,2,856,856,0,not sure
Garden,Solvent control,33,2,860,860,0,
Garden,Solvent control,33,2,903,903,0,
Garden,Solvent control,33,2,909,909,0,15:37 Trophallaxis
Garden,Solvent control,33,2,1166,1169,3,
Garden,Solvent control,33,2,1313,1313,0,
Garden,Solvent control,33,2,1381,1381,0,
Garden,Solvent control,33,2,1470,1470,0,
Garden,Solvent control,33,2,1486,1486,0,
Garden,Solvent control,33,2,1552,1615,63,
Garden,Solvent control,33,2,1647,1647,0,
Garden,Solvent control,33,2,1673,1676,3,bee moves paper with legs - actually seems interrested in it though?
Garden,Solvent control,33,2,1692,1692,0,
Garden,Solvent control,33,2,1715,1715,0,
Garden,Solvent control,33,2,1733,1734,1,
Garden,Solvent control,33,2,1752,1752,0,
Garden,Solvent control,33,2,1761,1761,0,
Garden,Solvent control,33,2,1768,1768,0,
Garden,Solvent control,33,2,1776,1778,2,
Garden,Solvent control,34,8,36,36,0,
Garden,Solvent control,34,8,62,62,0,
Garden,Solvent control,34,8,128,128,0,leg touch
Garden,Solvent control,34,8,150,150,0,
Garden,Solvent control,34,8,289,289,0,
Garden,Solvent control,34,8,396,396,0,
Garden,Solvent control,34,8,576,576,0,
Garden,Solvent control,34,8,703,704,1,
Garden,Solvent control,34,8,705,705,0,
Garden,Solvent control,34,8,734,734,0,
Garden,Solvent control,34,8,793,793,0,
Garden,Solvent control,34,8,801,801,0,
Garden,Solvent control,34,8,861,861,0,
Garden,Solvent control,34,8,899,899,0,
Garden,Solvent control,34,8,912,912,0,moves paper with a leg
Garden,Solvent control,34,8,933,933,0,walks past very close and turns its head towards paper
Garden,Solvent control,35,10,3,5,2,
Garden,Solvent control,35,10,43,43,0,
Garden,Solvent control,35,10,124,125,1,"Bee walks past and moves the paper with its leggs, doesn't stop"
Garden,Solvent control,35,10,149,149,0,
Garden,Solvent control,35,10,176,176,0,
Garden,Solvent control,35,10,287,287,0,
Garden,Solvent control,35,10,334,334,0,
Garden,Solvent control,35,10,408,408,0,
Garden,Solvent control,35,10,441,441,0,Moves with leg maybe on accident
Garden,Solvent control,35,10,446,446,0,
Garden,Solvent control,35,10,455,455,0,
Garden,Solvent control,35,10,486,486,0,
Garden,Solvent control,35,10,505,505,0,
Garden,Solvent control,35,10,549,549,0,
Garden,Solvent control,35,10,559,562,3,
Garden,Solvent control,35,10,562,572,10,Pushed in to it near end of interraction with paper - not sure if it meant to stay there this long
Garden,Solvent control,35,10,620,620,0,
Garden,Solvent control,35,10,627,627,0,
Garden,Solvent control,35,10,641,643,2,
Garden,Solvent control,35,10,647,647,0,
Garden,Solvent control,35,10,772,813,41,
Garden,Solvent control,35,10,784,790,6,
Garden,Solvent control,35,10,793,793,0,
Garden,Solvent control,35,10,795,795,0,
Garden,Solvent control,35,10,901,901,0,
Garden,Solvent control,35,10,992,992,0,
Garden,Solvent control,35,10,1018,1018,0,
Garden,Solvent control,35,10,1293,1293,0,
Garden,Solvent control,35,10,1298,1298,0,paper moved because bee moved it with its leg as it walked past
Garden,Solvent control,35,10,1326,1326,0,
Garden,Solvent control,35,10,1423,1423,0,
Garden,Solvent control,35,10,1746,1746,0,
Garden,Solvent control,35,10,1747,1747,0,
Garden,Solvent control,35,10,1762,1762,0,
Garden,10-HDA (worker control),20,1,12,13,1,
Garden,10-HDA (worker control),20,1,46,46,0,
Garden,10-HDA (worker control),20,1,54,56,2,
Garden,10-HDA (worker control),20,1,71,71,0,
Garden,10-HDA (worker control),20,1,85,85,0,
Garden,10-HDA (worker control),20,1,86,86,0,
Garden,10-HDA (worker control),20,1,130,130,0,
Garden,10-HDA (worker control),20,1,221,221,0,
Garden,10-HDA (worker control),20,1,282,282,0,
Garden,10-HDA (worker control),20,1,328,328,0,
Garden,10-HDA (worker control),20,1,341,341,0,
Garden,10-HDA (worker control),20,1,521,521,0,
Garden,10-HDA (worker control),20,1,533,534,1,
Garden,10-HDA (worker control),20,1,555,555,0,
Garden,10-HDA (worker control),20,1,556,556,0,
Garden,10-HDA (worker control),20,1,558,558,0,
Garden,10-HDA (worker control),20,1,689,689,0,
Garden,10-HDA (worker control),20,1,922,922,0,
Garden,10-HDA (worker control),20,1,990,990,0,
Garden,10-HDA (worker control),20,1,1081,1081,0,
Garden,10-HDA (worker control),20,1,1159,1159,0,
Garden,10-HDA (worker control),20,1,1266,1267,1,
Garden,10-HDA (worker control),20,1,1373,1374,1,
Garden,10-HDA (worker control),20,1,1399,1400,1,
Garden,10-HDA (worker control),20,1,1610,1613,3,
Garden,10-HDA (worker control),21,11,30,31,1,
Garden,10-HDA (worker control),21,11,38,38,0,
Garden,10-HDA (worker control),21,11,51,51,0,
Garden,10-HDA (worker control),21,11,77,78,1,
Garden,10-HDA (worker control),21,11,169,172,3,
Garden,10-HDA (worker control),21,11,168,169,1,
Garden,10-HDA (worker control),21,11,199,199,0,
Garden,10-HDA (worker control),21,11,210,211,1,
Garden,10-HDA (worker control),21,11,291,291,0,"not super sure this should count, sort of dabs at paper as it walks past"
Garden,10-HDA (worker control),21,11,292,292,0,
Garden,10-HDA (worker control),21,11,297,298,1,
Garden,10-HDA (worker control),21,11,362,362,0,
Garden,10-HDA (worker control),21,11,407,407,0,
Garden,10-HDA (worker control),21,11,455,455,0,
Garden,10-HDA (worker control),21,11,514,514,0,
Garden,10-HDA (worker control),21,11,528,528,0,
Garden,10-HDA (worker control),21,11,541,541,0,
Garden,10-HDA (worker control),21,11,637,638,1,
Garden,10-HDA (worker control),21,11,770,770,0,
Garden,10-HDA (worker control),21,11,836,836,0,
Garden,10-HDA (worker control),21,11,874,876,2,
Garden,10-HDA (worker control),21,11,888,888,0,not super sure
Garden,10-HDA (worker control),21,11,993,993,0,
Garden,10-HDA (worker control),21,11,1004,1004,0,
Garden,10-HDA (worker control),21,11,1026,1026,0,
Garden,10-HDA (worker control),21,11,1204,1204,0,
Garden,10-HDA (worker control),21,11,1286,1286,0,
Garden,10-HDA (worker control),21,11,1320,1320,0,
Garden,10-HDA (worker control),21,11,1342,1343,1,
Garden,10-HDA (worker control),21,11,1481,1481,0,
Garden,10-HDA (worker control),21,11,1529,1529,0,
Garden,10-HDA (worker control),21,11,1534,1534,0,
Garden,10-HDA (worker control),21,11,1551,1553,2,
Garden,10-HDA (worker control),21,11,1608,1608,0,
Garden,10-HDA (worker control),21,11,1638,1639,1,
Garden,10-HDA (worker control),21,11,1654,1654,0,
Garden,10-HDA (worker control),21,11,1687,1687,0,
Garden,10-HDA (worker control),21,11,1732,1734,2,
Garden,10-HDA (worker control),22,1,138,139,1,
Garden,10-HDA (worker control),22,1,342,343,1,
Garden,10-HDA (worker control),22,1,379,379,0,
Garden,10-HDA (worker control),22,1,879,879,0,
Garden,10-HDA (worker control),24,10,0,1,1,
Garden,10-HDA (worker control),24,10,3,8,5,
Garden,10-HDA (worker control),24,10,6,6,0,
Garden,10-HDA (worker control),24,10,20,21,1,
Garden,10-HDA (worker control),24,10,31,31,0,
Garden,10-HDA (worker control),24,10,41,42,1,
Garden,10-HDA (worker control),24,10,54,56,2,
Garden,10-HDA (worker control),24,10,74,74,0,
Garden,10-HDA (worker control),24,10,93,94,1,
Garden,10-HDA (worker control),24,10,96,96,0,
Garden,10-HDA (worker control),24,10,106,106,0,
Garden,10-HDA (worker control),24,10,140,141,1,
Garden,10-HDA (worker control),24,10,200,200,0,
Garden,10-HDA (worker control),24,10,201,202,1,
Garden,10-HDA (worker control),24,10,339,342,3,
Garden,10-HDA (worker control),24,10,384,384,0,
Garden,10-HDA (worker control),24,10,422,422,0,
Garden,10-HDA (worker control),24,10,431,435,4,
Garden,10-HDA (worker control),24,10,453,454,1,
Garden,10-HDA (worker control),24,10,501,501,0,
Garden,10-HDA (worker control),24,10,544,545,1,
Garden,10-HDA (worker control),24,10,591,591,0,
Garden,10-HDA (worker control),24,10,603,605,2,
Garden,10-HDA (worker control),24,10,618,619,1,
Garden,10-HDA (worker control),24,10,817,818,1,
Garden,10-HDA (worker control),24,10,833,834,1,
Garden,10-HDA (worker control),24,10,837,837,0,
Garden,10-HDA (worker control),24,10,844,844,0,
Garden,10-HDA (worker control),24,10,845,846,1,
Garden,10-HDA (worker control),24,10,847,847,0,
Garden,10-HDA (worker control),24,10,856,857,1,
Garden,10-HDA (worker control),24,10,864,865,1,
Garden,10-HDA (worker control),24,10,869,869,0,
Garden,10-HDA (worker control),24,10,920,920,0,
Garden,10-HDA (worker control),24,10,925,925,0,
Garden,10-HDA (worker control),24,10,978,979,1,
Garden,10-HDA (worker control),24,10,1040,1041,1,
Garden,10-HDA (worker control),24,10,1067,1069,2,
Garden,10-HDA (worker control),24,10,1104,1104,0,
Garden,10-HDA (worker control),24,10,1115,1116,1,
Garden,10-HDA (worker control),24,10,1132,1132,0,
Garden,10-HDA (worker control),24,10,1158,1160,2,
Garden,10-HDA (worker control),24,10,630,1176,546,
Garden,10-HDA (worker control),24,10,1198,1198,0,
Garden,10-HDA (worker control),24,10,1232,1232,0,
Garden,10-HDA (worker control),24,10,1334,1334,0,
Garden,10-HDA (worker control),24,10,1354,1354,0,
Garden,10-HDA (worker control),24,10,1382,1382,0,
Garden,10-HDA (worker control),24,10,1385,1386,1,
Garden,10-HDA (worker control),24,10,1417,1417,0,
Garden,10-HDA (worker control),24,10,1420,1421,1,
Garden,10-HDA (worker control),24,10,1432,1433,1,
Garden,10-HDA (worker control),24,10,1439,1439,0,
Garden,10-HDA (worker control),24,10,1486,1486,0,
Garden,10-HDA (worker control),24,10,1615,1619,4,
Garden,10-HDA (worker control),24,10,1682,1688,6,
Garden,10-HDA (worker control),24,10,1732,1741,9,
Garden,10-HDA (worker control),24,10,1746,1746,0,
Garden,10-HDA (worker control),24,10,1787,1787,0,
Garden,10-HDA (worker control),25,9,13,13,0,
Garden,10-HDA (worker control),25,9,22,22,0,
Garden,10-HDA (worker control),25,9,32,32,0,
Garden,10-HDA (worker control),25,9,32,34,2,
Garden,10-HDA (worker control),25,9,38,39,1,
Garden,10-HDA (worker control),25,9,40,44,4,
Garden,10-HDA (worker control),25,9,46,46,0,
Garden,10-HDA (worker control),25,9,56,57,1,
Garden,10-HDA (worker control),25,9,70,70,0,
Garden,10-HDA (worker control),25,9,71,71,0,
Garden,10-HDA (worker control),25,9,86,89,3,
Garden,10-HDA (worker control),25,9,120,121,1,
Garden,10-HDA (worker control),25,9,125,125,0,
Garden,10-HDA (worker control),25,9,234,234,0,
Garden,10-HDA (worker control),25,9,235,236,1,
Garden,10-HDA (worker control),25,9,246,246,0,
Garden,10-HDA (worker control),25,9,271,275,4,
Garden,10-HDA (worker control),25,9,277,279,2,
Garden,10-HDA (worker control),25,9,285,286,1,
Garden,10-HDA (worker control),25,9,297,297,0,
Garden,10-HDA (worker control),25,9,354,355,1,
Garden,10-HDA (worker control),25,9,368,369,1,
Garden,10-HDA (worker control),25,9,396,397,1,
Garden,10-HDA (worker control),25,9,420,422,2,
Garden,10-HDA (worker control),25,9,429,435,6,
Garden,10-HDA (worker control),25,9,485,486,1,
Garden,10-HDA (worker control),25,9,522,522,0,
Garden,10-HDA (worker control),25,9,537,537,0,
Garden,10-HDA (worker control),25,9,551,551,0,
Garden,10-HDA (worker control),25,9,578,578,0,
Garden,10-HDA (worker control),25,9,645,646,1,
Garden,10-HDA (worker control),25,9,659,661,2,
Garden,10-HDA (worker control),25,9,708,714,6,
Garden,10-HDA (worker control),25,9,784,784,0,
Garden,10-HDA (worker control),25,9,815,815,0,
Garden,10-HDA (worker control),25,9,825,826,1,
Garden,10-HDA (worker control),25,9,892,892,0,
Garden,10-HDA (worker control),25,9,895,895,0,
Garden,10-HDA (worker control),25,9,917,917,0,
Garden,10-HDA (worker control),25,9,924,925,1,
Garden,10-HDA (worker control),25,9,1029,1029,0,
Garden,10-HDA (worker control),25,9,1049,1051,2,
Garden,10-HDA (worker control),25,9,1071,1072,1,
Garden,10-HDA (worker control),25,9,1103,1104,1,
Garden,10-HDA (worker control),25,9,1164,1165,1,
Garden,10-HDA (worker control),25,9,1177,1177,0,
Garden,10-HDA (worker control),25,9,1260,1260,0,
Garden,10-HDA (worker control),25,9,1356,1356,0,
Garden,10-HDA (worker control),25,9,1397,1401,4,
Garden,10-HDA (worker control),25,9,1431,1431,0,bee sort of bumps in to it sideways
Garden,10-HDA (worker control),25,9,1636,1636,0,
Garden,10-HDA (worker control),25,9,1669,1672,3,
Garden,10-HDA (worker control),25,9,1678,1678,0,
Garden,10-HDA (worker control),25,9,1686,1686,0,
Garden,10-HDA (worker control),26,11,0,7,7,
Garden,10-HDA (worker control),26,11,127,130,3,bee sort of sniffing but not touching
Garden,10-HDA (worker control),26,11,132,134,2,bee sort of sniffing but not touching
Garden,10-HDA (worker control),26,11,202,203,1,
Garden,10-HDA (worker control),26,11,209,217,8,
Garden,10-HDA (worker control),26,11,299,302,3,
Garden,10-HDA (worker control),26,11,365,365,0,
Garden,10-HDA (worker control),26,11,393,395,2,
Garden,10-HDA (worker control),26,11,459,461,2,bee sort of sniffing but not touching
Garden,10-HDA (worker control),26,11,464,467,3,
Garden,10-HDA (worker control),26,11,484,486,2,
Garden,10-HDA (worker control),26,11,497,501,4,
Garden,10-HDA (worker control),26,11,508,511,3,
Garden,10-HDA (worker control),26,11,691,692,1,
Garden,10-HDA (worker control),26,11,741,749,8,
Garden,10-HDA (worker control),26,11,783,790,7,bee sort of sniffing but not touching
Garden,10-HDA (worker control),26,11,834,834,0,
Garden,10-HDA (worker control),26,11,982,989,7,
Garden,10-HDA (worker control),26,11,1097,1099,2,
Garden,10-HDA (worker control),26,11,1169,1172,3,
Garden,10-HDA (worker control),26,11,1214,1217,3,
Garden,10-HDA (worker control),26,11,1251,1251,0,
Garden,10-HDA (worker control),26,11,1276,1282,6,
Garden,10-HDA (worker control),26,11,1286,1287,1,bee sort of sniffing but not touching
Garden,10-HDA (worker control),26,11,1302,1302,0,
Garden,10-HDA (worker control),26,11,1306,1307,1,
Garden,10-HDA (worker control),26,11,1315,1315,0,
Garden,10-HDA (worker control),26,11,1341,1341,0,
Garden,10-HDA (worker control),26,11,1433,1442,9,
Garden,10-HDA (worker control),26,11,1561,1563,2,
Garden,10-HDA (worker control),28,6,0,15,15,
Garden,10-HDA (worker control),28,6,1,1,0,
Garden,10-HDA (worker control),28,6,7,9,2,
Garden,10-HDA (worker control),28,6,17,22,5,
Garden,10-HDA (worker control),28,6,30,57,27,
Garden,10-HDA (worker control),28,6,76,78,2,
Garden,10-HDA (worker control),28,6,73,89,16,same bee as next entry sniffing the paper
Garden,10-HDA (worker control),28,6,92,210,118,same bee
Garden,10-HDA (worker control),28,6,137,137,0,
Garden,10-HDA (worker control),28,6,214,215,1,
Garden,10-HDA (worker control),28,6,236,268,32,
Garden,10-HDA (worker control),28,6,292,327,35,same bee
Garden,10-HDA (worker control),28,6,331,340,9,same bee
Garden,10-HDA (worker control),28,6,344,344,0,
Garden,10-HDA (worker control),28,6,351,359,8,
Garden,10-HDA (worker control),28,6,357,357,0,
Garden,10-HDA (worker control),28,6,364,374,10,same bee
Garden,10-HDA (worker control),28,6,383,383,0,
Garden,10-HDA (worker control),28,6,388,388,0,
Garden,10-HDA (worker control),28,6,417,420,3,
Garden,10-HDA (worker control),28,6,456,465,9,
Garden,10-HDA (worker control),28,6,470,473,3,
Garden,10-HDA (worker control),28,6,476,491,15,"bee actively sniffing during this time, then it sits on top of the paper until 9:48"
Garden,10-HDA (worker control),28,6,570,576,6,
Garden,10-HDA (worker control),28,6,578,582,4,
Garden,10-HDA (worker control),28,6,586,588,2,
Garden,10-HDA (worker control),28,6,599,603,4,
Garden,10-HDA (worker control),28,6,605,671,66,bee sits motionless with its antennae on paper
Garden,10-HDA (worker control),28,6,640,640,0,
Garden,10-HDA (worker control),28,6,648,648,0,
Garden,10-HDA (worker control),28,6,665,666,1,
Garden,10-HDA (worker control),28,6,671,675,4,
Garden,10-HDA (worker control),28,6,675,700,25,bee sits still very close to paper with its head on it
Garden,10-HDA (worker control),28,6,728,735,7,
Garden,10-HDA (worker control),28,6,791,793,2,
Garden,10-HDA (worker control),28,6,815,815,0,
Garden,10-HDA (worker control),28,6,833,835,2,
Garden,10-HDA (worker control),28,6,857,857,0,
Garden,10-HDA (worker control),28,6,1007,1007,0,
Garden,10-HDA (worker control),28,6,1042,1042,0,
Garden,10-HDA (worker control),28,6,1070,1070,0,
Garden,10-HDA (worker control),28,6,1156,1177,21,
Garden,10-HDA (worker control),28,6,1194,1194,0,
Garden,10-HDA (worker control),28,6,1213,1214,1,
Garden,10-HDA (worker control),28,6,1246,1246,0,
Garden,10-HDA (worker control),28,6,1276,1276,0,
Garden,10-HDA (worker control),28,6,1293,1294,1,
Garden,10-HDA (worker control),28,6,1312,1314,2,
Garden,10-HDA (worker control),28,6,1319,1319,0,
Garden,10-HDA (worker control),28,6,1426,1426,0,
Garden,10-HDA (worker control),28,6,1443,1445,2,bee walks over paper
Garden,10-HDA (worker control),28,6,1461,1463,2,bee walks over paper
Garden,10-HDA (worker control),28,6,1590,1592,2,
Garden,10-HDA (worker control),28,6,1594,1594,0,
Garden,10-HDA (worker control),28,6,1676,1677,1,
Garden,10-HDA (worker control),28,6,1689,1689,0,
Garden,10-HDA (worker control),28,6,1742,1742,0,
Garden,10-HDA (worker control),28,6,1750,1750,0,
Garden,10-HDA (worker control),29,3,8,8,0,
Garden,10-HDA (worker control),29,3,18,18,0,
Garden,10-HDA (worker control),29,3,63,69,6,
Garden,10-HDA (worker control),29,3,112,114,2,
Garden,10-HDA (worker control),29,3,177,178,1,
Garden,10-HDA (worker control),29,3,206,206,0,
Garden,10-HDA (worker control),29,3,349,349,0,
Garden,10-HDA (worker control),29,3,389,396,7,
Garden,10-HDA (worker control),29,3,423,426,3,
Garden,10-HDA (worker control),29,3,434,435,1,
Garden,10-HDA (worker control),29,3,624,635,11,
Garden,10-HDA (worker control),29,3,786,793,7,
Garden,10-HDA (worker control),29,3,830,834,4,
Garden,10-HDA (worker control),29,3,933,933,0,
Garden,10-HDA (worker control),29,3,964,966,2,
Garden,10-HDA (worker control),29,3,987,987,0,
Garden,10-HDA (worker control),29,3,1093,1095,2,
Garden,10-HDA (worker control),29,3,1420,1422,2,
Garden,10-HDA (worker control),29,3,1456,1459,3,
Garden,10-HDA (worker control),29,3,1517,1517,0,
Garden,10-HDA (worker control),29,3,1575,1577,2,
Garden,10-HDA (worker control),29,3,1754,1755,1,
Garden,10-HDA (worker control),30,5,2,3,1,
Garden,10-HDA (worker control),30,5,8,51,43,
Garden,10-HDA (worker control),30,5,76,78,2,
Garden,10-HDA (worker control),30,5,88,89,1,
Garden,10-HDA (worker control),30,5,126,127,1,
Garden,10-HDA (worker control),30,5,172,172,0,
Garden,10-HDA (worker control),30,5,279,286,7,
Garden,10-HDA (worker control),30,5,338,338,0,
Garden,10-HDA (worker control),30,5,358,358,0,
Garden,10-HDA (worker control),30,5,367,372,5,
Garden,10-HDA (worker control),30,5,393,393,0,
Garden,10-HDA (worker control),30,5,402,404,2,
Garden,10-HDA (worker control),30,5,415,418,3,
Garden,10-HDA (worker control),30,5,422,422,0,
Garden,10-HDA (worker control),30,5,541,541,0,
Garden,10-HDA (worker control),30,5,545,545,0,
Garden,10-HDA (worker control),30,5,706,706,0,
Garden,10-HDA (worker control),30,5,878,880,2,
Garden,10-HDA (worker control),30,5,882,882,0,
Garden,10-HDA (worker control),30,5,958,958,0,
Garden,10-HDA (worker control),30,5,980,984,4,
Garden,10-HDA (worker control),30,5,991,995,4,
Garden,10-HDA (worker control),30,5,997,999,2,
Garden,10-HDA (worker control),30,5,1023,1025,2,
Garden,10-HDA (worker control),30,5,1029,1029,0,
Garden,10-HDA (worker control),30,5,1059,1059,0,
Garden,10-HDA (worker control),30,5,1090,1091,1,
Garden,10-HDA (worker control),30,5,1140,1140,0,
Garden,10-HDA (worker control),30,5,1170,1170,0,
Garden,10-HDA (worker control),30,5,1194,1194,0,
Garden,10-HDA (worker control),30,5,1235,1235,0,
Garden,10-HDA (worker control),30,5,1274,1274,0,
Garden,10-HDA (worker control),30,5,1368,1371,3,
Garden,10-HDA (worker control),30,5,1445,1447,2,
Garden,10-HDA (worker control),30,5,1526,1526,0,
Garden,10-HDA (worker control),30,5,1541,1542,1,
Garden,10-HDA (worker control),30,5,1747,1747,0,
Garden,10-HDA (worker control),30,5,1751,1752,1,
Garden,10-HDA (worker control),30,5,1757,1757,0,
Garden,10-HDA (worker control),30,5,1769,1769,0,
Garden,10-HDA (worker control),30,5,1770,1770,0,
Garden,10-HDA (worker control),30,5,1773,1773,0,
Garden,10-HDA (worker control),31,11,2,2,0,
Garden,10-HDA (worker control),31,11,8,8,0,
Garden,10-HDA (worker control),31,11,22,26,4,
Garden,10-HDA (worker control),31,11,27,27,0,
Garden,10-HDA (worker control),31,11,40,185,145,
Garden,10-HDA (worker control),31,11,64,67,3,
Garden,10-HDA (worker control),31,11,86,117,31,
Garden,10-HDA (worker control),31,11,124,126,2,
Garden,10-HDA (worker control),31,11,125,133,8,
Garden,10-HDA (worker control),31,11,161,165,4,
Garden,10-HDA (worker control),31,11,177,180,3,
Garden,10-HDA (worker control),31,11,189,189,0,
Garden,10-HDA (worker control),31,11,224,228,4,
Garden,10-HDA (worker control),31,11,251,252,1,
Garden,10-HDA (worker control),31,11,287,287,0,
Garden,10-HDA (worker control),31,11,441,447,6,
Garden,10-HDA (worker control),31,11,550,554,4,
Garden,10-HDA (worker control),31,11,628,628,0,
Garden,10-HDA (worker control),31,11,708,710,2,
Garden,10-HDA (worker control),31,11,809,816,7,
Garden,10-HDA (worker control),31,11,840,842,2,
Garden,10-HDA (worker control),31,11,851,853,2,
Garden,10-HDA (worker control),31,11,1467,1467,0,
Garden,10-HDA (worker control),31,11,1599,1602,3,
Garden,10-HDA (worker control),31,11,1626,1626,0,
Garden,10-HDA (worker control),33,7,16,22,6,
Garden,10-HDA (worker control),33,7,25,25,0,
Garden,10-HDA (worker control),33,7,276,276,0,
Garden,10-HDA (worker control),33,7,416,416,0,
Garden,10-HDA (worker control),33,7,553,553,0,
Garden,10-HDA (worker control),33,7,660,662,2,
Garden,10-HDA (worker control),33,7,699,699,0,
Garden,10-HDA (worker control),33,7,702,702,0,
Garden,10-HDA (worker control),33,7,1068,1071,3,
Garden,10-HDA (worker control),33,7,1126,1127,1,
Garden,10-HDA (worker control),33,7,1217,1235,18,bee walks up and lies still next to paper - I don't really think I should count this but not sure
Garden,10-HDA (worker control),33,7,1275,1275,0,
Garden,10-HDA (worker control),33,7,1322,1322,0,Trophallaxis
Garden,10-HDA (worker control),33,7,1536,1538,2,
Garden,10-HDA (worker control),33,7,1590,1590,0,
Garden,10-HDA (worker control),33,7,1594,1594,0,
Garden,10-HDA (worker control),33,7,1780,1780,0,
Garden,10-HDA (worker control),33,7,1784,1784,0,
Garden,10-HDA (worker control),34,7,10,10,0,
Garden,10-HDA (worker control),34,7,34,34,0,
Garden,10-HDA (worker control),34,7,65,65,0,
Garden,10-HDA (worker control),34,7,106,106,0,
Garden,10-HDA (worker control),34,7,133,133,0,
Garden,10-HDA (worker control),34,7,568,570,2,seems very interrested and is very close - may not count though
Garden,10-HDA (worker control),34,7,1266,1266,0,
Garden,10-HDA (worker control),34,7,1322,1322,0,
Garden,10-HDA (worker control),34,7,1367,1367,0,
Garden,10-HDA (worker control),34,7,1691,1691,0,
Garden,10-HDA (worker control),34,7,1695,1695,0,
Garden,10-HDA (worker control),34,7,1732,1732,0,
Garden,10-HDA (worker control),34,7,1734,1734,0,
Garden,10-HDA (worker control),35,9,168,171,3,Bee falls on to paper - don't know if it counts - it seems to be trying to get the attention of one of its sisters when it falls
Garden,10-HDA (worker control),35,9,203,203,0,
Garden,10-HDA (worker control),35,9,985,985,0,
Garden,10-HDA (worker control),35,9,992,992,0,
Garden,10-HDA (worker control),35,9,1050,1054,4,Stops next to paper and bends its head towards it - i think it is a propper sniff
Garden,10-HDA (worker control),35,9,1128,1128,0,
Garden,10-HDA (worker control),35,9,1237,1237,0,
Garden,10-HDA (worker control),35,9,1239,1239,0,
Garden,10-HDA (worker control),35,9,1309,1309,0,
Garden,10-HDA (worker control),35,9,1310,1311,1,
Garden,10-HDA (worker control),35,9,1367,1367,0,
Garden,10-HDA (worker control),35,9,1380,1380,0,
Garden,10-HDA (worker control),35,9,1390,1390,0,
Garden,10-HDA (worker control),35,9,1408,1413,5,
Garden,HOB,20,4,16,19,3,
Garden,HOB,20,4,29,30,1,
Garden,HOB,20,4,69,71,2,
Garden,HOB,20,4,167,167,0,
Garden,HOB,20,4,462,463,1,
Garden,HOB,20,4,1e3,1001,1,bee sort of sniffs from afar - not sure
Garden,HOB,20,4,1021,1021,0,
Garden,HOB,20,4,1147,1147,0,bee sort of rubs on paper for a second - not facing it
Garden,HOB,20,4,1159,1160,1,
Garden,HOB,20,4,1288,1288,0,
Garden,HOB,20,4,1289,1289,0,
Garden,HOB,20,4,1309,1310,1,
Garden,HOB,20,4,1361,1361,0,really not sure about this one - bee sort of just keeps moving
Garden,HOB,20,4,1375,1375,0,
Garden,HOB,20,4,1403,1404,1,
Garden,HOB,20,4,1415,1416,1,
Garden,HOB,20,4,1746,1751,5,
Garden,HOB,20,4,1798,1799,1,
Garden,HOB,21,10,11,17,6,
Garden,HOB,21,10,23,28,5,
Garden,HOB,21,10,25,25,0,
Garden,HOB,21,10,32,36,4,
Garden,HOB,21,10,37,39,2,
Garden,HOB,21,10,43,45,2,
Garden,HOB,21,10,52,56,4,
Garden,HOB,21,10,67,70,3,
Garden,HOB,21,10,71,72,1,
Garden,HOB,21,10,81,84,3,
Garden,HOB,21,10,82,90,8,
Garden,HOB,21,10,87,88,1,
Garden,HOB,21,10,99,99,0,
Garden,HOB,21,10,101,101,0,
Garden,HOB,21,10,103,106,3,
Garden,HOB,21,10,122,129,7,
Garden,HOB,21,10,130,131,1,
Garden,HOB,21,10,138,138,0,
Garden,HOB,21,10,172,172,0,
Garden,HOB,21,10,180,186,6,
Garden,HOB,21,10,183,183,0,
Garden,HOB,21,10,188,188,0,
Garden,HOB,21,10,209,209,0,
Garden,HOB,21,10,218,218,0,
Garden,HOB,21,10,230,232,2,
Garden,HOB,21,10,255,257,2,
Garden,HOB,21,10,264,265,1,
Garden,HOB,21,10,267,268,1,
Garden,HOB,21,10,279,281,2,
Garden,HOB,21,10,311,311,0,
Garden,HOB,21,10,390,391,1,
Garden,HOB,21,10,428,431,3,
Garden,HOB,21,10,437,442,5,
Garden,HOB,21,10,482,502,20,
Garden,HOB,21,10,508,512,4,
Garden,HOB,21,10,512,518,6,
Garden,HOB,21,10,584,585,1,
Garden,HOB,21,10,629,631,2,
Garden,HOB,21,10,633,638,5,
Garden,HOB,21,10,642,643,1,"bee walks by really close, don't really think it counts"
Garden,HOB,21,10,655,659,4,11:02 bee sits on paper until this time
Garden,HOB,21,10,666,679,13,
Garden,HOB,21,10,684,687,3,
Garden,HOB,21,10,689,691,2,
Garden,HOB,21,10,686,701,15,
Garden,HOB,21,10,715,723,8,
Garden,HOB,21,10,719,723,4,
Garden,HOB,21,10,727,733,6,
Garden,HOB,21,10,804,810,6,
Garden,HOB,21,10,834,836,2,
Garden,HOB,21,10,837,841,4,sniff from a distance
Garden,HOB,21,10,842,842,0,
Garden,HOB,21,10,843,843,0,
Garden,HOB,21,10,844,845,1,
Garden,HOB,21,10,850,851,1,
Garden,HOB,21,10,866,871,5,
Garden,HOB,21,10,866,873,7,
Garden,HOB,21,10,877,880,3,
Garden,HOB,21,10,886,887,1,
Garden,HOB,21,10,899,901,2,
Garden,HOB,21,10,980,980,0,
Garden,HOB,21,10,997,997,0,
Garden,HOB,21,10,1013,1015,2,
Garden,HOB,21,10,1057,1058,1,
Garden,HOB,21,10,1082,1082,0,
Garden,HOB,21,10,1138,1138,0,
Garden,HOB,21,10,1211,1211,0,bee sort of walks in to the paper
Garden,HOB,21,10,1272,1272,0,bee sort of sideways sniffs paper as it walks past
Garden,HOB,21,10,1358,1363,5,
Garden,HOB,21,10,1373,1373,0,
Garden,HOB,21,10,1399,1401,2,bee walks on paper
Garden,HOB,21,10,1411,1412,1,
Garden,HOB,21,10,1415,1415,0,
Garden,HOB,21,10,1426,1431,5,
Garden,HOB,21,10,1437,1437,0,bee sort of sideways sniffs paper as it walks past
Garden,HOB,21,10,1458,1463,5,bee walsk aroudn the edge of paper super close
Garden,HOB,21,10,1471,1473,2,bee walks over paper
Garden,HOB,21,10,1485,1487,2,
Garden,HOB,21,10,1486,1489,3,
Garden,HOB,21,10,1496,1496,0,
Garden,HOB,21,10,1507,1516,9,
Garden,HOB,21,10,1563,1564,1,
Garden,HOB,21,10,1570,1571,1,
Garden,HOB,21,10,1617,1618,1,
Garden,HOB,21,10,1673,1674,1,
Garden,HOB,21,10,1690,1694,4,
Garden,HOB,21,10,1712,1714,2,
Garden,HOB,21,10,1728,1730,2,
Garden,HOB,21,10,1734,1737,3,
Garden,HOB,21,10,1768,1768,0,
Garden,HOB,21,10,1770,1770,0,
Garden,HOB,21,10,1779,1780,1,
Garden,HOB,21,10,1784,1784,0,bee sort of turns in to paper
Garden,HOB,21,10,1791,1791,0,"bee sort of walsk in to paper sideways, seems to be interrested"
Garden,HOB,22,12,3,8,5,
Garden,HOB,22,12,13,17,4,
Garden,HOB,22,12,23,99,76,
Garden,HOB,22,12,104,146,42,
Garden,HOB,22,12,165,277,112,
Garden,HOB,22,12,279,282,3,
Garden,HOB,22,12,288,367,79,"bee sort of grooming itself next to the paper, facing it. It also does touch it at the end of this period"
Garden,HOB,22,12,397,405,8,
Garden,HOB,22,12,410,414,4,
Garden,HOB,22,12,429,434,5,
Garden,HOB,22,12,451,453,2,
Garden,HOB,22,12,628,640,12,
Garden,HOB,22,12,649,690,41,"bee walks up to paper, antennates, then settles down facing the paper until annother bee crashes in to it and it moves away from the paper. 11:36 is when it actually turns away"
Garden,HOB,22,12,949,950,1,
Garden,HOB,22,12,960,962,2,
Garden,HOB,22,12,964,966,2,
Garden,HOB,22,12,968,969,1,
Garden,HOB,22,12,1055,1056,1,
Garden,HOB,22,12,1228,1230,2,
Garden,HOB,22,12,1403,1403,0,
Garden,HOB,22,12,1423,1426,3,
Garden,HOB,22,12,1449,1451,2,
Garden,HOB,22,12,1469,1471,2,
Garden,HOB,22,12,1491,1491,0,
Garden,HOB,22,12,1522,1522,0,
Garden,HOB,22,12,1622,1622,0,
Garden,HOB,22,12,1682,1682,0,
Garden,HOB,22,12,1698,1700,2,
Garden,HOB,22,12,1732,1733,1,
Garden,HOB,24,2,2,5,3,
Garden,HOB,24,2,5,5,0,
Garden,HOB,24,2,10,10,0,
Garden,HOB,24,2,17,18,1,
Garden,HOB,24,2,36,36,0,
Garden,HOB,24,2,56,56,0,
Garden,HOB,24,2,62,62,0,
Garden,HOB,24,2,65,65,0,
Garden,HOB,24,2,108,108,0,
Garden,HOB,24,2,238,238,0,
Garden,HOB,24,2,243,244,1,
Garden,HOB,24,2,281,283,2,
Garden,HOB,24,2,303,304,1,
Garden,HOB,24,2,350,352,2,
Garden,HOB,24,2,381,383,2,
Garden,HOB,24,2,398,399,1,
Garden,HOB,24,2,411,412,1,
Garden,HOB,24,2,421,421,0,
Garden,HOB,24,2,461,461,0,
Garden,HOB,24,2,474,474,0,
Garden,HOB,24,2,498,498,0,
Garden,HOB,24,2,518,519,1,
Garden,HOB,24,2,525,526,1,
Garden,HOB,24,2,645,645,0,
Garden,HOB,24,2,672,672,0,
Garden,HOB,24,2,684,684,0,
Garden,HOB,24,2,696,697,1,
Garden,HOB,24,2,710,710,0,
Garden,HOB,24,2,781,781,0,
Garden,HOB,24,2,785,786,1,
Garden,HOB,24,2,879,879,0,
Garden,HOB,24,2,979,980,1,
Garden,HOB,24,2,1008,1009,1,
Garden,HOB,24,2,1018,1018,0,
Garden,HOB,24,2,1030,1031,1,
Garden,HOB,24,2,1055,1056,1,
Garden,HOB,24,2,1066,1066,0,
Garden,HOB,24,2,1106,1106,0,
Garden,HOB,24,2,1201,1201,0,
Garden,HOB,24,2,1241,1241,0,
Garden,HOB,24,2,1265,1265,0,
Garden,HOB,24,2,1326,1328,2,
Garden,HOB,24,2,1333,1333,0,
Garden,HOB,24,2,1352,1353,1,
Garden,HOB,24,2,1359,1361,2,
Garden,HOB,24,2,1428,1428,0,
Garden,HOB,24,2,1455,1455,0,
Garden,HOB,24,2,1457,1457,0,
Garden,HOB,24,2,1473,1474,1,
Garden,HOB,24,2,1519,1519,0,
Garden,HOB,24,2,1527,1527,0,
Garden,HOB,24,2,1571,1571,0,
Garden,HOB,24,2,1578,1578,0,
Garden,HOB,24,2,1632,1634,2,
Garden,HOB,24,2,1682,1683,1,
Garden,HOB,24,2,1696,1696,0,
Garden,HOB,24,2,1724,1724,0,
Garden,HOB,24,2,1741,1742,1,
Garden,HOB,24,2,1754,1754,0,
Garden,HOB,24,2,1761,1761,0,
Garden,HOB,25,12,15,15,0,
Garden,HOB,25,12,93,94,1,
Garden,HOB,25,12,110,110,0,
Garden,HOB,25,12,186,188,2,
Garden,HOB,25,12,339,339,0,
Garden,HOB,25,12,556,556,0,
Garden,HOB,25,12,582,587,5,
Garden,HOB,25,12,605,607,2,
Garden,HOB,25,12,723,723,0,
Garden,HOB,25,12,817,818,1,
Garden,HOB,25,12,838,838,0,
Garden,HOB,25,12,893,895,2,
Garden,HOB,25,12,1099,1107,8,
Garden,HOB,25,12,1104,1105,1,
Garden,HOB,25,12,1154,1156,2,
Garden,HOB,25,12,1212,1214,2,
Garden,HOB,25,12,1225,1225,0,
Garden,HOB,25,12,1231,1231,0,
Garden,HOB,25,12,1247,1247,0,
Garden,HOB,25,12,1292,1294,2,
Garden,HOB,25,12,1396,1398,2,
Garden,HOB,25,12,1462,1462,0,
Garden,HOB,25,12,1466,1466,0,
Garden,HOB,25,12,1662,1662,0,
Garden,HOB,25,12,1701,1702,1,
Garden,HOB,25,12,1699,1762,63,
Garden,HOB,25,12,1798,1799,1,
Garden,HOB,26,10,36,38,2,
Garden,HOB,26,10,170,170,0,
Garden,HOB,26,10,446,446,0,
Garden,HOB,26,10,495,498,3,
Garden,HOB,26,10,640,640,0,
Garden,HOB,26,10,658,659,1,
Garden,HOB,26,10,751,751,0,bee sniffs but does not touch
Garden,HOB,26,10,818,818,0,
Garden,HOB,26,10,831,831,0,
Garden,HOB,26,10,926,928,2,bee sort of sniffing but not touching
Garden,HOB,26,10,1079,1080,1,
Garden,HOB,26,10,1298,1298,0,
Garden,HOB,26,10,1475,1475,0,
Garden,HOB,26,10,1671,1671,0,
Garden,HOB,28,5,8,8,0,
Garden,HOB,28,5,18,18,0,
Garden,HOB,28,5,41,42,1,
Garden,HOB,28,5,57,57,0,
Garden,HOB,28,5,58,58,0,
Garden,HOB,28,5,115,116,1,
Garden,HOB,28,5,278,280,2,
Garden,HOB,28,5,292,292,0,
Garden,HOB,28,5,331,334,3,
Garden,HOB,28,5,340,340,0,
Garden,HOB,28,5,403,404,1,
Garden,HOB,28,5,456,456,0,
Garden,HOB,28,5,518,518,0,
Garden,HOB,28,5,549,549,0,
Garden,HOB,28,5,556,556,0,
Garden,HOB,28,5,619,619,0,
Garden,HOB,28,5,624,624,0,
Garden,HOB,28,5,703,703,0,
Garden,HOB,28,5,870,871,1,
Garden,HOB,28,5,922,922,0,
Garden,HOB,28,5,945,945,0,
Garden,HOB,28,5,962,963,1,
Garden,HOB,28,5,988,988,0,
Garden,HOB,28,5,1142,1143,1,
Garden,HOB,28,5,1208,1208,0,
Garden,HOB,28,5,1230,1230,0,
Garden,HOB,28,5,1263,1273,10,little distance from the paper but it is definitely interrested in it
Garden,HOB,28,5,1297,1297,0,
Garden,HOB,28,5,1312,1312,0,
Garden,HOB,28,5,1497,1497,0,
Garden,HOB,28,5,1513,1513,0,
Garden,HOB,28,5,1634,1634,0,
Garden,HOB,28,5,1706,1706,0,
Garden,HOB,28,5,1765,1765,0,
Garden,HOB,29,2,59,59,0,
Garden,HOB,29,2,105,105,0,
Garden,HOB,29,2,121,121,0,
Garden,HOB,29,2,165,165,0,
Garden,HOB,29,2,259,259,0,
Garden,HOB,29,2,290,294,4,
Garden,HOB,29,2,302,302,0,
Garden,HOB,29,2,310,310,0,
Garden,HOB,29,2,355,355,0,
Garden,HOB,29,2,434,434,0,
Garden,HOB,29,2,567,573,6,
Garden,HOB,29,2,634,638,4,
Garden,HOB,29,2,732,732,0,
Garden,HOB,29,2,744,746,2,
Garden,HOB,29,2,814,814,0,
Garden,HOB,29,2,1003,1003,0,
Garden,HOB,29,2,1081,1083,2,
Garden,HOB,29,2,1088,1089,1,
Garden,HOB,29,2,1110,1110,0,
Garden,HOB,29,2,1172,1172,0,
Garden,HOB,29,2,1210,1212,2,
Garden,HOB,29,2,1213,1213,0,
Garden,HOB,29,2,1220,1220,0,
Garden,HOB,29,2,1255,1255,0,
Garden,HOB,29,2,1357,1357,0,
Garden,HOB,29,2,1364,1365,1,
Garden,HOB,29,2,1406,1406,0,
Garden,HOB,29,2,1415,1415,0,
Garden,HOB,29,2,1574,1574,0,
Garden,HOB,29,2,1672,1672,0,
Garden,HOB,29,2,1734,1734,0,
Garden,HOB,29,2,1744,1744,0,
Garden,HOB,31,10,42,42,0,
Garden,HOB,31,10,180,180,0,
Garden,HOB,31,10,343,343,0,
Garden,HOB,31,10,370,370,0,
Garden,HOB,31,10,388,388,0,
Garden,HOB,31,10,429,430,1,
Garden,HOB,31,10,457,457,0,
Garden,HOB,31,10,858,858,0,
Garden,HOB,31,10,902,909,7,little far away from paper but i think its genuinely antennating it
Garden,HOB,31,10,1021,1021,0,
Garden,HOB,31,10,1049,1050,1,
Garden,HOB,31,10,1065,1065,0,
Garden,HOB,31,10,1198,1206,8,
Garden,HOB,31,10,1235,1235,0,
Garden,HOB,31,10,1271,1284,13,
Garden,HOB,31,10,1310,1316,6,
Garden,HOB,31,10,1527,1531,4,
Garden,HOB,31,10,1555,1555,0,
Garden,HOB,33,9,15,15,0,
Garden,HOB,33,9,117,119,2,
Garden,HOB,33,9,140,142,2,
Garden,HOB,33,9,335,336,1,
Garden,HOB,33,9,376,376,0,
Garden,HOB,33,9,650,650,0,Bee kind of pushes other bee in to it - not sure it counts
Garden,HOB,33,9,815,815,0,bee walks in to paper - pushes it with its side - i kind of don't think it counts
Garden,HOB,33,9,958,958,0,
Garden,HOB,33,9,1105,1105,0,not sure
Garden,HOB,33,9,1310,1310,0,
Garden,HOB,33,9,1315,1315,0,
Garden,HOB,33,9,1325,1327,2,
Garden,HOB,33,9,1330,1330,0,
Garden,HOB,33,9,1336,1362,26,bee comes up and sits really close to it motionless - not sure if counts
Garden,HOB,33,9,1340,1340,0,
Garden,HOB,33,9,1344,1344,0,
Garden,HOB,33,9,1366,1367,1,
Garden,HOB,33,9,1374,1374,0,
Garden,HOB,33,9,1445,1445,0,
Garden,HOB,33,9,1472,1472,0,
Garden,HOB,33,9,1550,1550,0,not sure
Garden,HOB,33,9,1556,1556,0,not sure
Garden,HOB,33,9,1711,1711,0,
Garden,HOB,33,9,1728,1728,0,
Garden,HOB,33,9,1735,1736,1,
Garden,HOB,34,6,39,44,5,"Very interested, not actually touching maybe"
Garden,HOB,34,6,135,145,10,
Garden,HOB,34,6,137,140,3,"Quite close, definitely walks up and is interested, not quite touching"
Garden,HOB,34,6,158,158,0,
Garden,HOB,34,6,369,369,0,
Garden,HOB,34,6,419,419,0,
Garden,HOB,34,6,446,446,0,
Garden,HOB,34,6,539,539,0,
Garden,HOB,34,6,579,579,0,
Garden,HOB,34,6,725,725,0,
Garden,HOB,34,6,1007,1007,0,
Garden,HOB,34,6,1054,1054,0,
Garden,HOB,34,6,1423,1423,0,
Garden,HOB,34,6,1434,1434,0,
Garden,HOB,34,6,1491,1491,0,
Garden,HOB,34,6,1508,1508,0,Not super confident about this one
Garden,HVA,20,3,21,21,0,
Garden,HVA,20,3,31,31,0,
Garden,HVA,20,3,58,58,0,
Garden,HVA,20,3,89,89,0,
Garden,HVA,20,3,99,99,0,
Garden,HVA,20,3,113,113,0,
Garden,HVA,20,3,149,149,0,
Garden,HVA,20,3,189,190,1,
Garden,HVA,20,3,254,254,0,
Garden,HVA,20,3,378,378,0,
Garden,HVA,20,3,570,570,0,
Garden,HVA,20,3,661,661,0,
Garden,HVA,20,3,839,841,2,
Garden,HVA,20,3,999,1001,2,
Garden,HVA,20,3,1212,1213,1,
Garden,HVA,20,3,1279,1280,1,
Garden,HVA,20,3,1346,1346,0,
Garden,HVA,20,3,1405,1406,1,
Garden,HVA,20,3,1450,1450,0,
Garden,HVA,20,3,1515,1515,0,
Garden,HVA,20,3,1590,1590,0,
Garden,HVA,20,3,1671,1671,0,
Garden,HVA,20,3,1747,1764,17,
Garden,HVA,21,9,51,51,0,not sure if it counts bee doesnt really stop
Garden,HVA,21,9,204,204,0,
Garden,HVA,21,9,345,346,1,
Garden,HVA,21,9,365,365,0,
Garden,HVA,21,9,416,419,3,
Garden,HVA,21,9,433,433,0,
Garden,HVA,21,9,517,517,0,
Garden,HVA,21,9,612,613,1,
Garden,HVA,21,9,684,691,7,11:35 it sits on the paper until
Garden,HVA,21,9,699,703,4,bee walks on paper
Garden,HVA,21,9,706,711,5,bee walks on paper
Garden,HVA,21,9,734,736,2,
Garden,HVA,21,9,759,759,0,
Garden,HVA,21,9,987,993,6,
Garden,HVA,21,9,1118,1118,0,"bee sort of walks in to the papwr, not sure it counts"
Garden,HVA,21,9,1135,1143,8,
Garden,HVA,21,9,1154,1155,1,
Garden,HVA,21,9,1169,1170,1,
Garden,HVA,21,9,1382,1383,1,
Garden,HVA,21,9,1423,1424,1,
Garden,HVA,21,9,1450,1452,2,
Garden,HVA,21,9,1587,1589,2,
Garden,HVA,21,9,1592,1592,0,
Garden,HVA,21,9,1620,1623,3,
Garden,HVA,21,9,1715,1715,0,"not completely sure it counts, bee walking past has a sniff as it moves along"
Garden,HVA,21,9,1757,1759,2,
Garden,HVA,21,9,1760,1763,3,
Garden,HVA,21,9,1790,1795,5,
Garden,HVA,22,11,0,0,0,
Garden,HVA,22,11,2,4,2,
Garden,HVA,22,11,12,12,0,
Garden,HVA,22,11,23,27,4,bee walsking on paper
Garden,HVA,22,11,30,31,1,
Garden,HVA,22,11,32,34,2,
Garden,HVA,22,11,39,41,2,
Garden,HVA,22,11,54,54,0,
Garden,HVA,22,11,62,63,1,
Garden,HVA,22,11,69,72,3,
Garden,HVA,22,11,75,88,13,bee sort of sitting on top of paper
Garden,HVA,22,11,80,83,3,
Garden,HVA,22,11,95,99,4,
Garden,HVA,22,11,101,102,1,
Garden,HVA,22,11,110,110,0,
Garden,HVA,22,11,129,131,2,
Garden,HVA,22,11,150,152,2,
Garden,HVA,22,11,156,157,1,
Garden,HVA,22,11,170,171,1,
Garden,HVA,22,11,199,201,2,
Garden,HVA,22,11,226,226,0,
Garden,HVA,22,11,273,273,0,
Garden,HVA,22,11,300,301,1,
Garden,HVA,22,11,314,323,9,
Garden,HVA,22,11,325,325,0,
Garden,HVA,22,11,329,333,4,
Garden,HVA,22,11,337,337,0,
Garden,HVA,22,11,342,343,1,
Garden,HVA,22,11,347,350,3,
Garden,HVA,22,11,352,354,2,
Garden,HVA,22,11,361,363,2,
Garden,HVA,22,11,367,371,4,
Garden,HVA,22,11,452,456,4,7:23 it faces the paper and seems interrested
Garden,HVA,22,11,458,460,2,
Garden,HVA,22,11,480,481,1,
Garden,HVA,22,11,765,767,2,
Garden,HVA,22,11,950,962,12,
Garden,HVA,22,11,968,972,4,
Garden,HVA,22,11,1014,1015,1,
Garden,HVA,22,11,1047,1049,2,
Garden,HVA,22,11,1082,1088,6,
Garden,HVA,22,11,1094,1098,4,
Garden,HVA,22,11,1097,1099,2,
Garden,HVA,22,11,1106,1112,6,
Garden,HVA,22,11,1193,1196,3,
Garden,HVA,22,11,1212,1216,4,
Garden,HVA,22,11,1288,1291,3,
Garden,HVA,22,11,1340,1344,4,
Garden,HVA,22,11,1347,1349,2,
Garden,HVA,22,11,1563,1564,1,
Garden,HVA,22,11,1587,1589,2,
Garden,HVA,22,11,1607,1608,1,
Garden,HVA,22,11,1636,1639,3,
Garden,HVA,22,11,1692,1695,3,
Garden,HVA,24,5,3,3,0,
Garden,HVA,24,5,3,5,2,
Garden,HVA,24,5,30,31,1,
Garden,HVA,24,5,93,93,0,
Garden,HVA,24,5,96,96,0,
Garden,HVA,24,5,141,142,1,
Garden,HVA,24,5,168,169,1,bee walks over paper
Garden,HVA,24,5,209,209,0,
Garden,HVA,24,5,235,237,2,
Garden,HVA,24,5,259,260,1,
Garden,HVA,24,5,302,302,0,
Garden,HVA,24,5,313,313,0,
Garden,HVA,24,5,319,319,0,
Garden,HVA,24,5,321,321,0,
Garden,HVA,24,5,325,325,0,
Garden,HVA,24,5,332,332,0,
Garden,HVA,24,5,394,394,0,
Garden,HVA,24,5,412,412,0,
Garden,HVA,24,5,419,419,0,
Garden,HVA,24,5,421,421,0,
Garden,HVA,24,5,429,429,0,
Garden,HVA,24,5,457,458,1,
Garden,HVA,24,5,479,479,0,
Garden,HVA,24,5,488,489,1,
Garden,HVA,24,5,507,508,1,
Garden,HVA,24,5,544,544,0,
Garden,HVA,24,5,608,608,0,
Garden,HVA,24,5,626,627,1,
Garden,HVA,24,5,665,665,0,
Garden,HVA,24,5,705,705,0,bee walks over paper
Garden,HVA,24,5,769,769,0,
Garden,HVA,24,5,834,834,0,
Garden,HVA,24,5,884,886,2,
Garden,HVA,24,5,948,948,0,
Garden,HVA,24,5,961,961,0,
Garden,HVA,24,5,962,962,0,
Garden,HVA,24,5,990,990,0,
Garden,HVA,24,5,1065,1065,0,
Garden,HVA,24,5,1075,1075,0,
Garden,HVA,24,5,1080,1080,0,
Garden,HVA,24,5,1126,1126,0,
Garden,HVA,24,5,1155,1155,0,
Garden,HVA,24,5,1173,1175,2,
Garden,HVA,24,5,1183,1184,1,
Garden,HVA,24,5,1217,1217,0,
Garden,HVA,24,5,1293,1293,0,
Garden,HVA,24,5,1311,1312,1,
Garden,HVA,24,5,1313,1313,0,
Garden,HVA,24,5,1367,1368,1,
Garden,HVA,24,5,1373,1373,0,
Garden,HVA,24,5,1375,1376,1,
Garden,HVA,24,5,1403,1403,0,"bee walks very close to paper, not sure if it counts"
Garden,HVA,24,5,1407,1409,2,
Garden,HVA,24,5,1408,1413,5,
Garden,HVA,24,5,1436,1437,1,bee walks over paper
Garden,HVA,24,5,1448,1448,0,
Garden,HVA,24,5,1475,1477,2,
Garden,HVA,24,5,1488,1488,0,
Garden,HVA,24,5,1612,1612,0,bee walks over paper
Garden,HVA,24,5,1643,1643,0,
Garden,HVA,24,5,1717,1717,0,
Garden,HVA,24,5,1796,1796,0,
Garden,HVA,24,5,1799,1799,0,
Garden,HVA,25,6,58,58,0,
Garden,HVA,25,6,62,62,0,
Garden,HVA,25,6,136,138,2,
Garden,HVA,25,6,245,245,0,
Garden,HVA,25,6,260,265,5,
Garden,HVA,25,6,261,262,1,
Garden,HVA,25,6,405,405,0,
Garden,HVA,25,6,418,418,0,
Garden,HVA,25,6,426,429,3,
Garden,HVA,25,6,461,461,0,
Garden,HVA,25,6,548,549,1,
Garden,HVA,25,6,579,579,0,
Garden,HVA,25,6,748,748,0,
Garden,HVA,25,6,781,782,1,
Garden,HVA,25,6,824,824,0,
Garden,HVA,25,6,845,846,1,
Garden,HVA,25,6,896,896,0,
Garden,HVA,25,6,981,981,0,
Garden,HVA,25,6,1034,1034,0,
Garden,HVA,25,6,1049,1050,1,
Garden,HVA,25,6,1125,1125,0,
Garden,HVA,25,6,1174,1174,0,
Garden,HVA,25,6,1308,1308,0,
Garden,HVA,25,6,1388,1390,2,
Garden,HVA,25,6,1492,1492,0,
Garden,HVA,25,6,1647,1648,1,
Garden,HVA,25,6,1661,1661,0,
Garden,HVA,25,6,1779,1783,4,
Garden,HVA,25,6,1786,1787,1,
Garden,HVA,26,9,93,93,0,
Garden,HVA,26,9,132,132,0,
Garden,HVA,26,9,165,170,5,
Garden,HVA,26,9,259,259,0,
Garden,HVA,26,9,346,349,3,
Garden,HVA,26,9,350,350,0,
Garden,HVA,26,9,453,464,11,
Garden,HVA,26,9,568,568,0,
Garden,HVA,26,9,628,631,3,
Garden,HVA,26,9,665,667,2,
Garden,HVA,26,9,764,764,0,
Garden,HVA,26,9,872,877,5,
Garden,HVA,26,9,914,914,0,
Garden,HVA,26,9,938,938,0,
Garden,HVA,26,9,952,954,2,
Garden,HVA,26,9,982,982,0,
Garden,HVA,26,9,1077,1079,2,
Garden,HVA,26,9,1137,1145,8,
Garden,HVA,26,9,1158,1161,3,
Garden,HVA,26,9,1203,1209,6,
Garden,HVA,26,9,1215,1221,6,
Garden,HVA,26,9,1272,1273,1,
Garden,HVA,26,9,1289,1291,2,
Garden,HVA,26,9,1347,1348,1,
Garden,HVA,26,9,1416,1416,0,
Garden,HVA,26,9,1450,1461,11,
Garden,HVA,26,9,1460,1467,7,
Garden,HVA,26,9,1468,1473,5,
Garden,HVA,26,9,1482,1482,0,
Garden,HVA,26,9,1489,1490,1,
Garden,HVA,26,9,1500,1500,0,
Garden,HVA,26,9,1593,1594,1,
Garden,HVA,26,9,1600,1601,1,
Garden,HVA,26,9,1732,1738,6,
Garden,HVA,28,7,103,103,0,
Garden,HVA,28,7,370,370,0,
Garden,HVA,28,7,374,374,0,
Garden,HVA,28,7,403,403,0,
Garden,HVA,28,7,412,412,0,
Garden,HVA,28,7,441,441,0,
Garden,HVA,28,7,530,530,0,
Garden,HVA,28,7,997,997,0,
Garden,HVA,28,7,1063,1064,1,
Garden,HVA,28,7,1063,1063,0,
Garden,HVA,28,7,1066,1066,0,
Garden,HVA,28,7,1114,1116,2,
Garden,HVA,28,7,1128,1128,0,
Garden,HVA,28,7,1140,1140,0,
Garden,HVA,28,7,1158,1159,1,
Garden,HVA,28,7,1221,1221,0,
Garden,HVA,28,7,1277,1277,0,
Garden,HVA,28,7,1293,1293,0,
Garden,HVA,28,7,1352,1352,0,
Garden,HVA,28,7,1508,1508,0,
Garden,HVA,28,7,1557,1558,1,
Garden,HVA,28,7,1572,1572,0,
Garden,HVA,28,7,1587,1587,0,
Garden,HVA,28,7,1601,1601,0,
Garden,HVA,28,7,1669,1669,0,
Garden,HVA,29,1,5,5,0,
Garden,HVA,29,1,33,33,0,
Garden,HVA,29,1,92,92,0,
Garden,HVA,29,1,101,101,0,
Garden,HVA,29,1,166,166,0,
Garden,HVA,29,1,239,239,0,
Garden,HVA,29,1,594,595,1,
Garden,HVA,29,1,598,599,1,
Garden,HVA,29,1,774,775,1,
Garden,HVA,29,1,857,857,0,
Garden,HVA,29,1,886,892,6,
Garden,HVA,29,1,915,917,2,
Garden,HVA,29,1,920,920,0,
Garden,HVA,29,1,1026,1026,0,
Garden,HVA,29,1,1063,1063,0,
Garden,HVA,29,1,1095,1095,0,
Garden,HVA,29,1,1249,1250,1,
Garden,HVA,29,1,1328,1328,0,
Garden,HVA,29,1,1375,1382,7,
Garden,HVA,29,1,1400,1405,5,
Garden,HVA,29,1,1414,1416,2,
Garden,HVA,29,1,1436,1438,2,
Garden,HVA,29,1,1151,1753,602,
Garden,HVA,31,9,994,994,0,
Garden,HVA,31,9,1002,1003,1,
Garden,HVA,31,9,1011,1016,5,
Garden,HVA,31,9,1019,1023,4,
Garden,HVA,31,9,1037,1039,2,
Garden,HVA,31,9,1049,1052,3,
Garden,HVA,31,9,1055,1059,4,
Garden,HVA,31,9,1068,1074,6,
Garden,HVA,31,9,1129,1129,0,
Garden,HVA,31,9,1195,1195,0,
Garden,HVA,31,9,1199,1199,0,
Garden,HVA,31,9,1206,1207,1,
Garden,HVA,31,9,1333,1334,1,
Garden,HVA,31,9,1346,1346,0,
Garden,HVA,31,9,1382,1382,0,
Garden,HVA,31,9,1403,1403,0,
Garden,HVA,31,9,1420,1420,0,
Garden,HVA,31,9,1468,1468,0,
Garden,HVA,31,9,1532,1532,0,
Garden,HVA,31,9,1551,1551,0,
Garden,HVA,31,9,1563,1563,0,
Garden,HVA,31,9,1572,1572,0,
Garden,HVA,31,9,1746,1750,4,
Garden,HVA,33,1,24,24,0,
Garden,HVA,33,1,226,246,20,bee it very close and seems very interrested pretty sure it counts but not 100%
Garden,HVA,33,1,288,297,9,"not entirely sure if bee is interrested in other bee or the paper at this point - it is near the paper for much longer than this but it seemed pretty focused onm other bee up intil, this point when it sort of turned its attention to the peper"
Garden,HVA,33,1,1264,1266,2,
Garden,HVA,33,1,1269,1269,0,
Garden,HVA,33,1,1336,1336,0,
Garden,HVA,33,1,1386,1386,0,24:58 Trophallaxis
Garden,HVA,33,1,1530,1530,0,
Garden,HVA,33,1,1533,1535,2,
Garden,HVA,33,1,1562,1562,0,
Garden,HVA,33,1,1591,1591,0,
Garden,HVA,33,1,1652,1652,0,
Garden,HVA,33,1,1699,1699,0,
Garden,HVA,33,1,1749,1749,0,
Garden,HVA,33,1,1761,1761,0,
Garden,HVA,33,1,1766,1766,0,
Garden,HVA,33,1,293,294,1,
Garden,HVA,33,1,216,1474,1258,bee lies motionless apart from a few nibbles at the paper for this whole time -not sure if it counts - the little nibbles are recorsed as definite touches in this list already
Garden,HVA,33,1,235,247,12,
Garden,HVA,33,6,92,94,2,
Garden,HVA,33,6,109,109,0,
Garden,HVA,33,6,143,143,0,
Garden,HVA,33,6,166,170,4,
Garden,HVA,33,6,195,195,0,
Garden,HVA,33,6,270,270,0,
Garden,HVA,33,6,277,281,4,
Garden,HVA,33,6,303,304,1,
Garden,HVA,33,6,468,468,0,
Garden,HVA,33,6,625,625,0,
Garden,HVA,33,6,730,730,0,touches circle around pheromone quite deliberately
Garden,HVA,33,6,750,750,0,
Garden,HVA,33,6,922,929,7,
Garden,HVA,33,6,1038,1038,0,
Garden,HVA,33,6,1302,1307,5,
Garden,HVA,33,6,1306,1306,0,
Garden,HVA,33,6,1371,1371,0,
Garden,HVA,33,6,1451,1451,0,
Garden,HVA,33,6,1493,1493,0,
Garden,HVA,33,6,1518,1519,1,
Garden,HVA,33,6,1672,1674,2,may have bumped in to it because it had no way past its sisters
Garden,HVA,34,5,229,229,0,
Garden,HVA,34,5,352,352,0,
Garden,HVA,34,5,411,411,0,
Garden,HVA,34,5,415,415,0,Was sort of just turning around when it bumped in to the paper - not sure if it counts
Garden,HVA,34,5,632,632,0,
Garden,HVA,34,5,642,642,0,
Garden,HVA,34,5,646,652,6,Bee sort of gets its legs tangled in the paper don't quite know if it counts
Garden,HVA,34,5,666,672,6,Bee rubs its but on the paper - don't know if that counts
Garden,HVA,34,5,704,704,0,Bee moves paper with its leg
Garden,HVA,34,5,724,724,0,Bee moves paper with its leg
Garden,HVA,34,5,787,787,0,
Garden,HVA,34,5,800,800,0,
Garden,HVA,34,5,814,814,0,
Garden,HVA,34,5,882,882,0,
Garden,HVA,34,5,1014,1016,2,
Garden,HVA,34,5,1170,1180,10,Bee gets a little tangled in paper
Garden,HVA,34,5,620,621,1,
Garden,HVA,34,5,638,644,6,
Garden,HVA,34,5,1468,1468,0,Bee moves paper with its leg as its turning around
Garden,HVA,34,5,1546,1546,0,
Garden,HVA,35,11,308,308,0,
Garden,HVA,35,11,332,332,0,
Garden,HVA,35,11,460,460,0,
Garden,HVA,35,11,474,474,0,
Garden,HVA,35,11,514,514,0,
Garden,HVA,35,11,854,854,0,
Garden,HVA,35,11,885,885,0,
Garden,HVA,35,11,939,939,0,
Garden,HVA,35,11,1078,1078,0,Double paper boop
Garden,HVA,35,11,1384,1445,61,
Garden,HVA,35,11,1396,1396,0,paper moved because bee moved it with its leg as it walked past
Garden,HVA,35,11,1383,1383,0,
Garden,HVA,35,11,1395,1395,0,
Garden,HVA,35,11,1612,1612,0,
Garden,HVA,35,11,1749,1752,3,
Garden,HVA,35,11,1753,1753,0,
Garden,9-HDA,20,9,11,11,0,
Garden,9-HDA,20,9,25,27,2,
Garden,9-HDA,20,9,96,97,1,
Garden,9-HDA,20,9,136,140,4,
Garden,9-HDA,20,9,167,168,1,
Garden,9-HDA,20,9,267,267,0,
Garden,9-HDA,20,9,349,352,3,
Garden,9-HDA,20,9,462,463,1,
Garden,9-HDA,20,9,477,480,3,
Garden,9-HDA,20,9,489,490,1,
Garden,9-HDA,20,9,547,550,3,
Garden,9-HDA,20,9,657,657,0,
Garden,9-HDA,20,9,699,700,1,
Garden,9-HDA,20,9,747,747,0,
Garden,9-HDA,20,9,840,840,0,
Garden,9-HDA,20,9,866,871,5,
Garden,9-HDA,20,9,968,970,2,bee walks over paper
Garden,9-HDA,20,9,1059,1059,0,
Garden,9-HDA,20,9,1122,1124,2,
Garden,9-HDA,20,9,1174,1176,2,
Garden,9-HDA,20,9,1296,1296,0,
Garden,9-HDA,20,9,1303,1305,2,
Garden,9-HDA,20,9,1412,1419,7,
Garden,9-HDA,20,9,1572,1573,1,
Garden,9-HDA,20,9,1576,1576,0,
Garden,9-HDA,20,9,1600,1603,3,
Garden,9-HDA,20,9,1614,1623,9,
Garden,9-HDA,20,9,1675,1675,0,
Garden,9-HDA,20,9,1699,1704,5,
Garden,9-HDA,20,9,1732,1732,0,
Garden,9-HDA,21,7,15,15,0,
Garden,9-HDA,21,7,42,42,0,
Garden,9-HDA,21,7,49,51,2,
Garden,9-HDA,21,7,126,129,3,
Garden,9-HDA,21,7,145,148,3,
Garden,9-HDA,21,7,192,194,2,
Garden,9-HDA,21,7,219,219,0,
Garden,9-HDA,21,7,313,315,2,
Garden,9-HDA,21,7,339,339,0,not so sure
Garden,9-HDA,21,7,357,357,0,
Garden,9-HDA,21,7,385,386,1,
Garden,9-HDA,21,7,405,405,0,
Garden,9-HDA,21,7,412,412,0,not sure
Garden,9-HDA,21,7,468,469,1,
Garden,9-HDA,21,7,587,588,1,
Garden,9-HDA,21,7,590,591,1,
Garden,9-HDA,21,7,668,669,1,
Garden,9-HDA,21,7,788,789,1,
Garden,9-HDA,21,7,793,794,1,
Garden,9-HDA,21,7,858,859,1,
Garden,9-HDA,21,7,914,914,0,
Garden,9-HDA,21,7,940,941,1,
Garden,9-HDA,21,7,949,949,0,bee walks over paper
Garden,9-HDA,21,7,1051,1053,2,
Garden,9-HDA,21,7,1105,1106,1,
Garden,9-HDA,21,7,1108,1109,1,
Garden,9-HDA,21,7,1110,1110,0,bee walks over paper
Garden,9-HDA,21,7,1132,1132,0,
Garden,9-HDA,21,7,1253,1253,0,
Garden,9-HDA,21,7,1397,1398,1,
Garden,9-HDA,21,7,1493,1493,0,
Garden,9-HDA,21,7,1495,1495,0,
Garden,9-HDA,21,7,1650,1651,1,
Garden,9-HDA,22,7,664,664,0,
Garden,9-HDA,22,7,746,746,0,probs dosen't count bee is facing paper but quite far away and its olnly very short
Garden,9-HDA,22,7,785,814,29,
Garden,9-HDA,22,7,790,792,2,
Garden,9-HDA,22,7,813,816,3,
Garden,9-HDA,22,7,933,934,1,
Garden,9-HDA,22,7,950,950,0,
Garden,9-HDA,22,7,1432,1441,9,
Garden,9-HDA,22,7,1715,1716,1,
Garden,9-HDA,22,7,1719,1721,2,
Garden,9-HDA,22,7,1742,1743,1,
Garden,9-HDA,25,4,141,141,0,
Garden,9-HDA,25,4,146,146,0,
Garden,9-HDA,25,4,149,150,1,
Garden,9-HDA,25,4,272,272,0,
Garden,9-HDA,25,4,310,310,0,
Garden,9-HDA,25,4,549,549,0,
Garden,9-HDA,25,4,605,605,0,
Garden,9-HDA,25,4,610,610,0,
Garden,9-HDA,25,4,672,672,0,
Garden,9-HDA,25,4,695,699,4,
Garden,9-HDA,25,4,699,702,3,
Garden,9-HDA,25,4,707,709,2,
Garden,9-HDA,25,4,753,754,1,
Garden,9-HDA,25,4,765,768,3,
Garden,9-HDA,25,4,770,771,1,
Garden,9-HDA,25,4,961,961,0,
Garden,9-HDA,25,4,1006,1011,5,
Garden,9-HDA,25,4,1039,1040,1,
Garden,9-HDA,25,4,1061,1061,0,
Garden,9-HDA,25,4,1063,1064,1,
Garden,9-HDA,25,4,1115,1116,1,
Garden,9-HDA,25,4,1163,1165,2,
Garden,9-HDA,25,4,1303,1303,0,
Garden,9-HDA,25,4,1329,1331,2,
Garden,9-HDA,25,4,1341,1341,0,
Garden,9-HDA,25,4,1352,1355,3,
Garden,9-HDA,25,4,1401,1401,0,
Garden,9-HDA,25,4,1412,1416,4,
Garden,9-HDA,25,4,1468,1468,0,
Garden,9-HDA,25,4,1484,1484,0,
Garden,9-HDA,25,4,1683,1683,0,
Garden,9-HDA,25,4,1684,1684,0,
Garden,9-HDA,25,4,1689,1690,1,
Garden,9-HDA,25,4,1711,1717,6,
Garden,9-HDA,25,4,1766,1767,1,
Garden,9-HDA,26,3,5,5,0,
Garden,9-HDA,26,3,8,12,4,
Garden,9-HDA,26,3,21,23,2,
Garden,9-HDA,26,3,62,62,0,
Garden,9-HDA,26,3,90,91,1,
Garden,9-HDA,26,3,106,111,5,
Garden,9-HDA,26,3,145,148,3,
Garden,9-HDA,26,3,152,152,0,
Garden,9-HDA,26,3,173,173,0,
Garden,9-HDA,26,3,175,176,1,
Garden,9-HDA,26,3,208,209,1,
Garden,9-HDA,26,3,244,246,2,
Garden,9-HDA,26,3,311,311,0,
Garden,9-HDA,26,3,384,385,1,bee walks past / on paper a bit.
Garden,9-HDA,26,3,390,393,3,
Garden,9-HDA,26,3,475,475,0,
Garden,9-HDA,26,3,483,483,0,
Garden,9-HDA,26,3,517,517,0,
Garden,9-HDA,26,3,672,672,0,
Garden,9-HDA,26,3,726,726,0,
Garden,9-HDA,26,3,734,736,2,
Garden,9-HDA,26,3,743,746,3,
Garden,9-HDA,26,3,754,756,2,
Garden,9-HDA,26,3,794,794,0,
Garden,9-HDA,26,3,950,951,1,
Garden,9-HDA,26,3,958,959,1,
Garden,9-HDA,26,3,996,998,2,
Garden,9-HDA,26,3,1018,1020,2,
Garden,9-HDA,26,3,1032,1033,1,
Garden,9-HDA,26,3,1039,1040,1,
Garden,9-HDA,26,3,1077,1077,0,
Garden,9-HDA,26,3,1127,1127,0,
Garden,9-HDA,26,3,1155,1156,1,
Garden,9-HDA,26,3,1307,1307,0,
Garden,9-HDA,26,3,1323,1324,1,
Garden,9-HDA,26,3,1413,1414,1,
Garden,9-HDA,26,3,1420,1422,2,
Garden,9-HDA,26,3,1429,1431,2,
Garden,9-HDA,26,3,1595,1595,0,
Garden,9-HDA,26,3,1634,1634,0,
Garden,9-HDA,26,3,1742,1744,2,
Garden,9-HDA,26,3,1762,1762,0,
Garden,9-HDA,28,12,31,31,0,
Garden,9-HDA,28,12,38,38,0,
Garden,9-HDA,28,12,41,41,0,
Garden,9-HDA,28,12,48,51,3,
Garden,9-HDA,28,12,51,52,1,
Garden,9-HDA,28,12,61,63,2,
Garden,9-HDA,28,12,85,86,1,
Garden,9-HDA,28,12,111,113,2,
Garden,9-HDA,28,12,113,113,0,
Garden,9-HDA,28,12,114,114,0,
Garden,9-HDA,28,12,130,130,0,
Garden,9-HDA,28,12,133,133,0,
Garden,9-HDA,28,12,169,169,0,
Garden,9-HDA,28,12,175,176,1,
Garden,9-HDA,28,12,216,216,0,
Garden,9-HDA,28,12,214,216,2,
Garden,9-HDA,28,12,227,227,0,
Garden,9-HDA,28,12,240,240,0,
Garden,9-HDA,28,12,257,257,0,
Garden,9-HDA,28,12,298,298,0,
Garden,9-HDA,28,12,307,311,4,
Garden,9-HDA,28,12,308,308,0,
Garden,9-HDA,28,12,323,324,1,
Garden,9-HDA,28,12,384,384,0,
Garden,9-HDA,28,12,414,414,0,
Garden,9-HDA,28,12,436,436,0,
Garden,9-HDA,28,12,441,443,2,
Garden,9-HDA,28,12,456,456,0,
Garden,9-HDA,28,12,527,527,0,
Garden,9-HDA,28,12,614,614,0,
Garden,9-HDA,28,12,836,836,0,doesn't touch paper but is sniffing it
Garden,9-HDA,28,12,922,923,1,
Garden,9-HDA,28,12,930,930,0,
Garden,9-HDA,28,12,944,944,0,
Garden,9-HDA,28,12,956,956,0,
Garden,9-HDA,28,12,974,974,0,
Garden,9-HDA,28,12,995,995,0,doesn't touch paper but sniffing it
Garden,9-HDA,28,12,1007,1007,0,
Garden,9-HDA,28,12,1021,1021,0,
Garden,9-HDA,28,12,1031,1032,1,
Garden,9-HDA,28,12,1116,1116,0,
Garden,9-HDA,28,12,1259,1259,0,
Garden,9-HDA,28,12,1264,1266,2,
Garden,9-HDA,28,12,1273,1275,2,doesn't touch paper but sniffing it
Garden,9-HDA,28,12,1324,1326,2,
Garden,9-HDA,28,12,1339,1340,1,
Garden,9-HDA,28,12,1488,1491,3,
Garden,9-HDA,28,12,1527,1530,3,
Garden,9-HDA,28,12,1530,1532,2,
Garden,9-HDA,28,12,1589,1591,2,
Garden,9-HDA,28,12,1601,1602,1,
Garden,9-HDA,28,12,1632,1632,0,
Garden,9-HDA,28,12,1649,1651,2,
Garden,9-HDA,28,12,1728,1728,0,
Garden,9-HDA,28,12,1742,1742,0,
Garden,9-HDA,28,12,1758,1759,1,
Garden,9-HDA,28,12,1786,1786,0,
Garden,9-HDA,29,7,78,78,0,
Garden,9-HDA,29,7,202,202,0,
Garden,9-HDA,29,7,581,581,0,
Garden,9-HDA,29,7,599,599,0,
Garden,9-HDA,29,7,693,693,0,
Garden,9-HDA,29,7,842,842,0,
Garden,9-HDA,29,7,1015,1015,0,
Garden,9-HDA,29,7,1051,1052,1,
Garden,9-HDA,29,7,1055,1056,1,
Garden,9-HDA,29,7,1071,1071,0,
Garden,9-HDA,29,7,1243,1243,0,
Garden,9-HDA,29,7,1290,1295,5,
Garden,9-HDA,29,7,1361,1363,2,
Garden,9-HDA,29,7,1470,1470,0,
Garden,9-HDA,29,7,1682,1682,0,
Garden,9-HDA,29,7,1699,1699,0,
Garden,9-HDA,29,7,1724,1724,0,
Garden,9-HDA,29,7,1730,1733,3,
Garden,9-HDA,30,10,9,10,1,
Garden,9-HDA,30,10,20,21,1,
Garden,9-HDA,30,10,29,29,0,
Garden,9-HDA,30,10,75,76,1,
Garden,9-HDA,30,10,89,89,0,
Garden,9-HDA,30,10,114,114,0,
Garden,9-HDA,30,10,124,124,0,
Garden,9-HDA,30,10,128,128,0,
Garden,9-HDA,30,10,183,187,4,
Garden,9-HDA,30,10,222,222,0,
Garden,9-HDA,30,10,229,229,0,
Garden,9-HDA,30,10,290,290,0,
Garden,9-HDA,30,10,345,345,0,
Garden,9-HDA,30,10,374,375,1,
Garden,9-HDA,30,10,419,419,0,
Garden,9-HDA,30,10,452,454,2,
Garden,9-HDA,30,10,493,493,0,
Garden,9-HDA,30,10,505,507,2,
Garden,9-HDA,30,10,513,516,3,
Garden,9-HDA,30,10,523,525,2,
Garden,9-HDA,30,10,558,562,4,
Garden,9-HDA,30,10,577,577,0,
Garden,9-HDA,30,10,588,588,0,
Garden,9-HDA,30,10,590,592,2,
Garden,9-HDA,30,10,622,626,4,
Garden,9-HDA,30,10,624,624,0,
Garden,9-HDA,30,10,633,634,1,
Garden,9-HDA,30,10,655,656,1,
Garden,9-HDA,30,10,683,683,0,
Garden,9-HDA,30,10,737,740,3,
Garden,9-HDA,30,10,795,798,3,
Garden,9-HDA,30,10,812,813,1,
Garden,9-HDA,30,10,855,856,1,
Garden,9-HDA,30,10,916,916,0,
Garden,9-HDA,30,10,1002,1004,2,
Garden,9-HDA,30,10,1042,1042,0,
Garden,9-HDA,30,10,1136,1136,0,
Garden,9-HDA,30,10,1296,1300,4,
Garden,9-HDA,30,10,1353,1355,2,
Garden,9-HDA,30,10,1553,1553,0,
Garden,9-HDA,30,10,1643,1643,0,
Garden,9-HDA,30,10,1742,1742,0,
Garden,9-HDA,30,10,1786,1786,0,
Garden,9-HDA,33,8,144,150,6,
Garden,9-HDA,33,8,164,164,0,
Garden,9-HDA,33,8,340,340,0,
Garden,9-HDA,33,8,386,386,0,
Garden,9-HDA,33,8,408,408,0,
Garden,9-HDA,33,8,465,465,0,
Garden,9-HDA,33,8,496,510,14,
Garden,9-HDA,33,8,546,546,0,
Garden,9-HDA,33,8,580,580,0,
Garden,9-HDA,33,8,586,586,0,
Garden,9-HDA,33,8,590,590,0,
Garden,9-HDA,33,8,610,611,1,
Garden,9-HDA,33,8,659,660,1,
Garden,9-HDA,33,8,674,674,0,
Garden,9-HDA,33,8,733,733,0,
Garden,9-HDA,33,8,755,761,6,
Garden,9-HDA,33,8,781,781,0,
Garden,9-HDA,33,8,785,785,0,
Garden,9-HDA,33,8,802,802,0,
Garden,9-HDA,33,8,833,833,0,
Garden,9-HDA,33,8,859,859,0,
Garden,9-HDA,33,8,893,893,0,
Garden,9-HDA,33,8,912,912,0,
Garden,9-HDA,33,8,1017,1033,16,
Garden,9-HDA,33,8,1077,1120,43,same bee that made this touch then lies there next to the paper until the end of the video with little movement
Garden,9-HDA,33,8,1121,1121,0,
Garden,9-HDA,33,8,1179,1179,0,
Garden,9-HDA,33,8,1208,1209,1,
Garden,9-HDA,33,8,1394,1399,5,
Garden,9-HDA,33,8,1401,1411,10,
Garden,9-HDA,33,8,1424,1429,5,
Garden,9-HDA,33,8,1463,1466,3,
Garden,9-HDA,33,8,1518,1519,1,
Garden,9-HDA,33,8,1520,1520,0,bee kind of touxches as it walks past not with its mouth
Garden,9-HDA,33,8,1577,1577,0,
Garden,9-HDA,33,8,1600,1600,0,
Garden,9-HDA,33,8,1677,1677,0,
Garden,9-HDA,33,8,1766,1766,0,
Garden,9-HDA,34,11,38,38,0,bee moves it with its body as it moves past
Garden,9-HDA,34,11,46,46,0,
Garden,9-HDA,34,11,121,121,0,
Garden,9-HDA,34,11,246,246,0,
Garden,9-HDA,34,11,261,261,0,
Garden,9-HDA,34,11,431,435,4,
Garden,9-HDA,34,11,444,444,0,
Garden,9-HDA,34,11,472,475,3,maybe not actually touching but very interrested
Garden,9-HDA,34,11,490,490,0,
Garden,9-HDA,34,11,498,498,0,
Garden,9-HDA,34,11,502,502,0,
Garden,9-HDA,34,11,541,541,0,
Garden,9-HDA,34,11,555,555,0,
Garden,9-HDA,34,11,1048,1048,0,
Garden,9-HDA,34,11,1072,1072,0,bee moves paper with leg as it walks past
Garden,9-HDA,34,11,1100,1100,0,
Garden,9-HDA,34,11,1128,1128,0,
Garden,9-HDA,34,11,1138,1138,0,
Garden,9-HDA,34,11,1122,1122,0,bee brushes it as it walks past
Garden,9-HDA,34,11,1203,1203,0,
Garden,9-HDA,34,11,1222,1224,2,bee brushes past ans has a bit of a sniff
Garden,9-HDA,34,11,1119,1119,0,bee moves it with its legs as it walks past
Garden,9-HDA,34,11,1308,1308,0,
Garden,9-HDA,34,11,1330,1331,1,
Garden,9-HDA,34,11,1338,1343,5,
Garden,9-HDA,34,11,1344,1350,6,Trophallaxis
Garden,9-HDA,34,11,1368,1376,8,
Garden,9-HDA,34,11,1401,1404,3,bee moves paper with its legs and sniff
Garden,9-HDA,34,11,1472,1472,0,bee moves it with its legs as it walks past
Garden,9-HDA,34,11,1474,1474,0,
Garden,9-HDA,34,11,1558,1558,0,
Garden,9-HDA,34,11,1614,1614,0,
Garden,9-HDA,34,11,1642,1642,0,
Garden,9-HDA,34,11,1752,1753,1,
Garden,9-HDA,34,11,1774,1774,0,
Garden,9-HDA,35,5,1010,1010,0,
Garden,9-HDA,35,5,1638,1638,0,
Garden,9-ODA,20,12,52,52,0,
Garden,9-ODA,20,12,59,59,0,
Garden,9-ODA,20,12,76,78,2,
Garden,9-ODA,20,12,82,85,3,bee is acting strange near paper until 1:32
Garden,9-ODA,20,12,92,102,10,
Garden,9-ODA,20,12,106,111,5,
Garden,9-ODA,20,12,106,108,2,
Garden,9-ODA,20,12,111,112,1,
Garden,9-ODA,20,12,125,129,4,
Garden,9-ODA,20,12,127,138,11,
Garden,9-ODA,20,12,143,144,1,
Garden,9-ODA,20,12,171,185,14,
Garden,9-ODA,20,12,180,195,15,
Garden,9-ODA,20,12,192,229,37,
Garden,9-ODA,20,12,235,236,1,
Garden,9-ODA,20,12,235,236,1,
Garden,9-ODA,20,12,252,252,0,
Garden,9-ODA,20,12,327,327,0,
Garden,9-ODA,20,12,341,342,1,
Garden,9-ODA,20,12,371,371,0,
Garden,9-ODA,20,12,399,399,0,
Garden,9-ODA,20,12,441,441,0,
Garden,9-ODA,20,12,454,455,1,
Garden,9-ODA,20,12,539,539,0,
Garden,9-ODA,20,12,604,604,0,
Garden,9-ODA,20,12,764,765,1,
Garden,9-ODA,20,12,821,821,0,
Garden,9-ODA,20,12,931,936,5,
Garden,9-ODA,20,12,954,956,2,
Garden,9-ODA,20,12,1027,1027,0,
Garden,9-ODA,20,12,1115,1117,2,
Garden,9-ODA,20,12,1123,1123,0,
Garden,9-ODA,20,12,1125,1125,0,
Garden,9-ODA,20,12,1187,1189,2,
Garden,9-ODA,20,12,1225,1229,4,
Garden,9-ODA,20,12,1406,1409,3,
Garden,9-ODA,20,12,1443,1443,0,
Garden,9-ODA,20,12,1453,1454,1,
Garden,9-ODA,20,12,1506,1508,2,
Garden,9-ODA,20,12,1531,1531,0,
Garden,9-ODA,20,12,1709,1709,0,
Garden,9-ODA,20,12,1722,1722,0,
Garden,9-ODA,21,6,0,2,2,
Garden,9-ODA,21,6,1,40,39,
Garden,9-ODA,21,6,9,40,31,
Garden,9-ODA,21,6,28,29,1,
Garden,9-ODA,21,6,44,57,13,
Garden,9-ODA,21,6,44,69,25,
Garden,9-ODA,21,6,61,96,35,
Garden,9-ODA,21,6,78,87,9,
Garden,9-ODA,21,6,104,105,1,
Garden,9-ODA,21,6,163,176,13,
Garden,9-ODA,21,6,206,207,1,
Garden,9-ODA,21,6,220,220,0,lunges towards paper from afar
Garden,9-ODA,21,6,224,228,4,
Garden,9-ODA,21,6,256,260,4,
Garden,9-ODA,21,6,269,269,0,
Garden,9-ODA,21,6,380,433,53,
Garden,9-ODA,21,6,533,534,1,
Garden,9-ODA,21,6,542,545,3,
Garden,9-ODA,21,6,570,571,1,
Garden,9-ODA,21,6,582,584,2,
Garden,9-ODA,21,6,592,597,5,bee sniffs from afar I think
Garden,9-ODA,21,6,648,651,3,
Garden,9-ODA,21,6,751,1292,541,
Garden,9-ODA,21,6,890,904,14,
Garden,9-ODA,21,6,1258,1288,30,
Garden,9-ODA,21,6,1309,1310,1,
Garden,9-ODA,21,6,1438,1444,6,
Garden,9-ODA,21,6,1470,1770,300,
Garden,9-ODA,21,6,1724,1725,1,
Garden,9-ODA,21,6,1769,1772,3,
Garden,9-ODA,21,6,1777,1800,23,
Garden,9-ODA,21,6,1795,1795,0,
Garden,9-ODA,22,6,5,12,7,
Garden,9-ODA,22,6,21,71,50,
Garden,9-ODA,22,6,76,222,146,
Garden,9-ODA,22,6,226,226,0,
Garden,9-ODA,22,6,232,249,17,
Garden,9-ODA,22,6,275,275,0,
Garden,9-ODA,22,6,280,280,0,
Garden,9-ODA,22,6,283,285,2,
Garden,9-ODA,22,6,287,335,48,
Garden,9-ODA,22,6,353,393,40,
Garden,9-ODA,22,6,397,999,602,bee sniffing occasionally sitting with its face on the paper
Garden,9-ODA,22,6,771,774,3,
Garden,9-ODA,22,6,1016,1678,662,end of this period bee is still next to the paper but it is no longer quite facing it. stays there until the very end when it sniffs again (29:53 to 30:00)
Garden,9-ODA,22,6,1118,1124,6,
Garden,9-ODA,22,6,1290,1291,1,
Garden,9-ODA,22,6,1323,1332,9,
Garden,9-ODA,22,6,1793,1800,7,
Garden,9-ODA,24,6,6,7,1,
Garden,9-ODA,24,6,18,20,2,
Garden,9-ODA,24,6,22,22,0,
Garden,9-ODA,24,6,32,32,0,
Garden,9-ODA,24,6,75,75,0,
Garden,9-ODA,24,6,84,84,0,
Garden,9-ODA,24,6,109,110,1,
Garden,9-ODA,24,6,110,110,0,
Garden,9-ODA,24,6,111,111,0,
Garden,9-ODA,24,6,115,117,2,
Garden,9-ODA,24,6,134,137,3,
Garden,9-ODA,24,6,189,189,0,
Garden,9-ODA,24,6,196,196,0,
Garden,9-ODA,24,6,202,207,5,
Garden,9-ODA,24,6,210,210,0,
Garden,9-ODA,24,6,218,218,0,
Garden,9-ODA,24,6,209,209,0,
Garden,9-ODA,24,6,223,223,0,
Garden,9-ODA,24,6,235,235,0,
Garden,9-ODA,24,6,262,262,0,bee brushes past paper
Garden,9-ODA,24,6,276,276,0,
Garden,9-ODA,24,6,282,282,0,
Garden,9-ODA,24,6,341,342,1,
Garden,9-ODA,24,6,344,344,0,
Garden,9-ODA,24,6,346,349,3,
Garden,9-ODA,24,6,396,398,2,
Garden,9-ODA,24,6,400,400,0,
Garden,9-ODA,24,6,449,449,0,
Garden,9-ODA,24,6,456,456,0,
Garden,9-ODA,24,6,489,489,0,
Garden,9-ODA,24,6,542,545,3,
Garden,9-ODA,24,6,580,581,1,
Garden,9-ODA,24,6,593,596,3,
Garden,9-ODA,24,6,599,601,2,
Garden,9-ODA,24,6,602,603,1,
Garden,9-ODA,24,6,604,605,1,
Garden,9-ODA,24,6,619,619,0,
Garden,9-ODA,24,6,622,622,0,
Garden,9-ODA,24,6,670,670,0,
Garden,9-ODA,24,6,702,704,2,
Garden,9-ODA,24,6,753,753,0,
Garden,9-ODA,24,6,788,792,4,
Garden,9-ODA,24,6,797,797,0,
Garden,9-ODA,24,6,847,848,1,
Garden,9-ODA,24,6,858,860,2,
Garden,9-ODA,24,6,893,896,3,
Garden,9-ODA,24,6,904,904,0,
Garden,9-ODA,24,6,939,940,1,
Garden,9-ODA,24,6,946,947,1,
Garden,9-ODA,24,6,1029,1031,2,
Garden,9-ODA,24,6,1036,1039,3,
Garden,9-ODA,24,6,1077,1077,0,
Garden,9-ODA,24,6,1086,1090,4,
Garden,9-ODA,24,6,1092,1092,0,
Garden,9-ODA,24,6,1096,1096,0,
Garden,9-ODA,24,6,1102,1105,3,
Garden,9-ODA,24,6,1121,1126,5,
Garden,9-ODA,24,6,1141,1141,0,
Garden,9-ODA,24,6,1161,1164,3,
Garden,9-ODA,24,6,1171,1171,0,
Garden,9-ODA,24,6,1219,1223,4,
Garden,9-ODA,24,6,1244,1244,0,
Garden,9-ODA,24,6,1255,1255,0,
Garden,9-ODA,24,6,1275,1275,0,
Garden,9-ODA,24,6,1299,1301,2,
Garden,9-ODA,24,6,1337,1338,1,
Garden,9-ODA,24,6,1383,1384,1,
Garden,9-ODA,24,6,1408,1408,0,
Garden,9-ODA,24,6,1410,1410,0,
Garden,9-ODA,24,6,1425,1425,0,
Garden,9-ODA,24,6,1434,1435,1,
Garden,9-ODA,24,6,1434,1441,7,24:05 it walks away from paper it was just sitting next to it for a few seconds
Garden,9-ODA,24,6,1460,1460,0,
Garden,9-ODA,24,6,1481,1482,1,
Garden,9-ODA,24,6,1488,1488,0,
Garden,9-ODA,24,6,1512,1512,0,
Garden,9-ODA,24,6,1523,1523,0,
Garden,9-ODA,24,6,1528,1529,1,
Garden,9-ODA,24,6,1546,1546,0,
Garden,9-ODA,24,6,1636,1642,6,
Garden,9-ODA,24,6,1650,1650,0,
Garden,9-ODA,24,6,1659,1662,3,
Garden,9-ODA,24,6,1721,1722,1,
Garden,9-ODA,24,6,1736,1736,0,
Garden,9-ODA,24,6,1739,1739,0,
Garden,9-ODA,24,6,1746,1747,1,
Garden,9-ODA,24,6,1154,1759,605,
Garden,9-ODA,24,6,1762,1763,1,
Garden,9-ODA,24,6,1779,1779,0,
Garden,9-ODA,24,6,1780,1780,0,
Garden,9-ODA,25,3,3,5,2,
Garden,9-ODA,25,3,23,23,0,
Garden,9-ODA,25,3,34,34,0,
Garden,9-ODA,25,3,45,48,3,
Garden,9-ODA,25,3,60,61,1,
Garden,9-ODA,25,3,102,102,0,
Garden,9-ODA,25,3,113,115,2,
Garden,9-ODA,25,3,126,132,6,
Garden,9-ODA,25,3,151,159,8,
Garden,9-ODA,25,3,168,169,1,
Garden,9-ODA,25,3,234,236,2,
Garden,9-ODA,25,3,239,250,11,
Garden,9-ODA,25,3,265,266,1,
Garden,9-ODA,25,3,288,288,0,
Garden,9-ODA,25,3,331,333,2,
Garden,9-ODA,25,3,340,341,1,
Garden,9-ODA,25,3,367,367,0,
Garden,9-ODA,25,3,390,393,3,
Garden,9-ODA,25,3,498,501,3,
Garden,9-ODA,25,3,539,539,0,
Garden,9-ODA,25,3,557,563,6,
Garden,9-ODA,25,3,572,580,8,
Garden,9-ODA,25,3,582,583,1,
Garden,9-ODA,25,3,595,596,1,
Garden,9-ODA,25,3,626,629,3,
Garden,9-ODA,25,3,643,644,1,
Garden,9-ODA,25,3,649,649,0,
Garden,9-ODA,25,3,677,680,3,
Garden,9-ODA,25,3,706,712,6,
Garden,9-ODA,25,3,746,760,14,
Garden,9-ODA,25,3,771,771,0,
Garden,9-ODA,25,3,791,793,2,
Garden,9-ODA,25,3,877,877,0,
Garden,9-ODA,25,3,886,888,2,
Garden,9-ODA,25,3,892,892,0,
Garden,9-ODA,25,3,920,920,0,
Garden,9-ODA,25,3,1019,1022,3,
Garden,9-ODA,25,3,1026,1027,1,
Garden,9-ODA,25,3,1037,1042,5,
Garden,9-ODA,25,3,1050,1050,0,
Garden,9-ODA,25,3,1105,1106,1,
Garden,9-ODA,25,3,1223,1223,0,
Garden,9-ODA,25,3,1422,1423,1,
Garden,9-ODA,25,3,1453,1453,0,
Garden,9-ODA,25,3,1548,1549,1,
Garden,9-ODA,25,3,1605,1605,0,
Garden,9-ODA,25,3,1743,1743,0,
Garden,9-ODA,26,2,21,21,0,
Garden,9-ODA,26,2,34,34,0,
Garden,9-ODA,26,2,49,50,1,
Garden,9-ODA,26,2,144,150,6,
Garden,9-ODA,26,2,159,162,3,
Garden,9-ODA,26,2,177,178,1,
Garden,9-ODA,26,2,180,187,7,
Garden,9-ODA,26,2,190,192,2,
Garden,9-ODA,26,2,195,198,3,
Garden,9-ODA,26,2,211,212,1,
Garden,9-ODA,26,2,265,265,0,
Garden,9-ODA,26,2,332,333,1,
Garden,9-ODA,26,2,339,339,0,
Garden,9-ODA,26,2,390,391,1,
Garden,9-ODA,26,2,461,467,6,
Garden,9-ODA,26,2,549,553,4,
Garden,9-ODA,26,2,557,565,8,
Garden,9-ODA,26,2,575,576,1,
Garden,9-ODA,26,2,601,603,2,
Garden,9-ODA,26,2,693,695,2,
Garden,9-ODA,26,2,750,751,1,
Garden,9-ODA,26,2,752,754,2,
Garden,9-ODA,26,2,773,774,1,
Garden,9-ODA,26,2,783,783,0,
Garden,9-ODA,26,2,840,841,1,
Garden,9-ODA,26,2,921,939,18,bee almost motionless but it does seem to be sort of sniffing
Garden,9-ODA,26,2,983,983,0,
Garden,9-ODA,26,2,1006,1008,2,two bee in synchrony go and touch paper
Garden,9-ODA,26,2,1006,1008,2,
Garden,9-ODA,26,2,1026,1026,0,
Garden,9-ODA,26,2,1040,1042,2,
Garden,9-ODA,26,2,1099,1099,0,
Garden,9-ODA,26,2,1108,1109,1,
Garden,9-ODA,26,2,1114,1116,2,
Garden,9-ODA,26,2,1229,1229,0,
Garden,9-ODA,26,2,1240,1243,3,
Garden,9-ODA,26,2,1206,1207,1,
Garden,9-ODA,26,2,1307,1310,3,
Garden,9-ODA,26,2,1311,1313,2,
Garden,9-ODA,26,2,1372,1372,0,
Garden,9-ODA,26,2,1372,1373,1,
Garden,9-ODA,26,2,1395,1413,18,bee sort of sits on paper for a bit but it definitely is interrested
Garden,9-ODA,26,2,1449,1449,0,
Garden,9-ODA,26,2,1455,1455,0,
Garden,9-ODA,26,2,1474,1474,0,
Garden,9-ODA,26,2,1704,1708,4,
Garden,9-ODA,26,2,1732,1734,2,
Garden,9-ODA,28,11,4,7,3,
Garden,9-ODA,28,11,24,62,38,
Garden,9-ODA,28,11,95,99,4,
Garden,9-ODA,28,11,108,110,2,
Garden,9-ODA,28,11,178,219,41,
Garden,9-ODA,28,11,233,252,19,
Garden,9-ODA,28,11,255,257,2,
Garden,9-ODA,28,11,261,338,77,
Garden,9-ODA,28,11,316,326,10,
Garden,9-ODA,28,11,322,325,3,
Garden,9-ODA,28,11,353,358,5,
Garden,9-ODA,28,11,390,390,0,
Garden,9-ODA,28,11,393,401,8,
Garden,9-ODA,28,11,401,401,0,
Garden,9-ODA,28,11,499,504,5,
Garden,9-ODA,28,11,537,543,6,
Garden,9-ODA,28,11,550,598,48,bee sort of sits next to it or on it - doesn't really seem to be sniffing it
Garden,9-ODA,28,11,592,605,13,
Garden,9-ODA,28,11,610,615,5,
Garden,9-ODA,28,11,641,650,9,
Garden,9-ODA,28,11,657,668,11,"again, bee is real close to it but its head is not towards paper, it is sitting right next to the paper"
Garden,9-ODA,28,11,709,709,0,
Garden,9-ODA,28,11,773,778,5,paper moved to the edge of the plate about this time. it gets a little trampled from now on
Garden,9-ODA,28,11,792,800,8,
Garden,9-ODA,28,11,814,823,9,bee continues to sit on paper beyond this point but it is licking annother bee-not paying attention to the paper
Garden,9-ODA,28,11,830,843,13,
Garden,9-ODA,28,11,878,880,2,
Garden,9-ODA,28,11,884,886,2,
Garden,9-ODA,28,11,889,893,4,
Garden,9-ODA,28,11,923,936,13,
Garden,9-ODA,28,11,951,960,9,
Garden,9-ODA,28,11,965,973,8,
Garden,9-ODA,28,11,968,978,10,
Garden,9-ODA,28,11,988,991,3,
Garden,9-ODA,28,11,990,992,2,bee walks across paper
Garden,9-ODA,28,11,999,999,0,
Garden,9-ODA,28,11,1024,1032,8,
Garden,9-ODA,28,11,1036,1040,4,
Garden,9-ODA,28,11,1043,1046,3,
Garden,9-ODA,28,11,1053,1054,1,
Garden,9-ODA,28,11,1065,1072,7,
Garden,9-ODA,28,11,1070,1073,3,bee walks over it
Garden,9-ODA,28,11,1075,1076,1,
Garden,9-ODA,28,11,1086,1089,3,bee walks over paper
Garden,9-ODA,28,11,1109,1110,1,bee sniffs for this long and then it walks over the paper 18:34 is when it stops touching it
Garden,9-ODA,28,11,1118,1124,6,
Garden,9-ODA,28,11,1130,1144,14,bee sit on paper until 19:21 but no sniffing really
Garden,9-ODA,28,11,1140,1142,2,
Garden,9-ODA,28,11,1155,1158,3,
Garden,9-ODA,28,11,1163,1171,8,
Garden,9-ODA,28,11,1169,1172,3,bee walks over paper
Garden,9-ODA,28,11,1181,1181,0,
Garden,9-ODA,28,11,1183,1214,31,bee sits next to paper until 20:32
Garden,9-ODA,28,11,1207,1207,0,
Garden,9-ODA,28,11,1207,1209,2,
Garden,9-ODA,28,11,1267,1267,0,
Garden,9-ODA,28,11,1271,1276,5,
Garden,9-ODA,28,11,1274,1277,3,
Garden,9-ODA,28,11,1281,1289,8,
Garden,9-ODA,28,11,1288,1299,11,
Garden,9-ODA,28,11,1299,1308,9,
Garden,9-ODA,28,11,1302,1307,5,
Garden,9-ODA,28,11,1308,1311,3,
Garden,9-ODA,28,11,1320,1326,6,
Garden,9-ODA,28,11,1333,1339,6,
Garden,9-ODA,28,11,1352,1356,4,
Garden,9-ODA,28,11,1353,1362,9,
Garden,9-ODA,28,11,1385,1410,25,
Garden,9-ODA,28,11,1388,1390,2,
Garden,9-ODA,28,11,1395,1403,8,
Garden,9-ODA,28,11,1424,1433,9,
Garden,9-ODA,28,11,1452,1459,7,
Garden,9-ODA,28,11,1478,1480,2,
Garden,9-ODA,28,11,1487,1492,5,
Garden,9-ODA,28,11,1496,1497,1,
Garden,9-ODA,28,11,1515,1530,15,
Garden,9-ODA,28,11,1533,1534,1,
Garden,9-ODA,28,11,1549,1552,3,
Garden,9-ODA,28,11,1554,1555,1,
Garden,9-ODA,28,11,1572,1588,16,
Garden,9-ODA,28,11,1583,1585,2,bee walks over paper
Garden,9-ODA,28,11,1597,1600,3,bee walks over paper
Garden,9-ODA,28,11,1609,1612,3,bee sort of walks over it sort of stops and sniffs a little
Garden,9-ODA,28,11,1624,1630,6,
Garden,9-ODA,28,11,1646,1651,5,bee walks over paper
Garden,9-ODA,28,11,1655,1670,15,
Garden,9-ODA,28,11,1657,1664,7,
Garden,9-ODA,28,11,1667,1674,7,
Garden,9-ODA,28,11,1674,1677,3,bee walks over paper
Garden,9-ODA,28,11,1683,1690,7,
Garden,9-ODA,28,11,1688,1690,2,
Garden,9-ODA,28,11,1693,1713,20,
Garden,9-ODA,28,11,1713,1725,12,
Garden,9-ODA,28,11,1742,1742,0,
Garden,9-ODA,28,11,1744,1746,2,
Garden,9-ODA,28,11,1752,1764,12,
Garden,9-ODA,29,6,10,10,0,
Garden,9-ODA,29,6,62,62,0,
Garden,9-ODA,29,6,67,72,5,
Garden,9-ODA,29,6,90,90,0,
Garden,9-ODA,29,6,136,138,2,
Garden,9-ODA,29,6,172,174,2,
Garden,9-ODA,29,6,187,187,0,
Garden,9-ODA,29,6,208,209,1,
Garden,9-ODA,29,6,271,271,0,
Garden,9-ODA,29,6,386,386,0,
Garden,9-ODA,29,6,439,440,1,
Garden,9-ODA,29,6,666,666,0,
Garden,9-ODA,29,6,676,677,1,
Garden,9-ODA,29,6,705,706,1,
Garden,9-ODA,29,6,838,841,3,
Garden,9-ODA,29,6,972,972,0,
Garden,9-ODA,29,6,1e3,1e3,0,
Garden,9-ODA,29,6,1180,1180,0,
Garden,9-ODA,29,6,1224,1224,0,
Garden,9-ODA,29,6,1245,1245,0,
Garden,9-ODA,29,6,1263,1263,0,
Garden,9-ODA,29,6,1339,1340,1,
Garden,9-ODA,29,6,1448,1448,0,
Garden,9-ODA,29,6,1486,1486,0,
Garden,9-ODA,29,6,1614,1615,1,
Garden,9-ODA,29,6,1662,1662,0,
Garden,9-ODA,29,6,1677,1677,0,
Garden,9-ODA,29,6,1688,1689,1,
Garden,9-ODA,29,6,1785,1785,0,
Garden,9-ODA,29,6,1786,1786,0,
Garden,9-ODA,30,9,5,8,3,
Garden,9-ODA,30,9,142,142,0,
Garden,9-ODA,30,9,184,184,0,
Garden,9-ODA,30,9,191,192,1,
Garden,9-ODA,30,9,258,260,2,
Garden,9-ODA,30,9,313,313,0,
Garden,9-ODA,30,9,331,332,1,
Garden,9-ODA,30,9,436,436,0,
Garden,9-ODA,30,9,436,445,9,
Garden,9-ODA,30,9,466,474,8,
Garden,9-ODA,30,9,498,498,0,
Garden,9-ODA,30,9,503,503,0,
Garden,9-ODA,30,9,543,543,0,
Garden,9-ODA,30,9,563,563,0,
Garden,9-ODA,30,9,564,564,0,
Garden,9-ODA,30,9,581,581,0,
Garden,9-ODA,30,9,586,586,0,
Garden,9-ODA,30,9,628,629,1,
Garden,9-ODA,30,9,632,632,0,
Garden,9-ODA,30,9,663,663,0,
Garden,9-ODA,30,9,681,681,0,
Garden,9-ODA,30,9,706,706,0,
Garden,9-ODA,30,9,764,764,0,
Garden,9-ODA,30,9,791,792,1,
Garden,9-ODA,30,9,819,820,1,
Garden,9-ODA,30,9,844,851,7,
Garden,9-ODA,30,9,873,873,0,
Garden,9-ODA,30,9,896,900,4,
Garden,9-ODA,30,9,983,983,0,
Garden,9-ODA,30,9,1175,1178,3,
Garden,9-ODA,30,9,1230,1231,1,
Garden,9-ODA,30,9,1240,1241,1,
Garden,9-ODA,30,9,1281,1284,3,
Garden,9-ODA,30,9,1324,1330,6,
Garden,9-ODA,30,9,1368,1370,2,
Garden,9-ODA,30,9,1447,1447,0,
Garden,9-ODA,30,9,1464,1473,9,
Garden,9-ODA,30,9,1615,1620,5,
Garden,9-ODA,30,9,1719,1720,1,
Garden,9-ODA,31,2,254,255,1,
Garden,9-ODA,31,2,382,386,4,
Garden,9-ODA,31,2,393,394,1,
Garden,9-ODA,31,2,449,449,0,
Garden,9-ODA,31,2,562,564,2,
Garden,9-ODA,31,2,580,585,5,
Garden,9-ODA,31,2,590,590,0,
Garden,9-ODA,31,2,691,691,0,
Garden,9-ODA,31,2,925,927,2,
Garden,9-ODA,31,2,963,966,3,
Garden,9-ODA,31,2,1095,1097,2,
Garden,9-ODA,31,2,1109,1109,0,
Garden,9-ODA,31,2,1114,1114,0,
Garden,9-ODA,31,2,1212,1218,6,
Garden,9-ODA,31,2,1226,1228,2,
Garden,9-ODA,31,2,1230,1242,12,
Garden,9-ODA,31,2,1259,1259,0,
Garden,9-ODA,31,2,1494,1495,1,
Garden,9-ODA,31,2,1592,1599,7,
Garden,9-ODA,31,2,1595,1595,0,
Garden,9-ODA,31,2,1682,1683,1,
Garden,9-ODA,33,4,6,6,0,turns around and sort of bumps in to it not sure if counts
Garden,9-ODA,33,4,43,46,3,bee not quite touching but seems very interrested
Garden,9-ODA,33,4,101,101,0,
Garden,9-ODA,33,4,115,115,0,
Garden,9-ODA,33,4,176,176,0,
Garden,9-ODA,33,4,192,192,0,
Garden,9-ODA,33,4,202,202,0,
Garden,9-ODA,33,4,218,218,0,
Garden,9-ODA,33,4,260,260,0,
Garden,9-ODA,33,4,290,290,0,
Garden,9-ODA,33,4,376,378,2,not actually touching but super interrested
Garden,9-ODA,33,4,395,395,0,
Garden,9-ODA,33,4,421,421,0,
Garden,9-ODA,33,4,465,465,0,
Garden,9-ODA,33,4,554,554,0,
Garden,9-ODA,33,4,611,611,0,not sure
Garden,9-ODA,33,4,624,624,0,
Garden,9-ODA,33,4,639,639,0,
Garden,9-ODA,33,4,680,680,0,
Garden,9-ODA,33,4,765,765,0,
Garden,9-ODA,33,4,783,783,0,
Garden,9-ODA,33,4,796,796,0,
Garden,9-ODA,33,4,810,810,0,sort of lunges towards it not sure iof it touches or counts
Garden,9-ODA,33,4,813,813,0,
Garden,9-ODA,33,4,835,835,0,touches circle around paper quite deliberately
Garden,9-ODA,33,4,854,854,0,
Garden,9-ODA,33,4,815,815,0,
Garden,9-ODA,33,4,902,902,0,
Garden,9-ODA,33,4,993,993,0,
Garden,9-ODA,33,4,998,1e3,2,
Garden,9-ODA,33,4,1027,1027,0,
Garden,9-ODA,33,4,1142,1146,4,
Garden,9-ODA,33,4,1446,1446,0,
Garden,9-ODA,33,4,1618,1618,0,
Garden,9-ODA,34,10,58,58,0,bee moves paper with leg
Garden,9-ODA,34,10,82,82,0,
Garden,9-ODA,34,10,84,84,0,
Garden,9-ODA,34,10,105,105,0,
Garden,9-ODA,34,10,168,168,0,
Garden,9-ODA,34,10,196,196,0,
Garden,9-ODA,34,10,254,256,2,
Garden,9-ODA,34,10,269,270,1,
Garden,9-ODA,34,10,284,347,63,one bee is really going for it
Garden,9-ODA,34,10,366,366,0,bee knocks paper with its rear
Garden,9-ODA,34,10,371,404,33,
Garden,9-ODA,34,10,479,497,18,
Garden,9-ODA,34,10,556,557,1,
Garden,9-ODA,34,10,566,606,40,
Garden,9-ODA,34,10,639,653,14,
Garden,9-ODA,34,10,647,647,0,
Garden,9-ODA,34,10,654,665,11,
Garden,9-ODA,34,10,683,685,2,13:24 Trophallaxis
Garden,9-ODA,34,10,837,837,0,
Garden,9-ODA,34,10,904,904,0,not sure
Garden,9-ODA,34,10,929,929,0,
Garden,9-ODA,34,10,954,954,0,
Garden,9-ODA,34,10,960,960,0,
Garden,9-ODA,34,10,981,981,0,
Garden,9-ODA,34,10,1043,1046,3,
Garden,9-ODA,34,10,1086,1094,8,
Garden,9-ODA,34,10,1114,1119,5,
Garden,9-ODA,34,10,1161,1161,0,bee moves paper with leg as it walks past
Garden,9-ODA,34,10,1181,1181,0,
Garden,9-ODA,34,10,1182,1182,0,
Garden,9-ODA,34,10,1214,1214,0,
Garden,9-ODA,34,10,1216,1222,6,
Garden,9-ODA,34,10,1292,1292,0,bee moves it with its leg as it walks by
Garden,9-ODA,34,10,1316,1326,10,
Garden,9-ODA,34,10,1416,1416,0,
Garden,9-ODA,34,10,1441,1441,0,
Garden,9-ODA,34,10,1501,1501,0,
Garden,9-ODA,34,10,1663,1665,2,
Garden,9-ODA,35,2,949,949,0,
Garden,9-ODA,35,2,1068,1068,0,"Seems to walk past, have a quick sniff and then go back in for a second"
Garden,9-ODA,35,2,1094,1096,2,"Has a sniff, walks past and then moves it around by accidentally walking over it"
Garden,9-ODA,35,2,1111,1111,0,
Garden,9-ODA,35,2,1213,1213,0,
Garden,9-ODA,35,2,1258,1259,1,Double take and sniff
Garden,9-ODA,35,2,1288,1288,0,
Garden,9-ODA,35,2,1300,1301,1,
Garden,9-ODA,35,2,1327,1327,0,
Garden,9-ODA,35,2,1452,1452,0,
Garden,9-ODA,35,2,1561,1561,0,
Garden,9-ODA,35,2,1586,1589,3,
Garden,9-ODA,35,2,1607,1607,0,
Garden,9-ODA,35,2,1617,1622,5,
Garden,9-ODA,35,2,1652,1653,1,
Garden,9-ODA,35,2,1684,1684,0,
Garden,9-ODA,35,2,1728,1728,0,
Garden,9-ODA,35,2,1778,1778,0,
Garden,HOB and HVA,20,10,12,12,0,
Garden,HOB and HVA,20,10,42,43,1,
Garden,HOB and HVA,20,10,48,48,0,
Garden,HOB and HVA,20,10,65,66,1,
Garden,HOB and HVA,20,10,174,174,0,
Garden,HOB and HVA,20,10,179,179,0,
Garden,HOB and HVA,20,10,192,192,0,
Garden,HOB and HVA,20,10,387,389,2,
Garden,HOB and HVA,20,10,390,390,0,
Garden,HOB and HVA,20,10,461,461,0,
Garden,HOB and HVA,20,10,564,564,0,
Garden,HOB and HVA,20,10,577,577,0,
Garden,HOB and HVA,20,10,587,587,0,
Garden,HOB and HVA,20,10,634,634,0,
Garden,HOB and HVA,20,10,641,641,0,
Garden,HOB and HVA,20,10,676,679,3,
Garden,HOB and HVA,20,10,855,856,1,
Garden,HOB and HVA,20,10,982,983,1,
Garden,HOB and HVA,20,10,997,997,0,
Garden,HOB and HVA,20,10,999,1e3,1,
Garden,HOB and HVA,20,10,1006,1007,1,
Garden,HOB and HVA,20,10,1010,1012,2,
Garden,HOB and HVA,20,10,1105,1105,0,bee sort of walks in to paper
Garden,HOB and HVA,20,10,1143,1144,1,
Garden,HOB and HVA,20,10,1327,1327,0,
Garden,HOB and HVA,20,10,1354,1354,0,
Garden,HOB and HVA,20,10,1447,1447,0,
Garden,HOB and HVA,20,10,1449,1451,2,
Garden,HOB and HVA,20,10,1480,1480,0,
Garden,HOB and HVA,20,10,1551,1551,0,bee sort of tips towards paper as it walks past
Garden,HOB and HVA,20,10,1562,1562,0,
Garden,HOB and HVA,20,10,1583,1583,0,
Garden,HOB and HVA,20,10,1595,1596,1,
Garden,HOB and HVA,20,10,1672,1675,3,
Garden,HOB and HVA,20,10,1689,1690,1,
Garden,HOB and HVA,20,10,1740,1740,0,
Garden,HOB and HVA,20,10,1748,1750,2,
Garden,HOB and HVA,21,8,10,11,1,
Garden,HOB and HVA,21,8,13,15,2,
Garden,HOB and HVA,21,8,31,32,1,
Garden,HOB and HVA,21,8,107,113,6,"bee sniffs from afar, not entirely sure it counts"
Garden,HOB and HVA,21,8,117,118,1,
Garden,HOB and HVA,21,8,179,181,2,
Garden,HOB and HVA,21,8,227,228,1,
Garden,HOB and HVA,21,8,244,252,8,
Garden,HOB and HVA,21,8,287,289,2,
Garden,HOB and HVA,21,8,288,290,2,
Garden,HOB and HVA,21,8,341,341,0,
Garden,HOB and HVA,21,8,347,348,1,
Garden,HOB and HVA,21,8,360,360,0,
Garden,HOB and HVA,21,8,366,367,1,
Garden,HOB and HVA,21,8,380,380,0,
Garden,HOB and HVA,21,8,415,417,2,
Garden,HOB and HVA,21,8,425,425,0,
Garden,HOB and HVA,21,8,597,597,0,
Garden,HOB and HVA,21,8,620,620,0,
Garden,HOB and HVA,21,8,661,661,0,
Garden,HOB and HVA,21,8,882,882,0,
Garden,HOB and HVA,21,8,883,884,1,
Garden,HOB and HVA,21,8,938,938,0,
Garden,HOB and HVA,21,8,1004,1004,0,"not sure if it counts, bee sort of walks in to paper"
Garden,HOB and HVA,21,8,1029,1031,2,
Garden,HOB and HVA,21,8,1252,1252,0,
Garden,HOB and HVA,21,8,1299,1317,18,
Garden,HOB and HVA,21,8,1321,1322,1,
Garden,HOB and HVA,21,8,1337,1341,4,
Garden,HOB and HVA,21,8,1354,1354,0,not sure if it counts bee doesnt really stop
Garden,HOB and HVA,21,8,1657,1657,0,
Garden,HOB and HVA,21,8,1689,1695,6,
Garden,HOB and HVA,21,8,1708,1708,0,
Garden,HOB and HVA,21,8,1789,1791,2,
Garden,HOB and HVA,22,8,669,670,1,"bee waving itself in the general direction of the paper, not sure if it counts"
Garden,HOB and HVA,22,8,674,674,0,
Garden,HOB and HVA,22,8,736,739,3,
Garden,HOB and HVA,22,8,828,830,2,
Garden,HOB and HVA,22,8,831,833,2,
Garden,HOB and HVA,22,8,866,868,2,
Garden,HOB and HVA,22,8,950,951,1,
Garden,HOB and HVA,22,8,1041,1041,0,
Garden,HOB and HVA,22,8,1056,1057,1,
Garden,HOB and HVA,22,8,1060,1061,1,
Garden,HOB and HVA,22,8,1060,1063,3,
Garden,HOB and HVA,22,8,1066,1069,3,
Garden,HOB and HVA,22,8,1096,1104,8,
Garden,HOB and HVA,22,8,1149,1151,2,
Garden,HOB and HVA,22,8,1221,1231,10,
Garden,HOB and HVA,22,8,1233,1233,0,
Garden,HOB and HVA,22,8,1312,1315,3,
Garden,HOB and HVA,22,8,1320,1320,0,
Garden,HOB and HVA,22,8,1547,1548,1,
Garden,HOB and HVA,22,8,1610,1612,2,
Garden,HOB and HVA,22,8,1630,1637,7,
Garden,HOB and HVA,22,8,1696,1700,4,
Garden,HOB and HVA,22,8,1737,1743,6,
Garden,HOB and HVA,22,8,1744,1752,8,
Garden,HOB and HVA,22,8,1765,1765,0,
Garden,HOB and HVA,22,8,1779,1782,3,
Garden,HOB and HVA,24,8,4,5,1,
Garden,HOB and HVA,24,8,37,39,2,
Garden,HOB and HVA,24,8,46,46,0,
Garden,HOB and HVA,24,8,132,133,1,
Garden,HOB and HVA,24,8,150,153,3,bee fairly far away from paper
Garden,HOB and HVA,24,8,255,256,1,
Garden,HOB and HVA,24,8,292,292,0,
Garden,HOB and HVA,24,8,309,310,1,
Garden,HOB and HVA,24,8,316,318,2,
Garden,HOB and HVA,24,8,320,320,0,
Garden,HOB and HVA,24,8,384,384,0,
Garden,HOB and HVA,24,8,391,404,13,
Garden,HOB and HVA,24,8,417,417,0,
Garden,HOB and HVA,24,8,430,430,0,
Garden,HOB and HVA,24,8,441,441,0,
Garden,HOB and HVA,24,8,448,448,0,
Garden,HOB and HVA,24,8,457,459,2,bee sort of moves paper with its body
Garden,HOB and HVA,24,8,473,473,0,
Garden,HOB and HVA,24,8,529,530,1,
Garden,HOB and HVA,24,8,537,537,0,
Garden,HOB and HVA,24,8,632,632,0,
Garden,HOB and HVA,24,8,645,649,4,
Garden,HOB and HVA,24,8,654,656,2,
Garden,HOB and HVA,24,8,659,659,0,
Garden,HOB and HVA,24,8,758,759,1,
Garden,HOB and HVA,24,8,794,799,5,
Garden,HOB and HVA,24,8,826,826,0,
Garden,HOB and HVA,24,8,828,829,1,
Garden,HOB and HVA,24,8,891,893,2,
Garden,HOB and HVA,24,8,962,962,0,
Garden,HOB and HVA,24,8,966,969,3,
Garden,HOB and HVA,24,8,1192,1192,0,
Garden,HOB and HVA,24,8,1220,1220,0,
Garden,HOB and HVA,24,8,1318,1318,0,
Garden,HOB and HVA,24,8,1345,1345,0,
Garden,HOB and HVA,24,8,1395,1395,0,
Garden,HOB and HVA,24,8,1445,1446,1,
Garden,HOB and HVA,24,8,1454,1458,4,
Garden,HOB and HVA,24,8,1509,1509,0,
Garden,HOB and HVA,24,8,1673,1675,2,
Garden,HOB and HVA,24,8,1692,1692,0,
Garden,HOB and HVA,25,8,116,118,2,
Garden,HOB and HVA,25,8,273,278,5,
Garden,HOB and HVA,25,8,336,340,4,
Garden,HOB and HVA,25,8,348,348,0,
Garden,HOB and HVA,25,8,430,432,2,
Garden,HOB and HVA,25,8,438,438,0,
Garden,HOB and HVA,25,8,543,547,4,
Garden,HOB and HVA,25,8,571,576,5,
Garden,HOB and HVA,25,8,573,574,1,
Garden,HOB and HVA,25,8,585,587,2,
Garden,HOB and HVA,25,8,608,612,4,
Garden,HOB and HVA,25,8,650,652,2,
Garden,HOB and HVA,25,8,810,812,2,
Garden,HOB and HVA,25,8,818,821,3,
Garden,HOB and HVA,25,8,974,975,1,
Garden,HOB and HVA,25,8,1115,1118,3,
Garden,HOB and HVA,25,8,1292,1292,0,
Garden,HOB and HVA,25,8,1324,1324,0,
Garden,HOB and HVA,25,8,1353,1356,3,
Garden,HOB and HVA,25,8,1361,1361,0,
Garden,HOB and HVA,25,8,1392,1392,0,
Garden,HOB and HVA,25,8,1415,1418,3,
Garden,HOB and HVA,25,8,1419,1419,0,
Garden,HOB and HVA,25,8,1541,1545,4,
Garden,HOB and HVA,25,8,1588,1588,0,
Garden,HOB and HVA,25,8,1660,1664,4,
Garden,HOB and HVA,25,8,1783,1783,0,
Garden,HOB and HVA,26,4,3,9,6,
Garden,HOB and HVA,26,4,16,18,2,
Garden,HOB and HVA,26,4,20,22,2,
Garden,HOB and HVA,26,4,34,35,1,
Garden,HOB and HVA,26,4,54,54,0,
Garden,HOB and HVA,26,4,88,89,1,
Garden,HOB and HVA,26,4,112,112,0,
Garden,HOB and HVA,26,4,219,220,1,
Garden,HOB and HVA,26,4,330,331,1,
Garden,HOB and HVA,26,4,407,409,2,
Garden,HOB and HVA,26,4,497,497,0,
Garden,HOB and HVA,26,4,546,546,0,
Garden,HOB and HVA,26,4,557,558,1,bee walks in to paper. not sure if it counts
Garden,HOB and HVA,26,4,617,618,1,
Garden,HOB and HVA,26,4,704,708,4,
Garden,HOB and HVA,26,4,728,728,0,
Garden,HOB and HVA,26,4,760,761,1,
Garden,HOB and HVA,26,4,815,817,2,
Garden,HOB and HVA,26,4,817,817,0,
Garden,HOB and HVA,26,4,827,829,2,
Garden,HOB and HVA,26,4,922,925,3,
Garden,HOB and HVA,26,4,1077,1078,1,
Garden,HOB and HVA,26,4,1187,1190,3,
Garden,HOB and HVA,26,4,1295,1295,0,
Garden,HOB and HVA,26,4,1339,1339,0,
Garden,HOB and HVA,26,4,1340,1344,4,
Garden,HOB and HVA,26,4,1466,1466,0,
Garden,HOB and HVA,26,4,1480,1482,2,
Garden,HOB and HVA,26,4,1613,1615,2,
Garden,HOB and HVA,26,4,1697,1699,2,
Garden,HOB and HVA,26,4,1711,1711,0,
Garden,HOB and HVA,26,4,1760,1760,0,
Garden,HOB and HVA,28,8,36,37,1,bee walks over paper
Garden,HOB and HVA,28,8,39,39,0,
Garden,HOB and HVA,28,8,61,61,0,
Garden,HOB and HVA,28,8,108,108,0,beemoves paper with its legs
Garden,HOB and HVA,28,8,127,129,2,
Garden,HOB and HVA,28,8,173,173,0,
Garden,HOB and HVA,28,8,198,198,0,
Garden,HOB and HVA,28,8,199,200,1,bee walks over paper
Garden,HOB and HVA,28,8,203,203,0,
Garden,HOB and HVA,28,8,404,407,3,
Garden,HOB and HVA,28,8,420,421,1,bee walks over paper
Garden,HOB and HVA,28,8,475,475,0,
Garden,HOB and HVA,28,8,478,479,1,bee walks over paper
Garden,HOB and HVA,28,8,608,609,1,
Garden,HOB and HVA,28,8,641,641,0,
Garden,HOB and HVA,28,8,701,701,0,
Garden,HOB and HVA,28,8,710,714,4,bee walks over paper
Garden,HOB and HVA,28,8,727,729,2,bee walks over paper
Garden,HOB and HVA,28,8,744,744,0,
Garden,HOB and HVA,28,8,755,817,62,bee walks over paper
Garden,HOB and HVA,28,8,815,816,1,bee walks over paper
Garden,HOB and HVA,28,8,839,839,0,
Garden,HOB and HVA,28,8,968,968,0,
Garden,HOB and HVA,28,8,1049,1050,1,
Garden,HOB and HVA,28,8,1062,1063,1,bee walks over paper
Garden,HOB and HVA,28,8,1154,1157,3,
Garden,HOB and HVA,28,8,1176,1178,2,bee walks over paper
Garden,HOB and HVA,28,8,1251,1252,1,
Garden,HOB and HVA,28,8,1301,1302,1,bee walks over paper
Garden,HOB and HVA,28,8,1589,1589,0,
Garden,HOB and HVA,28,8,1713,1717,4,
Garden,HOB and HVA,29,8,103,105,2,
Garden,HOB and HVA,29,8,152,154,2,
Garden,HOB and HVA,29,8,159,159,0,
Garden,HOB and HVA,29,8,168,168,0,
Garden,HOB and HVA,29,8,179,179,0,
Garden,HOB and HVA,29,8,194,194,0,
Garden,HOB and HVA,29,8,246,246,0,
Garden,HOB and HVA,29,8,267,267,0,
Garden,HOB and HVA,29,8,329,329,0,
Garden,HOB and HVA,29,8,358,361,3,
Garden,HOB and HVA,29,8,392,392,0,
Garden,HOB and HVA,29,8,394,395,1,
Garden,HOB and HVA,29,8,428,429,1,
Garden,HOB and HVA,29,8,446,451,5,
Garden,HOB and HVA,29,8,464,464,0,
Garden,HOB and HVA,29,8,492,492,0,
Garden,HOB and HVA,29,8,549,549,0,
Garden,HOB and HVA,29,8,814,827,13,
Garden,HOB and HVA,29,8,858,859,1,
Garden,HOB and HVA,29,8,862,864,2,
Garden,HOB and HVA,29,8,983,983,0,
Garden,HOB and HVA,29,8,994,995,1,
Garden,HOB and HVA,29,8,1046,1046,0,
Garden,HOB and HVA,29,8,1164,1166,2,
Garden,HOB and HVA,29,8,1166,1169,3,
Garden,HOB and HVA,29,8,1282,1282,0,
Garden,HOB and HVA,29,8,1287,1292,5,
Garden,HOB and HVA,29,8,1315,1315,0,
Garden,HOB and HVA,29,8,1508,1510,2,
Garden,HOB and HVA,29,8,1643,1643,0,
Garden,HOB and HVA,29,8,1689,1691,2,
Garden,HOB and HVA,29,8,1702,1702,0,
Garden,HOB and HVA,29,8,1744,1745,1,
Garden,HOB and HVA,30,12,21,22,1,
Garden,HOB and HVA,30,12,28,31,3,
Garden,HOB and HVA,30,12,145,145,0,
Garden,HOB and HVA,30,12,146,146,0,
Garden,HOB and HVA,30,12,158,160,2,
Garden,HOB and HVA,30,12,252,252,0,
Garden,HOB and HVA,30,12,273,281,8,
Garden,HOB and HVA,30,12,283,283,0,
Garden,HOB and HVA,30,12,320,320,0,
Garden,HOB and HVA,30,12,334,334,0,
Garden,HOB and HVA,30,12,372,374,2,
Garden,HOB and HVA,30,12,392,392,0,
Garden,HOB and HVA,30,12,399,399,0,
Garden,HOB and HVA,30,12,475,477,2,
Garden,HOB and HVA,30,12,497,498,1,
Garden,HOB and HVA,30,12,512,520,8,
Garden,HOB and HVA,30,12,589,589,0,
Garden,HOB and HVA,30,12,726,729,3,walks over paper
Garden,HOB and HVA,30,12,805,806,1,
Garden,HOB and HVA,30,12,816,819,3,
Garden,HOB and HVA,30,12,870,871,1,
Garden,HOB and HVA,30,12,872,872,0,
Garden,HOB and HVA,30,12,933,946,13,
Garden,HOB and HVA,30,12,964,965,1,
Garden,HOB and HVA,30,12,1093,1093,0,
Garden,HOB and HVA,30,12,1206,1207,1,
Garden,HOB and HVA,30,12,1255,1255,0,
Garden,HOB and HVA,30,12,1331,1339,8,
Garden,HOB and HVA,30,12,1418,1418,0,
Garden,HOB and HVA,30,12,1421,1421,0,
Garden,HOB and HVA,30,12,1566,1566,0,
Garden,HOB and HVA,30,12,1585,1585,0,
Garden,HOB and HVA,31,4,15,26,11,
Garden,HOB and HVA,31,4,63,63,0,
Garden,HOB and HVA,31,4,68,78,10,bee very close to paper-sort of still - still think it actually counts though
Garden,HOB and HVA,31,4,86,86,0,
Garden,HOB and HVA,31,4,111,114,3,
Garden,HOB and HVA,31,4,129,132,3,
Garden,HOB and HVA,31,4,129,129,0,
Garden,HOB and HVA,31,4,148,149,1,
Garden,HOB and HVA,31,4,184,186,2,
Garden,HOB and HVA,31,4,192,192,0,
Garden,HOB and HVA,31,4,242,243,1,
Garden,HOB and HVA,31,4,263,263,0,
Garden,HOB and HVA,31,4,265,265,0,
Garden,HOB and HVA,31,4,283,283,0,
Garden,HOB and HVA,31,4,312,312,0,
Garden,HOB and HVA,31,4,314,314,0,
Garden,HOB and HVA,31,4,326,326,0,
Garden,HOB and HVA,31,4,426,426,0,
Garden,HOB and HVA,31,4,494,494,0,
Garden,HOB and HVA,31,4,552,552,0,
Garden,HOB and HVA,31,4,581,582,1,
Garden,HOB and HVA,31,4,674,675,1,
Garden,HOB and HVA,31,4,685,686,1,
Garden,HOB and HVA,31,4,822,833,11,
Garden,HOB and HVA,31,4,859,870,11,
Garden,HOB and HVA,31,4,948,948,0,
Garden,HOB and HVA,31,4,981,981,0,
Garden,HOB and HVA,31,4,984,984,0,
Garden,HOB and HVA,31,4,1035,1035,0,
Garden,HOB and HVA,31,4,1042,1042,0,
Garden,HOB and HVA,31,4,1045,1045,0,
Garden,HOB and HVA,31,4,1141,1141,0,
Garden,HOB and HVA,31,4,1229,1229,0,
Garden,HOB and HVA,31,4,1305,1306,1,
Garden,HOB and HVA,31,4,1306,1307,1,
Garden,HOB and HVA,31,4,1429,1429,0,
Garden,HOB and HVA,31,4,1465,1469,4,
Garden,HOB and HVA,31,4,1556,1556,0,
Garden,HOB and HVA,31,4,1689,1702,13,
Garden,HOB and HVA,31,4,1703,1703,0,
Garden,HOB and HVA,31,4,1721,1721,0,
Garden,HOB and HVA,34,12,14,14,0,
Garden,HOB and HVA,34,12,27,32,5,Has sniff brushes past and then sniffs again in this time
Garden,HOB and HVA,34,12,62,62,0,
Garden,HOB and HVA,34,12,72,72,0,
Garden,HOB and HVA,34,12,179,179,0,
Garden,HOB and HVA,34,12,205,205,0,
Garden,HOB and HVA,34,12,264,264,0,
Garden,HOB and HVA,34,12,331,331,0,
Garden,HOB and HVA,34,12,367,367,0,
Garden,HOB and HVA,34,12,675,675,0,
Garden,HOB and HVA,34,12,820,820,0,
Garden,HOB and HVA,35,6,41,41,0,
Garden,HOB and HVA,35,6,82,82,0,Does double sniff
Garden,HOB and HVA,35,6,87,87,0,"Bee snifft and then walks past, accidentally moves paper"
Garden,HOB and HVA,35,6,466,467,1,double sniff
Garden,HOB and HVA,35,6,470,470,0,
Garden,HOB and HVA,35,6,520,520,0,
Garden,HOB and HVA,35,6,529,529,0,
Garden,HOB and HVA,35,6,564,564,0,
Garden,HOB and HVA,35,6,618,618,0,
Garden,HOB and HVA,35,6,634,634,0,
Garden,HOB and HVA,35,6,649,649,0,
Garden,HOB and HVA,35,6,860,860,0,
Garden,HOB and HVA,35,6,960,960,0,
Garden,HOB and HVA,35,6,1098,1098,0,
Garden,HOB and HVA,35,6,1384,1444,60,
Garden,HOB and HVA,35,6,1537,1537,0,
Garden,HOB and HVA,35,6,1551,1551,0,
Garden,HOB and HVA,35,6,1746,1746,0,
Garden,9-HDA and HOB,20,8,56,56,0,
Garden,9-HDA and HOB,20,8,169,173,4,"bee not actually, touching, i think it counts"
Garden,9-HDA and HOB,20,8,188,189,1,
Garden,9-HDA and HOB,20,8,316,317,1,
Garden,9-HDA and HOB,20,8,380,380,0,
Garden,9-HDA and HOB,20,8,411,411,0,
Garden,9-HDA and HOB,20,8,593,594,1,
Garden,9-HDA and HOB,20,8,608,608,0,
Garden,9-HDA and HOB,20,8,661,661,0,
Garden,9-HDA and HOB,20,8,757,757,0,
Garden,9-HDA and HOB,20,8,833,834,1,
Garden,9-HDA and HOB,20,8,884,885,1,
Garden,9-HDA and HOB,20,8,1012,1012,0,
Garden,9-HDA and HOB,20,8,1055,1055,0,
Garden,9-HDA and HOB,20,8,1157,1157,0,"don't really think it counts, bee sort of bumps in to paper sideways"
Garden,9-HDA and HOB,20,8,1315,1317,2,
Garden,9-HDA and HOB,20,8,1340,1340,0,
Garden,9-HDA and HOB,20,8,1580,1581,1,
Garden,9-HDA and HOB,20,8,1703,1703,0,
Garden,9-HDA and HOB,20,8,1722,1724,2,
Garden,9-HDA and HOB,21,2,9,12,3,
Garden,9-HDA and HOB,21,2,20,22,2,
Garden,9-HDA and HOB,21,2,67,69,2,
Garden,9-HDA and HOB,21,2,119,119,0,
Garden,9-HDA and HOB,21,2,120,122,2,
Garden,9-HDA and HOB,21,2,321,321,0,
Garden,9-HDA and HOB,21,2,616,616,0,
Garden,9-HDA and HOB,21,2,106,106,0,
Garden,9-HDA and HOB,21,2,721,721,0,not sure if it counts
Garden,9-HDA and HOB,21,2,754,754,0,
Garden,9-HDA and HOB,21,2,773,773,0,
Garden,9-HDA and HOB,21,2,862,863,1,
Garden,9-HDA and HOB,21,2,872,876,4,
Garden,9-HDA and HOB,21,2,1062,1062,0,
Garden,9-HDA and HOB,21,2,1192,1193,1,
Garden,9-HDA and HOB,21,2,1278,1279,1,
Garden,9-HDA and HOB,21,2,1301,1303,2,
Garden,9-HDA and HOB,21,2,1357,1359,2,
Garden,9-HDA and HOB,21,2,1476,1477,1,
Garden,9-HDA and HOB,21,2,1533,1538,5,
Garden,9-HDA and HOB,21,2,1590,1592,2,
Garden,9-HDA and HOB,21,2,1701,1701,0,
Garden,9-HDA and HOB,21,2,1751,1751,0,
Garden,9-HDA and HOB,21,2,1792,1793,1,bee sniffing from afar
Garden,9-HDA and HOB,21,2,1797,1799,2,
Garden,9-HDA and HOB,22,10,37,39,2,bee sniffing from afar
Garden,9-HDA and HOB,22,10,69,73,4,bee sniffing from afar
Garden,9-HDA and HOB,22,10,80,80,0,
Garden,9-HDA and HOB,22,10,84,85,1,
Garden,9-HDA and HOB,22,10,713,713,0,
Garden,9-HDA and HOB,22,10,786,786,0,bee sniffing from afar
Garden,9-HDA and HOB,22,10,802,802,0,
Garden,9-HDA and HOB,22,10,813,815,2,
Garden,9-HDA and HOB,22,10,830,894,64,bee sits pretty mush stock still facing paper
Garden,9-HDA and HOB,22,10,891,892,1,
Garden,9-HDA and HOB,22,10,1151,1151,0,
Garden,9-HDA and HOB,22,10,1378,1379,1,
Garden,9-HDA and HOB,22,10,1404,1406,2,not super sure about this one
Garden,9-HDA and HOB,22,10,1741,1800,59,bee sits close to paper still
Garden,9-HDA and HOB,24,3,21,21,0,
Garden,9-HDA and HOB,24,3,24,24,0,
Garden,9-HDA and HOB,24,3,25,28,3,
Garden,9-HDA and HOB,24,3,39,39,0,
Garden,9-HDA and HOB,24,3,45,47,2,
Garden,9-HDA and HOB,24,3,73,73,0,bee moves paper with its leg
Garden,9-HDA and HOB,24,3,81,81,0,
Garden,9-HDA and HOB,24,3,94,94,0,
Garden,9-HDA and HOB,24,3,99,100,1,
Garden,9-HDA and HOB,24,3,128,128,0,
Garden,9-HDA and HOB,24,3,181,181,0,
Garden,9-HDA and HOB,24,3,215,215,0,
Garden,9-HDA and HOB,24,3,223,223,0,
Garden,9-HDA and HOB,24,3,239,239,0,
Garden,9-HDA and HOB,24,3,244,246,2,
Garden,9-HDA and HOB,24,3,264,264,0,
Garden,9-HDA and HOB,24,3,292,294,2,
Garden,9-HDA and HOB,24,3,314,315,1,
Garden,9-HDA and HOB,24,3,325,325,0,
Garden,9-HDA and HOB,24,3,335,335,0,
Garden,9-HDA and HOB,24,3,337,337,0,
Garden,9-HDA and HOB,24,3,346,350,4,
Garden,9-HDA and HOB,24,3,372,372,0,
Garden,9-HDA and HOB,24,3,429,431,2,
Garden,9-HDA and HOB,24,3,508,509,1,
Garden,9-HDA and HOB,24,3,509,512,3,
Garden,9-HDA and HOB,24,3,516,516,0,
Garden,9-HDA and HOB,24,3,563,563,0,bee sort of crawls over it
Garden,9-HDA and HOB,24,3,588,589,1,
Garden,9-HDA and HOB,24,3,607,607,0,
Garden,9-HDA and HOB,24,3,616,617,1,bee walks over paper
Garden,9-HDA and HOB,24,3,624,624,0,bee moves paper with its legs
Garden,9-HDA and HOB,24,3,650,650,0,
Garden,9-HDA and HOB,24,3,658,658,0,
Garden,9-HDA and HOB,24,3,675,675,0,
Garden,9-HDA and HOB,24,3,722,722,0,
Garden,9-HDA and HOB,24,3,765,765,0,
Garden,9-HDA and HOB,24,3,780,780,0,
Garden,9-HDA and HOB,24,3,790,790,0,bee moves paper with its legs
Garden,9-HDA and HOB,24,3,794,794,0,
Garden,9-HDA and HOB,24,3,795,795,0,
Garden,9-HDA and HOB,24,3,818,818,0,
Garden,9-HDA and HOB,24,3,817,817,0,
Garden,9-HDA and HOB,24,3,832,834,2,
Garden,9-HDA and HOB,24,3,884,884,0,bee sniffs paper and moves it to the edge of the dish. it may get trampled
Garden,9-HDA and HOB,24,3,904,904,0,bee moves paper with legs
Garden,9-HDA and HOB,24,3,906,907,1,
Garden,9-HDA and HOB,24,3,911,912,1,bee walks over paper
Garden,9-HDA and HOB,24,3,914,914,0,
Garden,9-HDA and HOB,24,3,931,931,0,
Garden,9-HDA and HOB,24,3,956,957,1,
Garden,9-HDA and HOB,24,3,973,973,0,
Garden,9-HDA and HOB,24,3,996,998,2,
Garden,9-HDA and HOB,24,3,999,999,0,
Garden,9-HDA and HOB,24,3,1004,1004,0,
Garden,9-HDA and HOB,24,3,1017,1017,0,bee moves paper with its legs
Garden,9-HDA and HOB,24,3,1023,1023,0,
Garden,9-HDA and HOB,24,3,1029,1029,0,
Garden,9-HDA and HOB,24,3,1034,1034,0,
Garden,9-HDA and HOB,24,3,1048,1049,1,bee moves paper with its leg
Garden,9-HDA and HOB,24,3,1073,1073,0,
Garden,9-HDA and HOB,24,3,1075,1075,0,"bee walsk past and seems to sniff, not entirely sure"
Garden,9-HDA and HOB,24,3,1082,1082,0,"bee moves paper, not sure if antennating"
Garden,9-HDA and HOB,24,3,1087,1090,3,
Garden,9-HDA and HOB,24,3,1092,1093,1,
Garden,9-HDA and HOB,24,3,1101,1103,2,bee moves paper - seems to just soer of walk over it
Garden,9-HDA and HOB,24,3,1104,1104,0,
Garden,9-HDA and HOB,24,3,1109,1109,0,bee walks past paper and moves it
Garden,9-HDA and HOB,24,3,510,511,1,bee walks over paper
Garden,9-HDA and HOB,24,3,1125,1127,2,
Garden,9-HDA and HOB,24,3,1095,1096,1,bee walsk over paper and moves it
Garden,9-HDA and HOB,24,3,1169,1169,0,
Garden,9-HDA and HOB,24,3,1176,1177,1,bee walks over paper but sort of seems interrested
Garden,9-HDA and HOB,24,3,1183,1184,1,bee walks over paper
Garden,9-HDA and HOB,24,3,1188,1190,2,
Garden,9-HDA and HOB,24,3,1190,1190,0,
Garden,9-HDA and HOB,24,3,1201,1205,4,
Garden,9-HDA and HOB,24,3,1202,1202,0,
Garden,9-HDA and HOB,24,3,1207,1207,0,
Garden,9-HDA and HOB,25,5,78,83,5,
Garden,9-HDA and HOB,25,5,216,219,3,
Garden,9-HDA and HOB,25,5,236,236,0,
Garden,9-HDA and HOB,25,5,281,282,1,
Garden,9-HDA and HOB,25,5,285,287,2,
Garden,9-HDA and HOB,25,5,326,326,0,bee touches as it walks past paper super fast
Garden,9-HDA and HOB,25,5,343,343,0,
Garden,9-HDA and HOB,25,5,380,380,0,
Garden,9-HDA and HOB,25,5,410,410,0,
Garden,9-HDA and HOB,25,5,441,445,4,
Garden,9-HDA and HOB,25,5,501,501,0,
Garden,9-HDA and HOB,25,5,581,583,2,
Garden,9-HDA and HOB,25,5,680,681,1,
Garden,9-HDA and HOB,25,5,744,746,2,
Garden,9-HDA and HOB,25,5,811,823,12,
Garden,9-HDA and HOB,25,5,825,825,0,
Garden,9-HDA and HOB,25,5,826,827,1,
Garden,9-HDA and HOB,25,5,887,891,4,
Garden,9-HDA and HOB,25,5,891,891,0,
Garden,9-HDA and HOB,25,5,967,970,3,
Garden,9-HDA and HOB,25,5,1093,1093,0,
Garden,9-HDA and HOB,25,5,1162,1167,5,
Garden,9-HDA and HOB,25,5,1220,1223,3,
Garden,9-HDA and HOB,25,5,1226,1230,4,
Garden,9-HDA and HOB,25,5,1233,1234,1,
Garden,9-HDA and HOB,25,5,1374,1374,0,
Garden,9-HDA and HOB,25,5,1472,1475,3,
Garden,9-HDA and HOB,25,5,1515,1515,0,
Garden,9-HDA and HOB,25,5,1546,1554,8,
Garden,9-HDA and HOB,25,5,1570,1570,0,
Garden,9-HDA and HOB,25,5,1677,1679,2,
Garden,9-HDA and HOB,25,5,1728,1728,0,
Garden,9-HDA and HOB,25,5,1744,1745,1,
Garden,9-HDA and HOB,26,6,26,27,1,
Garden,9-HDA and HOB,26,6,53,53,0,
Garden,9-HDA and HOB,26,6,108,108,0,
Garden,9-HDA and HOB,26,6,122,122,0,
Garden,9-HDA and HOB,26,6,132,133,1,
Garden,9-HDA and HOB,26,6,273,273,0,
Garden,9-HDA and HOB,26,6,339,340,1,
Garden,9-HDA and HOB,26,6,347,347,0,
Garden,9-HDA and HOB,26,6,379,379,0,
Garden,9-HDA and HOB,26,6,481,481,0,
Garden,9-HDA and HOB,26,6,551,551,0,
Garden,9-HDA and HOB,26,6,585,586,1,
Garden,9-HDA and HOB,26,6,593,596,3,
Garden,9-HDA and HOB,26,6,615,615,0,
Garden,9-HDA and HOB,26,6,628,628,0,
Garden,9-HDA and HOB,26,6,699,699,0,
Garden,9-HDA and HOB,26,6,702,703,1,
Garden,9-HDA and HOB,26,6,750,754,4,
Garden,9-HDA and HOB,26,6,774,774,0,
Garden,9-HDA and HOB,26,6,793,793,0,
Garden,9-HDA and HOB,26,6,872,872,0,
Garden,9-HDA and HOB,26,6,923,924,1,
Garden,9-HDA and HOB,26,6,926,926,0,
Garden,9-HDA and HOB,26,6,1020,1020,0,
Garden,9-HDA and HOB,26,6,1115,1115,0,
Garden,9-HDA and HOB,26,6,1325,1325,0,
Garden,9-HDA and HOB,26,6,1498,1498,0,
Garden,9-HDA and HOB,26,6,1511,1511,0,
Garden,9-HDA and HOB,26,6,1519,1519,0,
Garden,9-HDA and HOB,26,6,1521,1521,0,
Garden,9-HDA and HOB,26,6,1535,1535,0,
Garden,9-HDA and HOB,26,6,1569,1569,0,
Garden,9-HDA and HOB,26,6,1608,1608,0,
Garden,9-HDA and HOB,26,6,1640,1642,2,
Garden,9-HDA and HOB,26,6,1650,1650,0,
Garden,9-HDA and HOB,26,6,1703,1703,0,
Garden,9-HDA and HOB,26,6,1783,1783,0,
Garden,9-HDA and HOB,26,6,1798,1798,0,
Garden,9-HDA and HOB,26,6,1799,1799,0,
Garden,9-HDA and HOB,28,9,669,669,0,
Garden,9-HDA and HOB,28,9,743,744,1,
Garden,9-HDA and HOB,28,9,748,749,1,
Garden,9-HDA and HOB,28,9,757,757,0,
Garden,9-HDA and HOB,28,9,813,813,0,
Garden,9-HDA and HOB,28,9,823,824,1,
Garden,9-HDA and HOB,28,9,933,935,2,
Garden,9-HDA and HOB,28,9,996,996,0,
Garden,9-HDA and HOB,28,9,1019,1019,0,
Garden,9-HDA and HOB,28,9,1036,1036,0,
Garden,9-HDA and HOB,28,9,1247,1249,2,
Garden,9-HDA and HOB,28,9,1289,1290,1,
Garden,9-HDA and HOB,28,9,1308,1310,2,
Garden,9-HDA and HOB,28,9,1412,1412,0,
Garden,9-HDA and HOB,28,9,1425,1425,0,
Garden,9-HDA and HOB,28,9,1462,1462,0,
Garden,9-HDA and HOB,28,9,1482,1482,0,
Garden,9-HDA and HOB,28,9,1504,1505,1,
Garden,9-HDA and HOB,28,9,1539,1539,0,
Garden,9-HDA and HOB,28,9,1556,1559,3,
Garden,9-HDA and HOB,28,9,1627,1632,5,
Garden,9-HDA and HOB,28,9,1679,1679,0,
Garden,9-HDA and HOB,28,9,1724,1724,0,
Garden,9-HDA and HOB,28,9,1786,1787,1,
Garden,9-HDA and HOB,29,10,0,1,1,
Garden,9-HDA and HOB,29,10,4,7,3,
Garden,9-HDA and HOB,29,10,65,65,0,
Garden,9-HDA and HOB,29,10,310,311,1,
Garden,9-HDA and HOB,29,10,347,347,0,
Garden,9-HDA and HOB,29,10,379,380,1,
Garden,9-HDA and HOB,29,10,398,402,4,
Garden,9-HDA and HOB,29,10,434,434,0,
Garden,9-HDA and HOB,29,10,438,438,0,
Garden,9-HDA and HOB,29,10,487,487,0,
Garden,9-HDA and HOB,29,10,589,590,1,
Garden,9-HDA and HOB,29,10,642,643,1,
Garden,9-HDA and HOB,29,10,662,664,2,
Garden,9-HDA and HOB,29,10,670,670,0,
Garden,9-HDA and HOB,29,10,825,826,1,
Garden,9-HDA and HOB,29,10,831,831,0,
Garden,9-HDA and HOB,29,10,833,833,0,
Garden,9-HDA and HOB,29,10,985,987,2,
Garden,9-HDA and HOB,29,10,1010,1015,5,
Garden,9-HDA and HOB,29,10,1079,1080,1,
Garden,9-HDA and HOB,29,10,1087,1088,1,
Garden,9-HDA and HOB,29,10,1165,1165,0,
Garden,9-HDA and HOB,29,10,1228,1229,1,
Garden,9-HDA and HOB,29,10,1240,1241,1,
Garden,9-HDA and HOB,29,10,1356,1356,0,
Garden,9-HDA and HOB,29,10,1538,1539,1,
Garden,9-HDA and HOB,29,10,1566,1566,0,
Garden,9-HDA and HOB,29,10,1586,1586,0,
Garden,9-HDA and HOB,29,10,1748,1751,3,
Garden,9-HDA and HOB,29,10,1770,1793,23,
Garden,9-HDA and HOB,33,11,1403,1403,0,
Garden,9-HDA and HOB,33,11,1416,1416,0,
Garden,9-HDA and HOB,33,11,1422,1422,0,
Garden,9-HDA and HOB,33,11,1423,1423,0,
Garden,9-HDA and HOB,33,11,1439,1439,0,
Garden,9-HDA and HOB,33,11,1442,1442,0,
Garden,9-HDA and HOB,33,11,1443,1443,0,
Garden,9-HDA and HOB,33,11,1484,1485,1,
Garden,9-HDA and HOB,33,11,1498,1498,0,not sure if counts - bumps in to it from the side
Garden,9-HDA and HOB,33,11,1522,1522,0,
Garden,9-HDA and HOB,33,11,1541,1541,0,
Garden,9-HDA and HOB,33,11,1548,1548,0,
Garden,9-HDA and HOB,33,11,1587,1587,0,
Garden,9-HDA and HOB,33,11,1598,1598,0,
Garden,9-HDA and HOB,33,11,1742,1743,1,
Garden,9-HDA and HOB,33,11,1743,1743,0,
Garden,9-HDA and HOB,33,11,1756,1757,1,
Garden,9-HDA and HOB,33,11,1797,1797,0,
Garden,9-HDA and HOB,33,11,1799,1799,0,
Garden,9-HDA and HOB,34,2,16,16,0,
Garden,9-HDA and HOB,34,2,35,36,1,double paper boop
Garden,9-HDA and HOB,34,2,153,153,0,
Garden,9-HDA and HOB,34,2,160,163,3,Not sure about this one - it definitely hovers around very close to the paper
Garden,9-HDA and HOB,34,2,169,169,0,
Garden,9-HDA and HOB,34,2,246,246,0,
Garden,9-HDA and HOB,34,2,250,250,0,
Garden,9-HDA and HOB,34,2,258,258,0,
Garden,9-HDA and HOB,34,2,263,263,0,
Garden,9-HDA and HOB,34,2,298,298,0,
Garden,9-HDA and HOB,34,2,302,302,0,
Garden,9-HDA and HOB,34,2,308,308,0,
Garden,9-HDA and HOB,34,2,322,322,0,
Garden,9-HDA and HOB,34,2,590,590,0,
Garden,9-HDA and HOB,34,2,703,703,0,
Garden,9-HDA and HOB,34,2,704,704,0,
Garden,9-HDA and HOB,34,2,707,707,0,
Garden,9-HDA and HOB,34,2,745,745,0,
Garden,9-HDA and HOB,34,2,981,987,6,
Garden,9-HDA and HOB,34,2,986,986,0,
Garden,9-HDA and HOB,34,2,1028,1028,0,
Garden,9-HDA and HOB,34,2,1331,1331,0,
Garden,9-HDA and HOB,35,4,16,16,0,
Garden,9-HDA and HOB,35,4,1110,1110,0,
Garden,9-HDA and HOB,35,4,1109,1109,0,
Garden,9-HDA and HOB,35,4,1197,1197,0,
Garden,9-HDA and HOB,35,4,1235,1235,0,Seems to walk past and then come back for a sniff
Garden,9-HDA and HOB,35,4,1251,1251,0,
Garden,9-HDA and HOB,35,4,1330,1330,0,
Garden,9-HDA and HOB,35,4,1398,1398,0,
Garden,9-HDA and HOB,35,4,1497,1497,0,
Garden,9-HDA and HOB,35,4,1601,1601,0,
Garden,9-HDA and HVA,20,7,68,68,0,
Garden,9-HDA and HVA,20,7,98,98,0,
Garden,9-HDA and HVA,20,7,296,296,0,
Garden,9-HDA and HVA,20,7,316,317,1,
Garden,9-HDA and HVA,20,7,343,344,1,
Garden,9-HDA and HVA,20,7,548,548,0,
Garden,9-HDA and HVA,20,7,778,778,0,
Garden,9-HDA and HVA,20,7,1168,1168,0,
Garden,9-HDA and HVA,20,7,1230,1231,1,
Garden,9-HDA and HVA,20,7,1303,1305,2,
Garden,9-HDA and HVA,20,7,1308,1308,0,
Garden,9-HDA and HVA,20,7,1325,1326,1,
Garden,9-HDA and HVA,20,7,1344,1345,1,
Garden,9-HDA and HVA,20,7,1366,1366,0,
Garden,9-HDA and HVA,20,7,1393,1393,0,
Garden,9-HDA and HVA,20,7,1400,1400,0,
Garden,9-HDA and HVA,20,7,1586,1588,2,
Garden,9-HDA and HVA,21,1,24,25,1,
Garden,9-HDA and HVA,21,1,26,27,1,
Garden,9-HDA and HVA,21,1,28,30,2,
Garden,9-HDA and HVA,21,1,55,56,1,
Garden,9-HDA and HVA,21,1,64,67,3,
Garden,9-HDA and HVA,21,1,95,99,4,
Garden,9-HDA and HVA,21,1,109,114,5,
Garden,9-HDA and HVA,21,1,167,167,0,
Garden,9-HDA and HVA,21,1,179,182,3,
Garden,9-HDA and HVA,21,1,197,198,1,
Garden,9-HDA and HVA,21,1,227,228,1,
Garden,9-HDA and HVA,21,1,374,374,0,
Garden,9-HDA and HVA,21,1,381,381,0,
Garden,9-HDA and HVA,21,1,407,407,0,
Garden,9-HDA and HVA,21,1,426,427,1,
Garden,9-HDA and HVA,21,1,431,432,1,
Garden,9-HDA and HVA,21,1,434,434,0,
Garden,9-HDA and HVA,21,1,458,458,0,
Garden,9-HDA and HVA,21,1,494,494,0,"not sure this one counts, bee maybe just bumped into paper"
Garden,9-HDA and HVA,21,1,547,547,0,
Garden,9-HDA and HVA,21,1,567,568,1,
Garden,9-HDA and HVA,21,1,799,800,1,
Garden,9-HDA and HVA,21,1,858,858,0,
Garden,9-HDA and HVA,21,1,861,861,0,
Garden,9-HDA and HVA,21,1,866,866,0,
Garden,9-HDA and HVA,21,1,873,1473,600,
Garden,9-HDA and HVA,21,1,885,885,0,
Garden,9-HDA and HVA,21,1,903,903,0,
Garden,9-HDA and HVA,21,1,945,946,1,
Garden,9-HDA and HVA,21,1,992,993,1,
Garden,9-HDA and HVA,21,1,1026,1027,1,
Garden,9-HDA and HVA,21,1,1105,1106,1,
Garden,9-HDA and HVA,21,1,1134,1137,3,
Garden,9-HDA and HVA,21,1,1193,1193,0,
Garden,9-HDA and HVA,21,1,1265,1268,3,
Garden,9-HDA and HVA,22,9,19,19,0,
Garden,9-HDA and HVA,22,9,21,21,0,
Garden,9-HDA and HVA,22,9,0,654,654,
Garden,9-HDA and HVA,22,9,29,29,0,
Garden,9-HDA and HVA,22,9,389,390,1,
Garden,9-HDA and HVA,22,9,454,454,0,
Garden,9-HDA and HVA,22,9,466,466,0,
Garden,9-HDA and HVA,22,9,502,503,1,
Garden,9-HDA and HVA,22,9,672,680,8,
Garden,9-HDA and HVA,22,9,685,694,9,
Garden,9-HDA and HVA,22,9,697,698,1,
Garden,9-HDA and HVA,22,9,705,708,3,
Garden,9-HDA and HVA,22,9,720,722,2,
Garden,9-HDA and HVA,22,9,732,737,5,
Garden,9-HDA and HVA,22,9,748,752,4,
Garden,9-HDA and HVA,22,9,768,779,11,
Garden,9-HDA and HVA,22,9,792,805,13,
Garden,9-HDA and HVA,22,9,821,825,4,
Garden,9-HDA and HVA,22,9,848,852,4,
Garden,9-HDA and HVA,22,9,856,863,7,
Garden,9-HDA and HVA,22,9,865,866,1,
Garden,9-HDA and HVA,22,9,870,875,5,
Garden,9-HDA and HVA,22,9,892,914,22,
Garden,9-HDA and HVA,22,9,928,941,13,
Garden,9-HDA and HVA,22,9,945,947,2,
Garden,9-HDA and HVA,22,9,960,960,0,
Garden,9-HDA and HVA,22,9,1010,1013,3,
Garden,9-HDA and HVA,22,9,1029,1031,2,
Garden,9-HDA and HVA,22,9,1049,1051,2,
Garden,9-HDA and HVA,22,9,1123,1125,2,
Garden,9-HDA and HVA,22,9,1133,1135,2,
Garden,9-HDA and HVA,22,9,1145,1146,1,
Garden,9-HDA and HVA,22,9,1173,1178,5,
Garden,9-HDA and HVA,22,9,1195,1198,3,
Garden,9-HDA and HVA,22,9,1203,1207,4,not sure if it counts bee is very close to paper though
Garden,9-HDA and HVA,22,9,1219,1221,2,
Garden,9-HDA and HVA,22,9,1206,1361,155,
Garden,9-HDA and HVA,22,9,1263,1271,8,
Garden,9-HDA and HVA,22,9,1288,1304,16,
Garden,9-HDA and HVA,22,9,1321,1327,6,
Garden,9-HDA and HVA,22,9,1330,1348,18,
Garden,9-HDA and HVA,22,9,1358,1424,66,
Garden,9-HDA and HVA,22,9,1363,1440,77,
Garden,9-HDA and HVA,22,9,1442,1446,4,
Garden,9-HDA and HVA,22,9,1442,1447,5,bee remains very close to paper until 24:46
Garden,9-HDA and HVA,22,9,1448,1452,4,
Garden,9-HDA and HVA,22,9,1486,1488,2,same bee from earlier turns in and starts paying more attentiom to paper
Garden,9-HDA and HVA,22,9,1734,1738,4,
Garden,9-HDA and HVA,22,9,1741,1746,5,
Garden,9-HDA and HVA,22,9,1768,1770,2,bee reamins really close to paper until 30:00
Garden,9-HDA and HVA,24,1,17,17,0,
Garden,9-HDA and HVA,24,1,67,67,0,
Garden,9-HDA and HVA,24,1,87,87,0,
Garden,9-HDA and HVA,24,1,99,99,0,
Garden,9-HDA and HVA,24,1,185,186,1,
Garden,9-HDA and HVA,24,1,208,208,0,
Garden,9-HDA and HVA,24,1,219,219,0,
Garden,9-HDA and HVA,24,1,255,257,2,
Garden,9-HDA and HVA,24,1,270,271,1,
Garden,9-HDA and HVA,24,1,326,327,1,
Garden,9-HDA and HVA,24,1,336,336,0,
Garden,9-HDA and HVA,24,1,468,468,0,
Garden,9-HDA and HVA,24,1,538,538,0,
Garden,9-HDA and HVA,24,1,538,539,1,
Garden,9-HDA and HVA,24,1,593,593,0,
Garden,9-HDA and HVA,24,1,648,648,0,
Garden,9-HDA and HVA,24,1,715,716,1,
Garden,9-HDA and HVA,24,1,738,739,1,
Garden,9-HDA and HVA,24,1,741,741,0,
Garden,9-HDA and HVA,24,1,781,783,2,
Garden,9-HDA and HVA,24,1,781,781,0,
Garden,9-HDA and HVA,24,1,834,834,0,
Garden,9-HDA and HVA,24,1,966,966,0,
Garden,9-HDA and HVA,24,1,1020,1020,0,
Garden,9-HDA and HVA,24,1,1043,1043,0,
Garden,9-HDA and HVA,24,1,1133,1135,2,
Garden,9-HDA and HVA,24,1,1163,1163,0,
Garden,9-HDA and HVA,24,1,1201,1201,0,
Garden,9-HDA and HVA,24,1,1242,1242,0,
Garden,9-HDA and HVA,24,1,1293,1293,0,
Garden,9-HDA and HVA,24,1,1296,1296,0,
Garden,9-HDA and HVA,24,1,1310,1311,1,
Garden,9-HDA and HVA,24,1,1316,1317,1,
Garden,9-HDA and HVA,24,1,1321,1322,1,
Garden,9-HDA and HVA,24,1,1327,1328,1,
Garden,9-HDA and HVA,24,1,1333,1336,3,
Garden,9-HDA and HVA,24,1,1339,1341,2,
Garden,9-HDA and HVA,24,1,1343,1344,1,
Garden,9-HDA and HVA,24,1,1347,1350,3,
Garden,9-HDA and HVA,24,1,1358,1358,0,
Garden,9-HDA and HVA,24,1,1365,1365,0,
Garden,9-HDA and HVA,24,1,1433,1436,3,
Garden,9-HDA and HVA,24,1,1487,1487,0,
Garden,9-HDA and HVA,24,1,1525,1525,0,
Garden,9-HDA and HVA,24,1,1569,1569,0,
Garden,9-HDA and HVA,24,1,1588,1588,0,
Garden,9-HDA and HVA,24,1,1643,1643,0,
Garden,9-HDA and HVA,24,1,1671,1671,0,
Garden,9-HDA and HVA,24,1,1710,1710,0,
Garden,9-HDA and HVA,24,1,1734,1734,0,
Garden,9-HDA and HVA,24,1,1774,1774,0,
Garden,9-HDA and HVA,24,1,1787,1787,0,
Garden,9-HDA and HVA,24,1,1789,1789,0,
Garden,9-HDA and HVA,25,10,31,31,0,
Garden,9-HDA and HVA,25,10,33,36,3,
Garden,9-HDA and HVA,25,10,45,48,3,
Garden,9-HDA and HVA,25,10,119,121,2,
Garden,9-HDA and HVA,25,10,158,158,0,
Garden,9-HDA and HVA,25,10,366,366,0,
Garden,9-HDA and HVA,25,10,487,487,0,
Garden,9-HDA and HVA,25,10,518,519,1,
Garden,9-HDA and HVA,25,10,542,543,1,
Garden,9-HDA and HVA,25,10,553,553,0,
Garden,9-HDA and HVA,25,10,557,560,3,
Garden,9-HDA and HVA,25,10,582,582,0,
Garden,9-HDA and HVA,25,10,590,592,2,
Garden,9-HDA and HVA,25,10,611,611,0,
Garden,9-HDA and HVA,25,10,691,703,12,
Garden,9-HDA and HVA,25,10,710,720,10,bee sort of sits on the paper for some of this time - mostly it is sniffing
Garden,9-HDA and HVA,25,10,855,855,0,
Garden,9-HDA and HVA,25,10,906,906,0,
Garden,9-HDA and HVA,25,10,989,989,0,
Garden,9-HDA and HVA,25,10,1002,1003,1,
Garden,9-HDA and HVA,25,10,1016,1022,6,
Garden,9-HDA and HVA,25,10,1030,1032,2,
Garden,9-HDA and HVA,25,10,1042,1044,2,
Garden,9-HDA and HVA,25,10,1148,1152,4,
Garden,9-HDA and HVA,25,10,1208,1209,1,
Garden,9-HDA and HVA,25,10,1283,1283,0,
Garden,9-HDA and HVA,25,10,1318,1318,0,
Garden,9-HDA and HVA,25,10,1398,1399,1,
Garden,9-HDA and HVA,25,10,1525,1525,0,
Garden,9-HDA and HVA,25,10,1575,1575,0,
Garden,9-HDA and HVA,25,10,1592,1594,2,
Garden,9-HDA and HVA,25,10,1609,1609,0,
Garden,9-HDA and HVA,26,5,0,142,142,
Garden,9-HDA and HVA,26,5,61,65,4,
Garden,9-HDA and HVA,26,5,82,82,0,
Garden,9-HDA and HVA,26,5,107,107,0,
Garden,9-HDA and HVA,26,5,145,147,2,
Garden,9-HDA and HVA,26,5,148,385,237,
Garden,9-HDA and HVA,26,5,137,203,66,
Garden,9-HDA and HVA,26,5,229,229,0,
Garden,9-HDA and HVA,26,5,371,385,14,bee flings paper over to the side of the plate it may get a little trampled on from this point
Garden,9-HDA and HVA,26,5,407,413,6,
Garden,9-HDA and HVA,26,5,421,515,94,
Garden,9-HDA and HVA,26,5,437,455,18,
Garden,9-HDA and HVA,26,5,637,637,0,
Garden,9-HDA and HVA,26,5,760,761,1,
Garden,9-HDA and HVA,26,5,852,854,2,
Garden,9-HDA and HVA,26,5,1053,1055,2,
Garden,9-HDA and HVA,26,5,1126,1727,601,
Garden,9-HDA and HVA,26,5,1145,1146,1,
Garden,9-HDA and HVA,26,5,1177,1179,2,bee walks over it
Garden,9-HDA and HVA,26,5,1234,1235,1,
Garden,9-HDA and HVA,26,5,1310,1310,0,
Garden,9-HDA and HVA,26,5,1443,1446,3,
Garden,9-HDA and HVA,26,5,1503,1506,3,
Garden,9-HDA and HVA,26,5,1574,1577,3,
Garden,9-HDA and HVA,26,5,253,253,0,
Garden,9-HDA and HVA,26,5,432,433,1,
Garden,9-HDA and HVA,28,3,10,12,2,
Garden,9-HDA and HVA,28,3,142,143,1,
Garden,9-HDA and HVA,28,3,196,196,0,
Garden,9-HDA and HVA,28,3,254,256,2,
Garden,9-HDA and HVA,28,3,320,320,0,
Garden,9-HDA and HVA,28,3,664,665,1,
Garden,9-HDA and HVA,28,3,712,712,0,
Garden,9-HDA and HVA,28,3,739,739,0,
Garden,9-HDA and HVA,28,3,802,802,0,
Garden,9-HDA and HVA,28,3,806,806,0,
Garden,9-HDA and HVA,28,3,904,904,0,
Garden,9-HDA and HVA,28,3,1074,1074,0,
Garden,9-HDA and HVA,28,3,1177,1179,2,
Garden,9-HDA and HVA,28,3,1206,1206,0,
Garden,9-HDA and HVA,28,3,1292,1292,0,
Garden,9-HDA and HVA,28,3,1313,1314,1,
Garden,9-HDA and HVA,28,3,1416,1417,1,
Garden,9-HDA and HVA,28,3,1451,1451,0,
Garden,9-HDA and HVA,28,3,1472,1474,2,
Garden,9-HDA and HVA,28,3,1503,1504,1,
Garden,9-HDA and HVA,28,3,1524,1524,0,
Garden,9-HDA and HVA,28,3,1704,1705,1,
Garden,9-HDA and HVA,28,3,1728,1728,0,
Garden,9-HDA and HVA,28,3,1763,1764,1,
Garden,9-HDA and HVA,29,9,19,22,3,
Garden,9-HDA and HVA,29,9,49,50,1,
Garden,9-HDA and HVA,29,9,106,106,0,
Garden,9-HDA and HVA,29,9,174,174,0,
Garden,9-HDA and HVA,29,9,294,295,1,
Garden,9-HDA and HVA,29,9,388,388,0,
Garden,9-HDA and HVA,29,9,399,401,2,
Garden,9-HDA and HVA,29,9,468,468,0,
Garden,9-HDA and HVA,29,9,490,491,1,
Garden,9-HDA and HVA,29,9,577,577,0,
Garden,9-HDA and HVA,29,9,588,590,2,
Garden,9-HDA and HVA,29,9,689,690,1,
Garden,9-HDA and HVA,29,9,737,737,0,
Garden,9-HDA and HVA,29,9,755,755,0,
Garden,9-HDA and HVA,29,9,788,793,5,
Garden,9-HDA and HVA,29,9,899,899,0,
Garden,9-HDA and HVA,29,9,909,909,0,
Garden,9-HDA and HVA,29,9,911,913,2,
Garden,9-HDA and HVA,29,9,979,979,0,
Garden,9-HDA and HVA,29,9,1031,1031,0,
Garden,9-HDA and HVA,29,9,1120,1120,0,
Garden,9-HDA and HVA,29,9,1123,1123,0,
Garden,9-HDA and HVA,29,9,1138,1140,2,
Garden,9-HDA and HVA,29,9,1216,1216,0,
Garden,9-HDA and HVA,29,9,1404,1409,5,
Garden,9-HDA and HVA,29,9,1425,1426,1,
Garden,9-HDA and HVA,29,9,1457,1457,0,
Garden,9-HDA and HVA,29,9,1535,1538,3,
Garden,9-HDA and HVA,29,9,1600,1600,0,
Garden,9-HDA and HVA,29,9,1752,1753,1,
Garden,9-HDA and HVA,29,9,23,24,1,
Garden,9-HDA and HVA,29,9,27,27,0,
Garden,9-HDA and HVA,29,9,35,35,0,
Garden,9-HDA and HVA,29,9,35,37,2,
Garden,9-HDA and HVA,29,9,85,85,0,
Garden,9-HDA and HVA,29,9,141,141,0,
Garden,9-HDA and HVA,29,9,147,147,0,
Garden,9-HDA and HVA,29,9,163,164,1,
Garden,9-HDA and HVA,29,9,167,167,0,
Garden,9-HDA and HVA,29,9,236,236,0,
Garden,9-HDA and HVA,29,9,322,322,0,
Garden,9-HDA and HVA,29,9,403,403,0,
Garden,9-HDA and HVA,29,9,485,486,1,
Garden,9-HDA and HVA,29,9,490,492,2,
Garden,9-HDA and HVA,29,9,494,495,1,
Garden,9-HDA and HVA,29,9,505,506,1,
Garden,9-HDA and HVA,29,9,518,520,2,
Garden,9-HDA and HVA,29,9,526,527,1,
Garden,9-HDA and HVA,29,9,547,548,1,
Garden,9-HDA and HVA,29,9,580,584,4,
Garden,9-HDA and HVA,29,9,595,596,1,
Garden,9-HDA and HVA,29,9,619,633,14,
Garden,9-HDA and HVA,31,5,32,32,0,
Garden,9-HDA and HVA,31,5,33,40,7,
Garden,9-HDA and HVA,31,5,57,57,0,
Garden,9-HDA and HVA,31,5,84,87,3,
Garden,9-HDA and HVA,31,5,156,156,0,
Garden,9-HDA and HVA,31,5,193,196,3,
Garden,9-HDA and HVA,31,5,288,288,0,
Garden,9-HDA and HVA,31,5,311,312,1,
Garden,9-HDA and HVA,31,5,387,388,1,
Garden,9-HDA and HVA,31,5,428,431,3,
Garden,9-HDA and HVA,31,5,1033,1034,1,
Garden,9-HDA and HVA,31,5,1384,1386,2,
Garden,9-HDA and HVA,31,5,1401,1941,540,
Garden,9-HDA and HVA,31,5,1404,1408,4,
Garden,9-HDA and HVA,31,5,1430,1430,0,
Garden,9-HDA and HVA,31,5,1576,1576,0,
Garden,9-HDA and HVA,31,5,1630,1630,0,
Garden,9-HDA and HVA,31,5,1687,1687,0,
Garden,9-HDA and HVA,31,5,1763,1767,4,
Garden,9-HDA and HVA,33,10,4,4,0,
Garden,9-HDA and HVA,33,10,29,29,0,
Garden,9-HDA and HVA,33,10,33,34,1,
Garden,9-HDA and HVA,33,10,43,45,2,
Garden,9-HDA and HVA,33,10,168,168,0,
Garden,9-HDA and HVA,33,10,172,172,0,
Garden,9-HDA and HVA,33,10,178,178,0,
Garden,9-HDA and HVA,33,10,208,209,1,
Garden,9-HDA and HVA,33,10,274,274,0,
Garden,9-HDA and HVA,33,10,304,304,0,
Garden,9-HDA and HVA,33,10,307,307,0,bee moves paper with its leg
Garden,9-HDA and HVA,33,10,380,380,0,
Garden,9-HDA and HVA,33,10,500,500,0,bee moves paper with its leg
Garden,9-HDA and HVA,33,10,502,502,0,
Garden,9-HDA and HVA,33,10,623,623,0,
Garden,9-HDA and HVA,33,10,639,640,1,
Garden,9-HDA and HVA,33,10,717,719,2,
Garden,9-HDA and HVA,33,10,724,724,0,
Garden,9-HDA and HVA,33,10,760,760,0,
Garden,9-HDA and HVA,33,10,827,827,0,
Garden,9-HDA and HVA,33,10,860,860,0,
Garden,9-HDA and HVA,33,10,1090,1090,0,
Garden,9-HDA and HVA,33,10,1130,1130,0,
Garden,9-HDA and HVA,33,10,1154,1154,0,
Garden,9-HDA and HVA,33,10,1211,1214,3,
Garden,9-HDA and HVA,33,10,1216,1219,3,
Garden,9-HDA and HVA,33,10,1489,1489,0,
Garden,9-HDA and HVA,33,10,1597,1597,0,
Garden,9-HDA and HVA,33,10,1642,1642,0,
Garden,9-HDA and HVA,33,10,1689,1689,0,
Garden,9-HDA and HVA,33,10,1741,1743,2,
Garden,9-HDA and HVA,34,1,356,356,0,
Garden,9-HDA and HVA,34,1,475,475,0,
Garden,9-HDA and HVA,34,1,487,487,0,
Garden,9-HDA and HVA,34,1,530,530,0,
Garden,9-HDA and HVA,34,1,625,626,1,
Garden,9-HDA and HVA,34,1,646,646,0,
Garden,9-HDA and HVA,34,1,712,712,0,
Garden,9-HDA and HVA,34,1,762,762,0,
Garden,9-HDA and HVA,34,1,830,830,0,
Garden,9-HDA and HVA,34,1,841,841,0,
Garden,9-HDA and HVA,34,1,914,914,0,
Garden,9-HDA and HVA,34,1,932,932,0,
Garden,9-HDA and HVA,34,1,953,953,0,
Garden,9-HDA and HVA,34,1,1079,1079,0,
Garden,9-HDA and HVA,34,1,1082,1082,0,
Garden,9-HDA and HVA,34,1,1135,1135,0,
Garden,9-HDA and HVA,34,1,1137,1137,0,
Garden,9-HDA and HVA,34,1,1158,1158,0,
Garden,9-HDA and HVA,34,1,1302,1302,0,
Garden,9-HDA and HVA,34,1,1304,1304,0,
Garden,9-HDA and HVA,34,1,1310,1311,1,
Garden,9-HDA and HVA,34,1,1357,1357,0,
Garden,9-HDA and HVA,34,1,1417,1417,0,
Garden,9-HDA and HVA,34,1,1444,1444,0,
Garden,9-HDA and HVA,34,1,1559,2159,600,
Garden,9-HDA and HVA,34,1,1580,1580,0,
Garden,9-HDA and HVA,34,1,1612,1612,0,
Garden,9-HDA and HVA,34,1,1722,1723,1,
Garden,9-HDA and HVA,34,1,1766,1766,0,
Garden,9-HDA and HVA,35,3,1527,1527,0,
Garden,9-HDA and HVA,35,3,1651,1651,0,
Garden,9-HDA and HVA,35,3,1687,1687,0,
Garden,9-HDA and HVA,35,3,1760,1760,0,
Garden,9-ODA and HOB,20,6,6,7,1,
Garden,9-ODA and HOB,20,6,14,14,0,
Garden,9-ODA and HOB,20,6,32,32,0,
Garden,9-ODA and HOB,20,6,39,55,16,
Garden,9-ODA and HOB,20,6,46,47,1,
Garden,9-ODA and HOB,20,6,58,64,6,
Garden,9-ODA and HOB,20,6,68,70,2,
Garden,9-ODA and HOB,20,6,78,83,5,
Garden,9-ODA and HOB,20,6,90,93,3,
Garden,9-ODA and HOB,20,6,106,106,0,
Garden,9-ODA and HOB,20,6,109,115,6,
Garden,9-ODA and HOB,20,6,117,119,2,
Garden,9-ODA and HOB,20,6,122,124,2,
Garden,9-ODA and HOB,20,6,134,134,0,
Garden,9-ODA and HOB,20,6,139,139,0,
Garden,9-ODA and HOB,20,6,148,150,2,
Garden,9-ODA and HOB,20,6,154,155,1,
Garden,9-ODA and HOB,20,6,158,159,1,
Garden,9-ODA and HOB,20,6,170,170,0,
Garden,9-ODA and HOB,20,6,179,179,0,
Garden,9-ODA and HOB,20,6,225,226,1,
Garden,9-ODA and HOB,20,6,230,230,0,
Garden,9-ODA and HOB,20,6,244,244,0,
Garden,9-ODA and HOB,20,6,407,407,0,
Garden,9-ODA and HOB,20,6,499,503,4,
Garden,9-ODA and HOB,20,6,505,507,2,
Garden,9-ODA and HOB,20,6,508,508,0,
Garden,9-ODA and HOB,20,6,508,510,2,
Garden,9-ODA and HOB,20,6,527,527,0,
Garden,9-ODA and HOB,20,6,567,567,0,
Garden,9-ODA and HOB,20,6,727,732,5,
Garden,9-ODA and HOB,20,6,743,743,0,
Garden,9-ODA and HOB,20,6,773,774,1,
Garden,9-ODA and HOB,20,6,782,787,5,
Garden,9-ODA and HOB,20,6,792,792,0,
Garden,9-ODA and HOB,20,6,818,818,0,
Garden,9-ODA and HOB,20,6,888,888,0,
Garden,9-ODA and HOB,20,6,971,973,2,
Garden,9-ODA and HOB,20,6,1015,1015,0,
Garden,9-ODA and HOB,20,6,1016,1016,0,
Garden,9-ODA and HOB,20,6,1062,1064,2,
Garden,9-ODA and HOB,20,6,1205,1207,2,
Garden,9-ODA and HOB,20,6,1282,1284,2,
Garden,9-ODA and HOB,20,6,1290,1291,1,
Garden,9-ODA and HOB,20,6,1322,1322,0,
Garden,9-ODA and HOB,20,6,1485,1486,1,
Garden,9-ODA and HOB,20,6,1722,1724,2,
Garden,9-ODA and HOB,20,6,1732,1732,0,
Garden,9-ODA and HOB,20,6,1737,1738,1,
Garden,9-ODA and HOB,21,4,2,7,5,
Garden,9-ODA and HOB,21,4,7,10,3,
Garden,9-ODA and HOB,21,4,18,22,4,00:25 it sits on the paper until
Garden,9-ODA and HOB,21,4,28,30,2,00:32 it sits on the paper until
Garden,9-ODA and HOB,21,4,34,34,0,
Garden,9-ODA and HOB,21,4,41,41,0,fly by touch
Garden,9-ODA and HOB,21,4,100,152,52,
Garden,9-ODA and HOB,21,4,106,107,1,bee walks over paper
Garden,9-ODA and HOB,21,4,127,128,1,
Garden,9-ODA and HOB,21,4,149,151,2,
Garden,9-ODA and HOB,21,4,157,158,1,
Garden,9-ODA and HOB,21,4,158,161,3,
Garden,9-ODA and HOB,21,4,163,167,4,
Garden,9-ODA and HOB,21,4,173,174,1,
Garden,9-ODA and HOB,21,4,201,202,1,
Garden,9-ODA and HOB,21,4,204,206,2,
Garden,9-ODA and HOB,21,4,228,229,1,
Garden,9-ODA and HOB,21,4,234,315,81,
Garden,9-ODA and HOB,21,4,241,288,47,
Garden,9-ODA and HOB,21,4,319,321,2,
Garden,9-ODA and HOB,21,4,325,426,101,
Garden,9-ODA and HOB,21,4,328,329,1,
Garden,9-ODA and HOB,21,4,340,343,3,
Garden,9-ODA and HOB,21,4,432,437,5,
Garden,9-ODA and HOB,21,4,444,450,6,
Garden,9-ODA and HOB,21,4,459,1081,622,"Not a mistake, the bee was actually sniffing the paper for this long actively!"
Garden,9-ODA and HOB,21,4,671,676,5,
Garden,9-ODA and HOB,21,4,679,679,0,
Garden,9-ODA and HOB,21,4,740,740,0,
Garden,9-ODA and HOB,21,4,751,753,2,
Garden,9-ODA and HOB,21,4,811,811,0,
Garden,9-ODA and HOB,21,4,813,814,1,
Garden,9-ODA and HOB,21,4,814,815,1,
Garden,9-ODA and HOB,21,4,1110,1118,8,
Garden,9-ODA and HOB,21,4,1134,1143,9,
Garden,9-ODA and HOB,21,4,1151,1155,4,
Garden,9-ODA and HOB,21,4,1170,1174,4,
Garden,9-ODA and HOB,21,4,1178,1178,0,
Garden,9-ODA and HOB,21,4,1202,1203,1,
Garden,9-ODA and HOB,21,4,1244,1245,1,
Garden,9-ODA and HOB,21,4,1246,1250,4,
Garden,9-ODA and HOB,21,4,1257,1258,1,
Garden,9-ODA and HOB,21,4,1275,1277,2,
Garden,9-ODA and HOB,21,4,1379,1380,1,
Garden,9-ODA and HOB,21,4,1390,1390,0,
Garden,9-ODA and HOB,21,4,1459,1459,0,
Garden,9-ODA and HOB,21,4,1503,1537,34,
Garden,9-ODA and HOB,21,4,1541,1572,31,"starts off sniffing from afar and then moves in, pretty sure it counts"
Garden,9-ODA and HOB,21,4,1640,1640,0,
Garden,9-ODA and HOB,21,4,1693,1800,107,"bee sits pretty much still (jerks towards paper at some points) very close to paper, not quite facing it"
Garden,9-ODA and HOB,22,4,0,20,20,
Garden,9-ODA and HOB,22,4,25,29,4,
Garden,9-ODA and HOB,22,4,62,187,125,bee is genuinely sniffing this whole time
Garden,9-ODA and HOB,22,4,187,189,2,
Garden,9-ODA and HOB,22,4,210,211,1,
Garden,9-ODA and HOB,22,4,225,228,3,
Garden,9-ODA and HOB,22,4,234,244,10,
Garden,9-ODA and HOB,22,4,257,266,9,
Garden,9-ODA and HOB,22,4,278,288,10,
Garden,9-ODA and HOB,22,4,303,352,49,
Garden,9-ODA and HOB,22,4,346,348,2,
Garden,9-ODA and HOB,22,4,377,605,228,"bee sitting kind of still, seems very interested, gets bumped away from the paper at this point"
Garden,9-ODA and HOB,22,4,416,418,2,
Garden,9-ODA and HOB,22,4,446,446,0,
Garden,9-ODA and HOB,22,4,566,577,11,
Garden,9-ODA and HOB,22,4,581,581,0,
Garden,9-ODA and HOB,22,4,593,596,3,
Garden,9-ODA and HOB,22,4,601,603,2,
Garden,9-ODA and HOB,22,4,721,747,26,"bee sits mostly still facing paper beyond this time it sits still touching paper sideways until 29:12, ocassionally sniffing it"
Garden,9-ODA and HOB,22,4,1329,1362,33,
Garden,9-ODA and HOB,22,4,1534,2154,620,
Garden,9-ODA and HOB,22,4,1560,1567,7,
Garden,9-ODA and HOB,22,4,1587,1649,62,
Garden,9-ODA and HOB,22,4,1602,1605,3,
Garden,9-ODA and HOB,22,4,1679,1693,14,
Garden,9-ODA and HOB,22,4,1709,1711,2,
Garden,9-ODA and HOB,22,4,1783,1784,1,
Garden,9-ODA and HOB,22,4,1790,1800,10,
Garden,9-ODA and HOB,24,12,11,11,0,
Garden,9-ODA and HOB,24,12,97,107,10,
Garden,9-ODA and HOB,24,12,116,116,0,
Garden,9-ODA and HOB,24,12,120,120,0,
Garden,9-ODA and HOB,24,12,123,125,2,
Garden,9-ODA and HOB,24,12,127,133,6,
Garden,9-ODA and HOB,24,12,133,137,4,
Garden,9-ODA and HOB,24,12,141,144,3,
Garden,9-ODA and HOB,24,12,147,147,0,
Garden,9-ODA and HOB,24,12,162,163,1,
Garden,9-ODA and HOB,24,12,176,178,2,
Garden,9-ODA and HOB,24,12,190,190,0,
Garden,9-ODA and HOB,24,12,204,204,0,
Garden,9-ODA and HOB,24,12,212,212,0,
Garden,9-ODA and HOB,24,12,245,245,0,
Garden,9-ODA and HOB,24,12,264,273,9,
Garden,9-ODA and HOB,24,12,299,299,0,
Garden,9-ODA and HOB,24,12,374,374,0,
Garden,9-ODA and HOB,24,12,383,386,3,
Garden,9-ODA and HOB,24,12,431,431,0,
Garden,9-ODA and HOB,24,12,453,453,0,
Garden,9-ODA and HOB,24,12,473,474,1,
Garden,9-ODA and HOB,24,12,506,506,0,
Garden,9-ODA and HOB,24,12,542,542,0,
Garden,9-ODA and HOB,24,12,558,563,5,
Garden,9-ODA and HOB,24,12,578,580,2,
Garden,9-ODA and HOB,24,12,618,619,1,
Garden,9-ODA and HOB,24,12,633,635,2,
Garden,9-ODA and HOB,24,12,685,685,0,
Garden,9-ODA and HOB,24,12,704,717,13,
Garden,9-ODA and HOB,24,12,748,748,0,
Garden,9-ODA and HOB,24,12,817,817,0,
Garden,9-ODA and HOB,24,12,828,829,1,
Garden,9-ODA and HOB,24,12,874,874,0,
Garden,9-ODA and HOB,24,12,893,894,1,
Garden,9-ODA and HOB,24,12,899,899,0,
Garden,9-ODA and HOB,24,12,904,904,0,
Garden,9-ODA and HOB,24,12,928,929,1,
Garden,9-ODA and HOB,24,12,1039,1039,0,
Garden,9-ODA and HOB,24,12,1134,1134,0,
Garden,9-ODA and HOB,24,12,1175,1175,0,
Garden,9-ODA and HOB,24,12,1180,1181,1,
Garden,9-ODA and HOB,24,12,1211,1211,0,
Garden,9-ODA and HOB,24,12,1248,1248,0,
Garden,9-ODA and HOB,24,12,1268,1269,1,bee walks over paper
Garden,9-ODA and HOB,24,12,1303,1304,1,
Garden,9-ODA and HOB,24,12,1687,1690,3,
Garden,9-ODA and HOB,24,12,1725,1727,2,
Garden,9-ODA and HOB,25,2,2,5,3,
Garden,9-ODA and HOB,25,2,56,57,1,
Garden,9-ODA and HOB,25,2,211,211,0,
Garden,9-ODA and HOB,25,2,259,261,2,
Garden,9-ODA and HOB,25,2,338,338,0,
Garden,9-ODA and HOB,25,2,353,354,1,
Garden,9-ODA and HOB,25,2,477,477,0,
Garden,9-ODA and HOB,25,2,515,519,4,
Garden,9-ODA and HOB,25,2,526,530,4,
Garden,9-ODA and HOB,25,2,555,555,0,
Garden,9-ODA and HOB,25,2,583,584,1,
Garden,9-ODA and HOB,25,2,671,671,0,
Garden,9-ODA and HOB,25,2,976,976,0,
Garden,9-ODA and HOB,25,2,1116,1117,1,
Garden,9-ODA and HOB,25,2,1226,1234,8,
Garden,9-ODA and HOB,25,2,1280,1283,3,
Garden,9-ODA and HOB,25,2,1282,1282,0,
Garden,9-ODA and HOB,25,2,1294,1298,4,
Garden,9-ODA and HOB,25,2,1389,1389,0,
Garden,9-ODA and HOB,25,2,1381,1387,6,
Garden,9-ODA and HOB,25,2,1428,1428,0,
Garden,9-ODA and HOB,25,2,1521,1546,25,
Garden,9-ODA and HOB,25,2,1560,1561,1,
Garden,9-ODA and HOB,25,2,1562,1562,0,
Garden,9-ODA and HOB,25,2,1588,1588,0,
Garden,9-ODA and HOB,25,2,1589,1589,0,
Garden,9-ODA and HOB,25,2,1649,1652,3,
Garden,9-ODA and HOB,25,2,1721,1723,2,
Garden,9-ODA and HOB,25,2,1761,1761,0,
Garden,9-ODA and HOB,26,8,0,0,0,
Garden,9-ODA and HOB,26,8,0,0,0,
Garden,9-ODA and HOB,26,8,1,5,4,
Garden,9-ODA and HOB,26,8,10,10,0,
Garden,9-ODA and HOB,26,8,37,37,0,
Garden,9-ODA and HOB,26,8,37,38,1,
Garden,9-ODA and HOB,26,8,41,45,4,
Garden,9-ODA and HOB,26,8,57,59,2,
Garden,9-ODA and HOB,26,8,132,135,3,
Garden,9-ODA and HOB,26,8,220,222,2,
Garden,9-ODA and HOB,26,8,228,229,1,
Garden,9-ODA and HOB,26,8,234,234,0,
Garden,9-ODA and HOB,26,8,252,254,2,
Garden,9-ODA and HOB,26,8,276,276,0,
Garden,9-ODA and HOB,26,8,282,283,1,
Garden,9-ODA and HOB,26,8,288,288,0,
Garden,9-ODA and HOB,26,8,398,398,0,
Garden,9-ODA and HOB,26,8,407,407,0,
Garden,9-ODA and HOB,26,8,465,465,0,
Garden,9-ODA and HOB,26,8,496,496,0,
Garden,9-ODA and HOB,26,8,509,510,1,
Garden,9-ODA and HOB,26,8,537,539,2,
Garden,9-ODA and HOB,26,8,541,542,1,
Garden,9-ODA and HOB,26,8,553,559,6,
Garden,9-ODA and HOB,26,8,681,684,3,
Garden,9-ODA and HOB,26,8,788,788,0,
Garden,9-ODA and HOB,26,8,798,799,1,
Garden,9-ODA and HOB,26,8,813,813,0,
Garden,9-ODA and HOB,26,8,847,848,1,
Garden,9-ODA and HOB,26,8,850,851,1,
Garden,9-ODA and HOB,26,8,1011,1011,0,
Garden,9-ODA and HOB,26,8,1021,1021,0,
Garden,9-ODA and HOB,26,8,1069,1070,1,
Garden,9-ODA and HOB,26,8,1082,1082,0,
Garden,9-ODA and HOB,26,8,1198,1198,0,
Garden,9-ODA and HOB,26,8,1215,1215,0,
Garden,9-ODA and HOB,26,8,1339,1339,0,
Garden,9-ODA and HOB,26,8,1501,1505,4,
Garden,9-ODA and HOB,26,8,1536,1536,0,
Garden,9-ODA and HOB,26,8,1553,1553,0,
Garden,9-ODA and HOB,26,8,1596,1596,0,
Garden,9-ODA and HOB,26,8,1614,1616,2,
Garden,9-ODA and HOB,26,8,1663,1664,1,
Garden,9-ODA and HOB,29,12,74,75,1,
Garden,9-ODA and HOB,29,12,192,192,0,
Garden,9-ODA and HOB,29,12,196,196,0,
Garden,9-ODA and HOB,29,12,213,214,1,
Garden,9-ODA and HOB,29,12,384,385,1,
Garden,9-ODA and HOB,29,12,406,407,1,
Garden,9-ODA and HOB,29,12,464,466,2,
Garden,9-ODA and HOB,29,12,570,571,1,
Garden,9-ODA and HOB,29,12,727,733,6,
Garden,9-ODA and HOB,29,12,736,736,0,
Garden,9-ODA and HOB,29,12,0,846,846,"bee sits real close to the paper, mostly motionless, but it does move a little."
Garden,9-ODA and HOB,29,12,943,943,0,
Garden,9-ODA and HOB,29,12,749,749,0,
Garden,9-ODA and HOB,29,12,749,749,0,
Garden,9-ODA and HOB,29,12,1198,1201,3,
Garden,9-ODA and HOB,29,12,1359,2022,663,
Garden,9-ODA and HOB,29,12,1577,1577,0,
Garden,9-ODA and HOB,29,12,1736,1736,0,bee sits here for a while longer but its head it not near the paper - i'm pretty sure it only actually antennates it once quickly
Garden,9-ODA and HOB,30,8,0,2,2,
Garden,9-ODA and HOB,30,8,115,116,1,
Garden,9-ODA and HOB,30,8,132,134,2,
Garden,9-ODA and HOB,30,8,132,137,5,
Garden,9-ODA and HOB,30,8,150,151,1,
Garden,9-ODA and HOB,30,8,165,165,0,
Garden,9-ODA and HOB,30,8,189,189,0,
Garden,9-ODA and HOB,30,8,191,191,0,
Garden,9-ODA and HOB,30,8,196,196,0,
Garden,9-ODA and HOB,30,8,197,197,0,
Garden,9-ODA and HOB,30,8,230,230,0,
Garden,9-ODA and HOB,30,8,241,241,0,
Garden,9-ODA and HOB,30,8,346,347,1,
Garden,9-ODA and HOB,30,8,361,363,2,
Garden,9-ODA and HOB,30,8,439,439,0,
Garden,9-ODA and HOB,30,8,545,546,1,
Garden,9-ODA and HOB,30,8,615,616,1,
Garden,9-ODA and HOB,30,8,678,681,3,
Garden,9-ODA and HOB,30,8,694,694,0,
Garden,9-ODA and HOB,30,8,843,848,5,
Garden,9-ODA and HOB,30,8,852,854,2,
Garden,9-ODA and HOB,30,8,863,864,1,
Garden,9-ODA and HOB,30,8,899,899,0,
Garden,9-ODA and HOB,30,8,936,938,2,
Garden,9-ODA and HOB,30,8,960,960,0,
Garden,9-ODA and HOB,30,8,972,972,0,
Garden,9-ODA and HOB,30,8,985,985,0,
Garden,9-ODA and HOB,30,8,1020,1021,1,
Garden,9-ODA and HOB,30,8,1053,1053,0,
Garden,9-ODA and HOB,30,8,1086,1087,1,
Garden,9-ODA and HOB,30,8,1106,1107,1,
Garden,9-ODA and HOB,30,8,1311,1316,5,
Garden,9-ODA and HOB,30,8,1390,1391,1,
Garden,9-ODA and HOB,30,8,1450,1451,1,
Garden,9-ODA and HOB,30,8,1458,1462,4,
Garden,9-ODA and HOB,30,8,1541,1542,1,
Garden,9-ODA and HOB,30,8,1573,1573,0,
Garden,9-ODA and HOB,30,8,1585,1585,0,
Garden,9-ODA and HOB,30,8,1732,1735,3,
Garden,9-ODA and HOB,30,8,1787,1791,4,
Garden,9-ODA and HOB,31,8,128,128,0,
Garden,9-ODA and HOB,31,8,149,155,6,
Garden,9-ODA and HOB,31,8,160,160,0,
Garden,9-ODA and HOB,31,8,161,161,0,
Garden,9-ODA and HOB,31,8,165,167,2,
Garden,9-ODA and HOB,31,8,179,179,0,
Garden,9-ODA and HOB,31,8,215,215,0,
Garden,9-ODA and HOB,31,8,422,423,1,
Garden,9-ODA and HOB,31,8,445,445,0,
Garden,9-ODA and HOB,31,8,462,462,0,
Garden,9-ODA and HOB,31,8,480,480,0,
Garden,9-ODA and HOB,31,8,483,483,0,
Garden,9-ODA and HOB,31,8,490,490,0,
Garden,9-ODA and HOB,31,8,520,520,0,
Garden,9-ODA and HOB,31,8,603,614,11,
Garden,9-ODA and HOB,31,8,617,617,0,
Garden,9-ODA and HOB,31,8,725,725,0,
Garden,9-ODA and HOB,31,8,741,744,3,
Garden,9-ODA and HOB,31,8,850,863,13,
Garden,9-ODA and HOB,31,8,891,894,3,
Garden,9-ODA and HOB,31,8,931,935,4,
Garden,9-ODA and HOB,31,8,980,987,7,
Garden,9-ODA and HOB,31,8,1012,1012,0,
Garden,9-ODA and HOB,31,8,1033,1033,0,
Garden,9-ODA and HOB,31,8,1170,1170,0,
Garden,9-ODA and HOB,31,8,1299,1302,3,
Garden,9-ODA and HOB,31,8,1340,1346,6,
Garden,9-ODA and HOB,31,8,1351,1353,2,
Garden,9-ODA and HOB,31,8,1375,1382,7,
Garden,9-ODA and HOB,31,8,1386,1388,2,
Garden,9-ODA and HOB,31,8,1399,1406,7,"23:58 bee sits on top of paper until this time not moving much, then bee moves paper to outside of dish and it gets trampled."
Garden,9-ODA and HOB,31,8,1515,1518,3,
Garden,9-ODA and HOB,31,8,1555,1566,11,
Garden,9-ODA and HOB,31,8,1595,1600,5,
Garden,9-ODA and HOB,31,8,1789,1800,11,
Garden,9-ODA and HOB,33,5,104,155,51,bee sits almost motionless very close to it - has a little bit of a sniff
Garden,9-ODA and HOB,33,5,146,155,9,
Garden,9-ODA and HOB,33,5,170,173,3,
Garden,9-ODA and HOB,33,5,243,247,4,
Garden,9-ODA and HOB,33,5,260,260,0,
Garden,9-ODA and HOB,33,5,271,271,0,
Garden,9-ODA and HOB,33,5,409,409,0,
Garden,9-ODA and HOB,33,5,456,456,0,
Garden,9-ODA and HOB,33,5,481,484,3,
Garden,9-ODA and HOB,33,5,501,501,0,
Garden,9-ODA and HOB,33,5,547,548,1,
Garden,9-ODA and HOB,33,5,607,608,1,
Garden,9-ODA and HOB,33,5,693,695,2,
Garden,9-ODA and HOB,33,5,752,752,0,
Garden,9-ODA and HOB,33,5,759,759,0,
Garden,9-ODA and HOB,33,5,762,764,2,
Garden,9-ODA and HOB,33,5,1320,1322,2,
Garden,9-ODA and HOB,33,5,1325,1335,10,it freaking hugs the paper! so cute
Garden,9-ODA and HOB,33,5,1339,1340,1,
Garden,9-ODA and HOB,33,5,1357,1358,1,
Garden,9-ODA and HOB,33,5,1360,1372,12,
Garden,9-ODA and HOB,33,5,1375,1375,0,
Garden,9-ODA and HOB,33,5,1376,1376,0,
Garden,9-ODA and HOB,33,5,1469,1469,0,
Garden,9-ODA and HOB,33,5,1479,1481,2,
Garden,9-ODA and HOB,33,5,1515,1515,0,
Garden,9-ODA and HOB,33,5,1593,1593,0,
Garden,9-ODA and HOB,33,5,1601,1602,1,
Garden,9-ODA and HOB,33,5,1663,1663,0,
Garden,9-ODA and HOB,33,5,1692,1692,0,
Garden,9-ODA and HOB,34,4,3,3,0,
Garden,9-ODA and HOB,34,4,25,25,0,
Garden,9-ODA and HOB,34,4,28,30,2,
Garden,9-ODA and HOB,34,4,79,79,0,
Garden,9-ODA and HOB,34,4,89,89,0,
Garden,9-ODA and HOB,34,4,106,106,0,
Garden,9-ODA and HOB,34,4,127,127,0,
Garden,9-ODA and HOB,34,4,160,160,0,
Garden,9-ODA and HOB,34,4,231,231,0,
Garden,9-ODA and HOB,34,4,324,324,0,
Garden,9-ODA and HOB,34,4,421,421,0,
Garden,9-ODA and HOB,34,4,579,579,0,
Garden,9-ODA and HOB,34,4,633,633,0,
Garden,9-ODA and HOB,34,4,861,861,0,
Garden,9-ODA and HOB,34,4,887,888,1,
Garden,9-ODA and HOB,34,4,1156,1165,9,
Garden,9-ODA and HOB,34,4,1356,1364,8,
Garden,9-ODA and HOB,34,4,1453,1453,0,
Garden,9-ODA and HOB,34,4,1485,1485,0,
Garden,9-ODA and HOB,34,4,1664,1664,0,
Garden,9-ODA and HOB,34,4,1775,1775,0,
Garden,9-ODA and HOB,35,8,154,154,0,
Garden,9-ODA and HOB,35,8,204,204,0,
Garden,9-ODA and HOB,35,8,218,218,0,
Garden,9-ODA and HOB,35,8,238,238,0,
Garden,9-ODA and HOB,35,8,264,265,1,Second bee bumbs fro=
Garden,9-ODA and HOB,35,8,294,294,0,
Garden,9-ODA and HOB,35,8,327,327,0,
Garden,9-ODA and HOB,35,8,335,335,0,
Garden,9-ODA and HOB,35,8,470,845,375,Beee is very close to paper and seems super interrested (antennae tuned to it and is bumbed away only to walk back towards paper). Pretty sure it counts - may need to review
Garden,9-ODA and HOB,35,8,509,510,1,Bee walks over it has a sniff
Garden,9-ODA and HOB,35,8,844,845,1,Second bee comes up and has a sniff - bumps fist bee away from it
Garden,9-ODA and HOB,35,8,878,878,0,
Garden,9-ODA and HOB,35,8,896,896,0,
Garden,9-ODA and HOB,35,8,920,920,0,
Garden,9-ODA and HOB,35,8,1026,1083,57,
Garden,9-ODA and HOB,35,8,1163,1163,0,
Garden,9-ODA and HOB,35,8,1224,1224,0,
Garden,9-ODA and HOB,35,8,1227,1227,0,
Garden,9-ODA and HOB,35,8,1236,1236,0,
Garden,9-ODA and HOB,35,8,1241,1241,0,
Garden,9-ODA and HOB,35,8,1242,1242,0,
Garden,9-ODA and HOB,35,8,1329,1330,1,
Garden,9-ODA and HOB,35,8,1431,1431,0,same bee turns around and has annother sniff
Garden,9-ODA and HOB,35,8,1435,1435,0,
Garden,9-ODA and HOB,35,8,1514,1514,0,
Garden,9-ODA and HOB,35,8,1515,1542,27,
Garden,9-ODA and HOB,35,8,1542,1542,0,
Garden,9-ODA and HOB,35,8,1546,1558,12,
Garden,9-ODA and HOB,35,8,1559,1585,26,
Garden,9-ODA and HOB,35,8,1589,1590,1,
Garden,9-ODA and HOB,35,8,1596,1602,6,
Garden,9-ODA and HOB,35,8,1606,1606,0,
Garden,9-ODA and HOB,35,8,1638,1638,0,
Garden,9-ODA and HOB,35,8,1650,1654,4,
Garden,9-ODA and HOB,35,8,1664,1668,4,
Garden,9-ODA and HOB,35,8,1670,1679,9,
Garden,9-ODA and HOB,35,8,1636,1636,0,
Garden,9-ODA and HOB,35,8,1644,1667,23,
Garden,9-ODA and HOB,35,8,1666,1666,0,
Garden,9-ODA and HOB,35,8,1672,1800,128,
Garden,9-ODA and HVA,20,5,1,4,3,
Garden,9-ODA and HVA,20,5,9,19,10,
Garden,9-ODA and HVA,20,5,45,48,3,
Garden,9-ODA and HVA,20,5,61,62,1,
Garden,9-ODA and HVA,20,5,82,88,6,
Garden,9-ODA and HVA,20,5,90,90,0,
Garden,9-ODA and HVA,20,5,101,103,2,
Garden,9-ODA and HVA,20,5,109,109,0,
Garden,9-ODA and HVA,20,5,129,134,5,
Garden,9-ODA and HVA,20,5,160,170,10,
Garden,9-ODA and HVA,20,5,201,213,12,
Garden,9-ODA and HVA,20,5,230,231,1,
Garden,9-ODA and HVA,20,5,240,250,10,
Garden,9-ODA and HVA,20,5,264,266,2,
Garden,9-ODA and HVA,20,5,328,333,5,
Garden,9-ODA and HVA,20,5,342,348,6,
Garden,9-ODA and HVA,20,5,353,356,3,
Garden,9-ODA and HVA,20,5,360,363,3,
Garden,9-ODA and HVA,20,5,368,368,0,
Garden,9-ODA and HVA,20,5,389,425,36,
Garden,9-ODA and HVA,20,5,401,405,4,
Garden,9-ODA and HVA,20,5,404,407,3,
Garden,9-ODA and HVA,20,5,412,414,2,
Garden,9-ODA and HVA,20,5,421,426,5,
Garden,9-ODA and HVA,20,5,427,428,1,
Garden,9-ODA and HVA,20,5,449,451,2,
Garden,9-ODA and HVA,20,5,467,553,86,
Garden,9-ODA and HVA,20,5,557,656,99,
Garden,9-ODA and HVA,20,5,667,667,0,
Garden,9-ODA and HVA,20,5,674,674,0,
Garden,9-ODA and HVA,20,5,701,702,1,
Garden,9-ODA and HVA,20,5,765,767,2,pretty sure it shouldn't count! It sort of faces the paper from a distance
Garden,9-ODA and HVA,20,5,778,778,0,
Garden,9-ODA and HVA,20,5,788,790,2,
Garden,9-ODA and HVA,20,5,868,869,1,
Garden,9-ODA and HVA,20,5,889,890,1,
Garden,9-ODA and HVA,20,5,898,900,2,
Garden,9-ODA and HVA,20,5,907,907,0,
Garden,9-ODA and HVA,20,5,950,950,0,
Garden,9-ODA and HVA,20,5,1078,1078,0,
Garden,9-ODA and HVA,20,5,1147,1151,4,
Garden,9-ODA and HVA,20,5,1154,1155,1,
Garden,9-ODA and HVA,20,5,1183,1183,0,
Garden,9-ODA and HVA,20,5,1218,1220,2,
Garden,9-ODA and HVA,20,5,1247,1248,1,
Garden,9-ODA and HVA,20,5,1326,1328,2,
Garden,9-ODA and HVA,20,5,1580,1580,0,
Garden,9-ODA and HVA,20,5,1604,1604,0,
Garden,9-ODA and HVA,21,3,14,22,8,
Garden,9-ODA and HVA,21,3,29,91,62,
Garden,9-ODA and HVA,21,3,48,70,22,
Garden,9-ODA and HVA,21,3,73,91,18,
Garden,9-ODA and HVA,21,3,105,111,6,
Garden,9-ODA and HVA,21,3,117,117,0,
Garden,9-ODA and HVA,21,3,121,131,10,
Garden,9-ODA and HVA,21,3,137,140,3,
Garden,9-ODA and HVA,21,3,144,147,3,
Garden,9-ODA and HVA,21,3,148,152,4,
Garden,9-ODA and HVA,21,3,170,172,2,
Garden,9-ODA and HVA,21,3,173,174,1,bee walks over part of the paper
Garden,9-ODA and HVA,21,3,177,182,5,
Garden,9-ODA and HVA,21,3,194,196,2,
Garden,9-ODA and HVA,21,3,200,201,1,
Garden,9-ODA and HVA,21,3,202,204,2,
Garden,9-ODA and HVA,21,3,215,217,2,
Garden,9-ODA and HVA,21,3,240,242,2,
Garden,9-ODA and HVA,21,3,316,317,1,
Garden,9-ODA and HVA,21,3,335,337,2,
Garden,9-ODA and HVA,21,3,344,344,0,
Garden,9-ODA and HVA,21,3,400,401,1,
Garden,9-ODA and HVA,21,3,414,414,0,
Garden,9-ODA and HVA,21,3,441,460,19,"7:21-7:24 obviously interested in the paper, after thazt it sort of sits at a distance facing the paper grooming itself or something? Not sure if it counts"
Garden,9-ODA and HVA,21,3,516,606,90,
Garden,9-ODA and HVA,21,3,606,607,1,
Garden,9-ODA and HVA,21,3,708,708,0,
Garden,9-ODA and HVA,21,3,864,864,0,
Garden,9-ODA and HVA,21,3,930,1074,144,"bee sits almost motionless facing paper: it gets knocked in to the paper and seems to sniff it at 16:31-16:39, it independantly sniffs paper at 17:12-17:13 and 17:32-17:54"
Garden,9-ODA and HVA,21,3,1091,1092,1,
Garden,9-ODA and HVA,21,3,1092,1195,103,
Garden,9-ODA and HVA,21,3,1137,1137,0,
Garden,9-ODA and HVA,21,3,1142,1147,5,
Garden,9-ODA and HVA,21,3,1150,1150,0,
Garden,9-ODA and HVA,21,3,1161,1168,7,
Garden,9-ODA and HVA,21,3,1204,1205,1,
Garden,9-ODA and HVA,21,3,1206,1208,2,
Garden,9-ODA and HVA,21,3,1241,1361,120,bee sits motionless sort of half facing the paper
Garden,9-ODA and HVA,21,3,1274,1276,2,
Garden,9-ODA and HVA,21,3,1286,1290,4,
Garden,9-ODA and HVA,21,3,1256,1260,4,
Garden,9-ODA and HVA,21,3,1278,1278,0,
Garden,9-ODA and HVA,21,3,1316,1373,57,
Garden,9-ODA and HVA,21,3,1375,1378,3,
Garden,9-ODA and HVA,21,3,1395,1403,8,
Garden,9-ODA and HVA,21,3,1405,1407,2,
Garden,9-ODA and HVA,21,3,1408,1410,2,
Garden,9-ODA and HVA,21,3,1439,1453,14,
Garden,9-ODA and HVA,21,3,1457,1460,3,
Garden,9-ODA and HVA,21,3,1474,1474,0,
Garden,9-ODA and HVA,21,3,1522,1526,4,
Garden,9-ODA and HVA,21,3,1558,1558,0,
Garden,9-ODA and HVA,21,3,1604,1604,0,
Garden,9-ODA and HVA,21,3,1676,1709,33,"bee sits really close to the paper, moves around a bit, definitely touches it but remains quite stationary. At some points it moves spo its not directly facing the paper 29:01-29:04, 29:10-29:11 bee definitely touches"
Garden,9-ODA and HVA,22,3,13,13,0,
Garden,9-ODA and HVA,22,3,32,32,0,
Garden,9-ODA and HVA,22,3,35,36,1,
Garden,9-ODA and HVA,22,3,42,42,0,
Garden,9-ODA and HVA,22,3,49,56,7,
Garden,9-ODA and HVA,22,3,53,54,1,
Garden,9-ODA and HVA,22,3,58,58,0,
Garden,9-ODA and HVA,22,3,60,71,11,
Garden,9-ODA and HVA,22,3,62,64,2,
Garden,9-ODA and HVA,22,3,93,126,33,
Garden,9-ODA and HVA,22,3,118,121,3,
Garden,9-ODA and HVA,22,3,120,214,94,bee is grooming itself right next to paper - turns away from it at this point
Garden,9-ODA and HVA,22,3,124,124,0,
Garden,9-ODA and HVA,22,3,133,133,0,
Garden,9-ODA and HVA,22,3,158,158,0,
Garden,9-ODA and HVA,22,3,160,160,0,
Garden,9-ODA and HVA,22,3,170,170,0,
Garden,9-ODA and HVA,22,3,180,180,0,bee walks over paper but seems to be interrested
Garden,9-ODA and HVA,22,3,206,207,1,
Garden,9-ODA and HVA,22,3,210,212,2,bee walks over paper but seems to be interrested
Garden,9-ODA and HVA,22,3,221,236,15,bee then sits next to paper not quite facing it until 20:46
Garden,9-ODA and HVA,22,3,273,275,2,
Garden,9-ODA and HVA,22,3,327,329,2,
Garden,9-ODA and HVA,22,3,328,328,0,
Garden,9-ODA and HVA,22,3,333,333,0,
Garden,9-ODA and HVA,22,3,439,441,2,
Garden,9-ODA and HVA,22,3,472,472,0,
Garden,9-ODA and HVA,22,3,608,609,1,
Garden,9-ODA and HVA,22,3,614,614,0,
Garden,9-ODA and HVA,22,3,662,662,0,
Garden,9-ODA and HVA,22,3,663,663,0,
Garden,9-ODA and HVA,22,3,665,665,0,
Garden,9-ODA and HVA,22,3,708,708,0,
Garden,9-ODA and HVA,22,3,711,711,0,not sure
Garden,9-ODA and HVA,22,3,758,758,0,
Garden,9-ODA and HVA,22,3,840,840,0,
Garden,9-ODA and HVA,22,3,869,870,1,
Garden,9-ODA and HVA,22,3,984,984,0,
Garden,9-ODA and HVA,22,3,996,998,2,
Garden,9-ODA and HVA,22,3,1020,1020,0,
Garden,9-ODA and HVA,22,3,1042,1044,2,
Garden,9-ODA and HVA,22,3,1085,1085,0,
Garden,9-ODA and HVA,22,3,1098,1099,1,
Garden,9-ODA and HVA,22,3,1157,1158,1,
Garden,9-ODA and HVA,22,3,1196,1196,0,
Garden,9-ODA and HVA,22,3,1218,1221,3,
Garden,9-ODA and HVA,22,3,1244,1246,2,
Garden,9-ODA and HVA,22,3,1229,1251,22,
Garden,9-ODA and HVA,22,3,1251,1252,1,
Garden,9-ODA and HVA,22,3,1256,1257,1,
Garden,9-ODA and HVA,22,3,1286,1286,0,
Garden,9-ODA and HVA,22,3,162,162,0,
Garden,9-ODA and HVA,22,3,1387,1388,1,bee walks over the paper
Garden,9-ODA and HVA,22,3,1416,1416,0,
Garden,9-ODA and HVA,22,3,1451,1451,0,
Garden,9-ODA and HVA,22,3,1453,1512,59,bee really interrested from 24:54 to 25:12 - rest of the time it is sort of sitting there
Garden,9-ODA and HVA,22,3,1491,1492,1,
Garden,9-ODA and HVA,22,3,1637,1638,1,
Garden,9-ODA and HVA,22,3,1659,1659,0,
Garden,9-ODA and HVA,24,7,203,203,0,
Garden,9-ODA and HVA,24,7,211,213,2,
Garden,9-ODA and HVA,24,7,213,213,0,
Garden,9-ODA and HVA,24,7,250,250,0,
Garden,9-ODA and HVA,24,7,471,483,12,the bee starts of sniffing from pretty far away and moves closer
Garden,9-ODA and HVA,24,7,496,496,0,
Garden,9-ODA and HVA,24,7,531,533,2,
Garden,9-ODA and HVA,24,7,536,537,1,
Garden,9-ODA and HVA,24,7,544,546,2,
Garden,9-ODA and HVA,24,7,635,636,1,
Garden,9-ODA and HVA,24,7,896,896,0,
Garden,9-ODA and HVA,24,7,897,897,0,
Garden,9-ODA and HVA,24,7,906,907,1,
Garden,9-ODA and HVA,24,7,1005,1016,11,
Garden,9-ODA and HVA,24,7,1031,1031,0,
Garden,9-ODA and HVA,24,7,1081,1081,0,
Garden,9-ODA and HVA,24,7,1096,1098,2,
Garden,9-ODA and HVA,24,7,1361,1363,2,
Garden,9-ODA and HVA,24,7,1394,1397,3,
Garden,9-ODA and HVA,24,7,1401,1402,1,
Garden,9-ODA and HVA,24,7,1461,1463,2,
Garden,9-ODA and HVA,24,7,1543,1543,0,
Garden,9-ODA and HVA,24,7,1555,1557,2,
Garden,9-ODA and HVA,24,7,1716,1717,1,
Garden,9-ODA and HVA,24,7,1742,1752,10,
Garden,9-ODA and HVA,25,11,0,1,1,
Garden,9-ODA and HVA,25,11,17,21,4,
Garden,9-ODA and HVA,25,11,93,96,3,
Garden,9-ODA and HVA,25,11,98,100,2,
Garden,9-ODA and HVA,25,11,126,127,1,
Garden,9-ODA and HVA,25,11,188,190,2,
Garden,9-ODA and HVA,25,11,230,236,6,
Garden,9-ODA and HVA,25,11,236,244,8,
Garden,9-ODA and HVA,25,11,238,242,4,
Garden,9-ODA and HVA,25,11,244,248,4,
Garden,9-ODA and HVA,25,11,280,282,2,
Garden,9-ODA and HVA,25,11,367,369,2,
Garden,9-ODA and HVA,25,11,431,431,0,
Garden,9-ODA and HVA,25,11,434,439,5,
Garden,9-ODA and HVA,25,11,439,440,1,
Garden,9-ODA and HVA,25,11,482,488,6,
Garden,9-ODA and HVA,25,11,541,541,0,
Garden,9-ODA and HVA,25,11,573,573,0,
Garden,9-ODA and HVA,25,11,581,587,6,
Garden,9-ODA and HVA,25,11,637,645,8,
Garden,9-ODA and HVA,25,11,642,644,2,
Garden,9-ODA and HVA,25,11,646,646,0,
Garden,9-ODA and HVA,25,11,658,661,3,
Garden,9-ODA and HVA,25,11,663,663,0,
Garden,9-ODA and HVA,25,11,792,796,4,
Garden,9-ODA and HVA,25,11,813,813,0,
Garden,9-ODA and HVA,25,11,846,848,2,
Garden,9-ODA and HVA,25,11,851,856,5,
Garden,9-ODA and HVA,25,11,867,872,5,
Garden,9-ODA and HVA,25,11,901,902,1,
Garden,9-ODA and HVA,25,11,904,910,6,
Garden,9-ODA and HVA,25,11,905,907,2,
Garden,9-ODA and HVA,25,11,979,979,0,
Garden,9-ODA and HVA,25,11,979,993,14,bee sort of sitting still next to the paper most of this time.
Garden,9-ODA and HVA,25,11,1004,1005,1,
Garden,9-ODA and HVA,25,11,1031,1033,2,
Garden,9-ODA and HVA,25,11,1149,1152,3,
Garden,9-ODA and HVA,25,11,1179,1182,3,
Garden,9-ODA and HVA,25,11,1182,1182,0,
Garden,9-ODA and HVA,25,11,1205,1208,3,
Garden,9-ODA and HVA,25,11,1212,1217,5,
Garden,9-ODA and HVA,25,11,1237,1237,0,
Garden,9-ODA and HVA,25,11,1350,1351,1,
Garden,9-ODA and HVA,25,11,1361,1361,0,
Garden,9-ODA and HVA,25,11,1371,1373,2,
Garden,9-ODA and HVA,25,11,1387,1387,0,
Garden,9-ODA and HVA,25,11,1399,1399,0,
Garden,9-ODA and HVA,25,11,1401,1405,4,
Garden,9-ODA and HVA,25,11,1407,1410,3,
Garden,9-ODA and HVA,25,11,1414,1420,6,
Garden,9-ODA and HVA,25,11,1422,1426,4,
Garden,9-ODA and HVA,25,11,1458,1461,3,
Garden,9-ODA and HVA,25,11,1499,1501,2,
Garden,9-ODA and HVA,25,11,1567,1569,2,
Garden,9-ODA and HVA,25,11,1592,1594,2,
Garden,9-ODA and HVA,25,11,1597,1599,2,
Garden,9-ODA and HVA,25,11,1602,1607,5,
Garden,9-ODA and HVA,25,11,1610,1610,0,
Garden,9-ODA and HVA,25,11,1625,1625,0,
Garden,9-ODA and HVA,25,11,1659,1660,1,
Garden,9-ODA and HVA,25,11,1670,1672,2,
Garden,9-ODA and HVA,25,11,1674,1677,3,
Garden,9-ODA and HVA,25,11,1699,1699,0,
Garden,9-ODA and HVA,25,11,1705,1707,2,
Garden,9-ODA and HVA,25,11,1778,1787,9,
Garden,9-ODA and HVA,25,11,1784,1784,0,
Garden,9-ODA and HVA,25,11,1795,1796,1,
Garden,9-ODA and HVA,26,7,5,10,5,
Garden,9-ODA and HVA,26,7,9,13,4,
Garden,9-ODA and HVA,26,7,15,17,2,
Garden,9-ODA and HVA,26,7,29,40,11,
Garden,9-ODA and HVA,26,7,50,55,5,
Garden,9-ODA and HVA,26,7,68,70,2,
Garden,9-ODA and HVA,26,7,81,86,5,
Garden,9-ODA and HVA,26,7,81,90,9,
Garden,9-ODA and HVA,26,7,95,97,2,
Garden,9-ODA and HVA,26,7,114,121,7,
Garden,9-ODA and HVA,26,7,125,128,3,
Garden,9-ODA and HVA,26,7,134,138,4,
Garden,9-ODA and HVA,26,7,140,143,3,
Garden,9-ODA and HVA,26,7,154,158,4,
Garden,9-ODA and HVA,26,7,164,168,4,
Garden,9-ODA and HVA,26,7,180,183,3,
Garden,9-ODA and HVA,26,7,188,189,1,
Garden,9-ODA and HVA,26,7,194,194,0,
Garden,9-ODA and HVA,26,7,201,204,3,
Garden,9-ODA and HVA,26,7,210,214,4,
Garden,9-ODA and HVA,26,7,219,219,0,
Garden,9-ODA and HVA,26,7,224,227,3,
Garden,9-ODA and HVA,26,7,250,254,4,
Garden,9-ODA and HVA,26,7,264,264,0,
Garden,9-ODA and HVA,26,7,271,273,2,
Garden,9-ODA and HVA,26,7,300,307,7,
Garden,9-ODA and HVA,26,7,366,1087,721,bee was on paper pretty much motionless this whole time
Garden,9-ODA and HVA,26,7,384,388,4,
Garden,9-ODA and HVA,26,7,688,689,1,
Garden,9-ODA and HVA,26,7,707,708,1,
Garden,9-ODA and HVA,26,7,271,272,1,
Garden,9-ODA and HVA,26,7,1010,1010,0,
Garden,9-ODA and HVA,26,7,1008,1012,4,there's this bee motionless on the paper and a bee comes up here and licks the bee on the paper - but its head is pretty much on the paper too - not sure if it counts
Garden,9-ODA and HVA,26,7,1052,1054,2,
Garden,9-ODA and HVA,26,7,1069,1087,18,
Garden,9-ODA and HVA,26,7,1172,1172,0,
Garden,9-ODA and HVA,26,7,1243,1244,1,
Garden,9-ODA and HVA,26,7,1335,1335,0,
Garden,9-ODA and HVA,26,7,1366,1367,1,
Garden,9-ODA and HVA,26,7,1398,1398,0,
Garden,9-ODA and HVA,26,7,1410,1412,2,
Garden,9-ODA and HVA,26,7,1533,1534,1,
Garden,9-ODA and HVA,26,7,1562,1564,2,
Garden,9-ODA and HVA,26,7,1602,1605,3,
Garden,9-ODA and HVA,26,7,1618,1628,10,
Garden,9-ODA and HVA,26,7,1635,1639,4,
Garden,9-ODA and HVA,26,7,1723,1724,1,
Garden,9-ODA and HVA,26,7,1752,1752,0,
Garden,9-ODA and HVA,28,10,18,19,1,
Garden,9-ODA and HVA,28,10,88,88,0,
Garden,9-ODA and HVA,28,10,105,108,3,
Garden,9-ODA and HVA,28,10,134,136,2,
Garden,9-ODA and HVA,28,10,277,277,0,
Garden,9-ODA and HVA,28,10,425,430,5,
Garden,9-ODA and HVA,28,10,485,486,1,
Garden,9-ODA and HVA,28,10,536,540,4,
Garden,9-ODA and HVA,28,10,983,983,0,bee kind of sniffs it kind of walks over it
Garden,9-ODA and HVA,28,10,1101,1108,7,
Garden,9-ODA and HVA,28,10,1114,1116,2,
Garden,9-ODA and HVA,28,10,1146,1147,1,
Garden,9-ODA and HVA,28,10,1350,1353,3,
Garden,9-ODA and HVA,28,10,1485,1556,71,
Garden,9-ODA and HVA,28,10,1699,1703,4,
Garden,9-ODA and HVA,29,11,20,20,0,
Garden,9-ODA and HVA,29,11,54,56,2,
Garden,9-ODA and HVA,29,11,67,70,3,
Garden,9-ODA and HVA,29,11,151,151,0,
Garden,9-ODA and HVA,29,11,208,210,2,
Garden,9-ODA and HVA,29,11,278,280,2,
Garden,9-ODA and HVA,29,11,435,437,2,
Garden,9-ODA and HVA,29,11,523,523,0,
Garden,9-ODA and HVA,29,11,717,717,0,
Garden,9-ODA and HVA,29,11,822,822,0,
Garden,9-ODA and HVA,29,11,977,980,3,
Garden,9-ODA and HVA,29,11,982,986,4,
Garden,9-ODA and HVA,29,11,1038,1041,3,
Garden,9-ODA and HVA,29,11,1068,1070,2,
Garden,9-ODA and HVA,29,11,1150,1151,1,
Garden,9-ODA and HVA,29,11,1164,1166,2,
Garden,9-ODA and HVA,29,11,1207,1217,10,
Garden,9-ODA and HVA,29,11,1236,1240,4,
Garden,9-ODA and HVA,30,7,44,44,0,
Garden,9-ODA and HVA,30,7,52,52,0,
Garden,9-ODA and HVA,30,7,138,139,1,
Garden,9-ODA and HVA,30,7,152,152,0,
Garden,9-ODA and HVA,30,7,162,165,3,
Garden,9-ODA and HVA,30,7,188,193,5,
Garden,9-ODA and HVA,30,7,201,205,4,
Garden,9-ODA and HVA,30,7,272,274,2,
Garden,9-ODA and HVA,30,7,325,337,12,
Garden,9-ODA and HVA,30,7,367,368,1,
Garden,9-ODA and HVA,30,7,370,371,1,
Garden,9-ODA and HVA,30,7,557,561,4,
Garden,9-ODA and HVA,30,7,896,896,0,
Garden,9-ODA and HVA,30,7,925,925,0,
Garden,9-ODA and HVA,30,7,995,996,1,
Garden,9-ODA and HVA,30,7,995,999,4,
Garden,9-ODA and HVA,30,7,1091,1111,20,
Garden,9-ODA and HVA,30,7,1095,1095,0,
Garden,9-ODA and HVA,30,7,1130,1143,13,
Garden,9-ODA and HVA,30,7,1281,1287,6,
Garden,9-ODA and HVA,30,7,1340,1342,2,
Garden,9-ODA and HVA,30,7,1402,1402,0,
Garden,9-ODA and HVA,30,7,1442,1442,0,
Garden,9-ODA and HVA,30,7,1464,1469,5,
Garden,9-ODA and HVA,30,7,1562,1570,8,
Garden,9-ODA and HVA,30,7,1565,1567,2,
Garden,9-ODA and HVA,30,7,1599,1600,1,
Garden,9-ODA and HVA,30,7,1668,1680,12,
Garden,9-ODA and HVA,30,7,1647,1648,1,
Garden,9-ODA and HVA,31,7,197,197,0,
Garden,9-ODA and HVA,31,7,221,224,3,
Garden,9-ODA and HVA,31,7,342,342,0,
Garden,9-ODA and HVA,31,7,370,370,0,
Garden,9-ODA and HVA,31,7,470,470,0,
Garden,9-ODA and HVA,31,7,482,482,0,
Garden,9-ODA and HVA,31,7,507,507,0,
Garden,9-ODA and HVA,31,7,556,556,0,
Garden,9-ODA and HVA,31,7,574,578,4,
Garden,9-ODA and HVA,31,7,608,612,4,
Garden,9-ODA and HVA,31,7,634,634,0,
Garden,9-ODA and HVA,31,7,685,685,0,
Garden,9-ODA and HVA,31,7,783,783,0,
Garden,9-ODA and HVA,31,7,810,810,0,
Garden,9-ODA and HVA,31,7,880,880,0,
Garden,9-ODA and HVA,31,7,923,925,2,
Garden,9-ODA and HVA,31,7,935,935,0,
Garden,9-ODA and HVA,31,7,1044,1045,1,
Garden,9-ODA and HVA,31,7,1119,1120,1,
Garden,9-ODA and HVA,31,7,1134,1134,0,
Garden,9-ODA and HVA,31,7,1136,1136,0,
Garden,9-ODA and HVA,31,7,1332,1332,0,
Garden,9-ODA and HVA,31,7,1342,1342,0,
Garden,9-ODA and HVA,31,7,1413,1413,0,
Garden,9-ODA and HVA,31,7,1421,1429,8,
Garden,9-ODA and HVA,31,7,1426,1426,0,
Garden,9-ODA and HVA,31,7,1465,1466,1,
Garden,9-ODA and HVA,31,7,1473,1473,0,
Garden,9-ODA and HVA,31,7,1534,1534,0,
Garden,9-ODA and HVA,31,7,1537,1537,0,
Garden,9-ODA and HVA,31,7,1548,1548,0,
Garden,9-ODA and HVA,31,7,1560,1563,3,
Garden,9-ODA and HVA,31,7,1637,1637,0,
Garden,9-ODA and HVA,31,7,1644,1644,0,
Garden,9-ODA and HVA,31,7,1715,1716,1,
Garden,9-ODA and HVA,31,7,1729,1731,2,
Garden,9-ODA and HVA,31,7,1764,1765,1,
Garden,9-ODA and HVA,33,3,314,315,1,
Garden,9-ODA and HVA,33,3,1066,1066,0,doesn't quite touch but seems super interrested
Garden,9-ODA and HVA,33,3,1132,1132,0,
Garden,9-ODA and HVA,33,3,1261,1264,3,
Garden,9-ODA and HVA,33,3,1275,1275,0,same bee that sniffed before turns around and knocks in to it sort of
Garden,9-ODA and HVA,33,3,1312,1312,0,
Garden,9-ODA and HVA,33,3,1352,1360,8,
Garden,9-ODA and HVA,33,3,1389,1390,1,not quite touch but sniff
Garden,9-ODA and HVA,33,3,1432,1460,28,
Garden,9-ODA and HVA,33,3,1485,1485,0,
Garden,9-ODA and HVA,33,3,1489,1489,0,
Garden,9-ODA and HVA,34,3,253,256,3,
Garden,9-ODA and HVA,34,3,298,298,0,
Garden,9-ODA and HVA,34,3,307,307,0,
Garden,9-ODA and HVA,34,3,316,317,1,
Garden,9-ODA and HVA,34,3,419,419,0,
Garden,9-ODA and HVA,34,3,484,484,0,
Garden,9-ODA and HVA,34,3,521,521,0,
Garden,9-ODA and HVA,34,3,558,560,2,seemed to be investigating paper - not sure if it counts as a touch
Garden,9-ODA and HVA,34,3,601,601,0,
Garden,9-ODA and HVA,34,3,850,850,0,
Garden,9-ODA and HVA,34,3,1237,1237,0,
Garden,9-ODA and HVA,34,3,1367,1542,175,Bee is mucking about very close to it - not sure if it counts
Garden,9-ODA and HVA,34,3,1651,1651,0,
Garden,9-ODA and HVA,34,3,1690,1690,0,Paper moved because bee walked over it - not sure if it counts
Garden,9-ODA and HVA,35,7,874,874,0,
Garden,9-ODA and HVA,35,7,1007,1007,0,Two bees in a group - one is definitely waggling its antennae real close to the pheromones - pretty sure its having a sniff
Garden,9-ODA and HVA,35,7,1038,1038,0,
Garden,9-ODA and HVA,35,7,1256,1257,1,
Garden,9-ODA and HVA,35,7,1525,1528,3,
Garden,9-ODA and HVA,35,7,1596,1596,0,
Garden,9-ODA and HVA,35,7,1723,1723,0,
Garden,9-ODA and 9-HDA,20,11,56,56,0,
Garden,9-ODA and 9-HDA,20,11,338,339,1,
Garden,9-ODA and 9-HDA,20,11,402,402,0,
Garden,9-ODA and 9-HDA,20,11,538,539,1,
Garden,9-ODA and 9-HDA,20,11,600,601,1,
Garden,9-ODA and 9-HDA,20,11,709,711,2,
Garden,9-ODA and 9-HDA,20,11,755,755,0,
Garden,9-ODA and 9-HDA,20,11,843,843,0,
Garden,9-ODA and 9-HDA,20,11,906,906,0,touches it as it walks past really quickly
Garden,9-ODA and 9-HDA,20,11,957,957,0,
Garden,9-ODA and 9-HDA,20,11,1017,1017,0,
Garden,9-ODA and 9-HDA,20,11,1046,1046,0,
Garden,9-ODA and 9-HDA,20,11,1144,1146,2,
Garden,9-ODA and 9-HDA,20,11,1164,1165,1,
Garden,9-ODA and 9-HDA,20,11,1220,1220,0,
Garden,9-ODA and 9-HDA,20,11,1274,1278,4,
Garden,9-ODA and 9-HDA,20,11,1311,1311,0,touches it as it walks past really quickly
Garden,9-ODA and 9-HDA,20,11,1467,1467,0,don't really think it counts - bee sort of walks in to paper
Garden,9-ODA and 9-HDA,20,11,1507,1507,0,
Garden,9-ODA and 9-HDA,20,11,1560,1563,3,
Garden,9-ODA and 9-HDA,20,11,1572,1572,0,
Garden,9-ODA and 9-HDA,20,11,1687,1687,0,
Garden,9-ODA and 9-HDA,21,5,0,3,3,
Garden,9-ODA and 9-HDA,21,5,3,4,1,
Garden,9-ODA and 9-HDA,21,5,5,7,2,
Garden,9-ODA and 9-HDA,21,5,35,37,2,
Garden,9-ODA and 9-HDA,21,5,56,57,1,
Garden,9-ODA and 9-HDA,21,5,65,66,1,
Garden,9-ODA and 9-HDA,21,5,184,184,0,
Garden,9-ODA and 9-HDA,21,5,200,208,8,
Garden,9-ODA and 9-HDA,21,5,261,261,0,
Garden,9-ODA and 9-HDA,21,5,265,265,0,
Garden,9-ODA and 9-HDA,21,5,429,430,1,
Garden,9-ODA and 9-HDA,21,5,450,460,10,bee sniffing from afar (I think)
Garden,9-ODA and 9-HDA,21,5,620,620,0,bee turns and sniffs but does not touch (think it counts)
Garden,9-ODA and 9-HDA,21,5,650,651,1,
Garden,9-ODA and 9-HDA,21,5,679,682,3,not sure
Garden,9-ODA and 9-HDA,21,5,878,878,0,
Garden,9-ODA and 9-HDA,21,5,1083,1084,1,
Garden,9-ODA and 9-HDA,21,5,1316,1316,0,
Garden,9-ODA and 9-HDA,21,5,1372,1375,3,
Garden,9-ODA and 9-HDA,21,5,1534,1534,0,
Garden,9-ODA and 9-HDA,21,5,1550,1550,0,
Garden,9-ODA and 9-HDA,21,5,1620,1621,1,
Garden,9-ODA and 9-HDA,21,5,1792,1792,0,
Garden,9-ODA and 9-HDA,22,5,0,13,13,
Garden,9-ODA and 9-HDA,22,5,32,39,7,
Garden,9-ODA and 9-HDA,22,5,0,52,52,
Garden,9-ODA and 9-HDA,22,5,45,46,1,
Garden,9-ODA and 9-HDA,22,5,65,66,1,
Garden,9-ODA and 9-HDA,22,5,75,81,6,
Garden,9-ODA and 9-HDA,22,5,81,81,0,
Garden,9-ODA and 9-HDA,22,5,84,89,5,
Garden,9-ODA and 9-HDA,22,5,136,140,4,
Garden,9-ODA and 9-HDA,22,5,143,146,3,
Garden,9-ODA and 9-HDA,22,5,188,200,12,
Garden,9-ODA and 9-HDA,22,5,207,212,5,
Garden,9-ODA and 9-HDA,22,5,248,250,2,
Garden,9-ODA and 9-HDA,22,5,339,339,0,
Garden,9-ODA and 9-HDA,22,5,709,711,2,
Garden,9-ODA and 9-HDA,22,5,764,764,0,
Garden,9-ODA and 9-HDA,22,5,859,868,9,
Garden,9-ODA and 9-HDA,22,5,883,889,6,
Garden,9-ODA and 9-HDA,22,5,1087,1102,15,bee was being wierd right next to paper from 16:44
Garden,9-ODA and 9-HDA,22,5,1142,1143,1,
Garden,9-ODA and 9-HDA,22,5,1180,1183,3,
Garden,9-ODA and 9-HDA,22,5,1247,1247,0,
Garden,9-ODA and 9-HDA,22,5,1308,1309,1,
Garden,9-ODA and 9-HDA,22,5,1466,1480,14,
Garden,9-ODA and 9-HDA,22,5,1501,1506,5,
Garden,9-ODA and 9-HDA,22,5,1517,1518,1,
Garden,9-ODA and 9-HDA,22,5,1607,1611,4,
Garden,9-ODA and 9-HDA,22,5,1645,1648,3,
Garden,9-ODA and 9-HDA,24,9,0,9,9,
Garden,9-ODA and 9-HDA,24,9,12,13,1,bee walks over paper
Garden,9-ODA and 9-HDA,24,9,14,16,2,
Garden,9-ODA and 9-HDA,24,9,21,234,213,
Garden,9-ODA and 9-HDA,24,9,32,151,119,
Garden,9-ODA and 9-HDA,24,9,231,232,1,
Garden,9-ODA and 9-HDA,24,9,247,275,28,paper gets moved out of the centre - I'm giving up on thos plate here. I can see that the paper just is going to get trampled.
Garden,9-ODA and 9-HDA,25,1,185,188,3,
Garden,9-ODA and 9-HDA,25,1,210,211,1,
Garden,9-ODA and 9-HDA,25,1,314,317,3,
Garden,9-ODA and 9-HDA,25,1,354,357,3,
Garden,9-ODA and 9-HDA,25,1,394,398,4,
Garden,9-ODA and 9-HDA,25,1,401,403,2,
Garden,9-ODA and 9-HDA,25,1,401,404,3,
Garden,9-ODA and 9-HDA,25,1,483,485,2,
Garden,9-ODA and 9-HDA,25,1,531,532,1,
Garden,9-ODA and 9-HDA,25,1,554,556,2,
Garden,9-ODA and 9-HDA,25,1,703,705,2,
Garden,9-ODA and 9-HDA,25,1,777,778,1,
Garden,9-ODA and 9-HDA,25,1,954,956,2,
Garden,9-ODA and 9-HDA,25,1,979,980,1,
Garden,9-ODA and 9-HDA,25,1,1068,1068,0,
Garden,9-ODA and 9-HDA,25,1,1099,1103,4,
Garden,9-ODA and 9-HDA,25,1,1165,1165,0,bee sort of walks in to the paper
Garden,9-ODA and 9-HDA,25,1,1179,1180,1,
Garden,9-ODA and 9-HDA,25,1,1192,1193,1,
Garden,9-ODA and 9-HDA,25,1,1445,1445,0,
Garden,9-ODA and 9-HDA,25,1,1476,1478,2,
Garden,9-ODA and 9-HDA,25,1,1556,1557,1,
Garden,9-ODA and 9-HDA,25,1,1566,1566,0,
Garden,9-ODA and 9-HDA,25,1,1576,1577,1,
Garden,9-ODA and 9-HDA,25,1,1583,1584,1,
Garden,9-ODA and 9-HDA,25,1,1608,1609,1,
Garden,9-ODA and 9-HDA,25,1,1728,1729,1,
Garden,9-ODA and 9-HDA,25,1,1747,1770,23,bee mucks about with the clear stiff around the paper (glue?)
Garden,9-ODA and 9-HDA,26,1,53,64,11,
Garden,9-ODA and 9-HDA,26,1,85,88,3,bee facing and very close to paper but not touching
Garden,9-ODA and 9-HDA,26,1,107,110,3,
Garden,9-ODA and 9-HDA,26,1,277,279,2,bee facing and very close to paper but not touching
Garden,9-ODA and 9-HDA,26,1,283,285,2,
Garden,9-ODA and 9-HDA,26,1,362,365,3,
Garden,9-ODA and 9-HDA,26,1,366,446,80,
Garden,9-ODA and 9-HDA,26,1,378,381,3,
Garden,9-ODA and 9-HDA,26,1,464,497,33,
Garden,9-ODA and 9-HDA,26,1,599,629,30,
Garden,9-ODA and 9-HDA,26,1,644,647,3,
Garden,9-ODA and 9-HDA,26,1,646,659,13,
Garden,9-ODA and 9-HDA,26,1,693,733,40,
Garden,9-ODA and 9-HDA,26,1,728,750,22,
Garden,9-ODA and 9-HDA,26,1,743,750,7,
Garden,9-ODA and 9-HDA,26,1,754,758,4,
Garden,9-ODA and 9-HDA,26,1,763,763,0,
Garden,9-ODA and 9-HDA,26,1,780,782,2,
Garden,9-ODA and 9-HDA,26,1,789,807,18,
Garden,9-ODA and 9-HDA,26,1,871,879,8,
Garden,9-ODA and 9-HDA,26,1,894,894,0,
Garden,9-ODA and 9-HDA,26,1,1086,1099,13,
Garden,9-ODA and 9-HDA,26,1,1118,1119,1,
Garden,9-ODA and 9-HDA,26,1,1181,1184,3,
Garden,9-ODA and 9-HDA,26,1,1309,1309,0,
Garden,9-ODA and 9-HDA,26,1,1358,1359,1,
Garden,9-ODA and 9-HDA,26,1,1501,1504,3,
Garden,9-ODA and 9-HDA,26,1,1542,1543,1,
Garden,9-ODA and 9-HDA,26,1,1740,1741,1,
Garden,9-ODA and 9-HDA,28,1,25,25,0,
Garden,9-ODA and 9-HDA,28,1,34,35,1,
Garden,9-ODA and 9-HDA,28,1,99,102,3,
Garden,9-ODA and 9-HDA,28,1,116,122,6,
Garden,9-ODA and 9-HDA,28,1,130,130,0,
Garden,9-ODA and 9-HDA,28,1,151,152,1,
Garden,9-ODA and 9-HDA,28,1,156,156,0,
Garden,9-ODA and 9-HDA,28,1,308,309,1,
Garden,9-ODA and 9-HDA,28,1,316,318,2,
Garden,9-ODA and 9-HDA,28,1,453,453,0,
Garden,9-ODA and 9-HDA,28,1,461,461,0,
Garden,9-ODA and 9-HDA,28,1,484,484,0,
Garden,9-ODA and 9-HDA,28,1,492,493,1,
Garden,9-ODA and 9-HDA,28,1,596,597,1,
Garden,9-ODA and 9-HDA,28,1,636,636,0,
Garden,9-ODA and 9-HDA,28,1,673,673,0,
Garden,9-ODA and 9-HDA,28,1,683,683,0,
Garden,9-ODA and 9-HDA,28,1,706,706,0,
Garden,9-ODA and 9-HDA,28,1,728,728,0,
Garden,9-ODA and 9-HDA,28,1,801,801,0,
Garden,9-ODA and 9-HDA,28,1,809,809,0,
Garden,9-ODA and 9-HDA,28,1,810,811,1,
Garden,9-ODA and 9-HDA,28,1,829,829,0,
Garden,9-ODA and 9-HDA,28,1,1166,1166,0,
Garden,9-ODA and 9-HDA,28,1,1209,1209,0,
Garden,9-ODA and 9-HDA,28,1,1305,1305,0,
Garden,9-ODA and 9-HDA,28,1,1343,1343,0,
Garden,9-ODA and 9-HDA,28,1,1354,1354,0,
Garden,9-ODA and 9-HDA,28,1,1372,1373,1,
Garden,9-ODA and 9-HDA,28,1,1471,1471,0,
Garden,9-ODA and 9-HDA,28,1,1493,1493,0,
Garden,9-ODA and 9-HDA,28,1,1642,1642,0,
Garden,9-ODA and 9-HDA,28,1,1707,1708,1,
Garden,9-ODA and 9-HDA,28,1,1726,1726,0,
Garden,9-ODA and 9-HDA,28,1,857,857,0,
Garden,9-ODA and 9-HDA,29,5,6,6,0,
Garden,9-ODA and 9-HDA,29,5,30,35,5,
Garden,9-ODA and 9-HDA,29,5,122,122,0,
Garden,9-ODA and 9-HDA,29,5,124,124,0,
Garden,9-ODA and 9-HDA,29,5,137,139,2,
Garden,9-ODA and 9-HDA,29,5,152,152,0,
Garden,9-ODA and 9-HDA,29,5,157,158,1,
Garden,9-ODA and 9-HDA,29,5,208,208,0,
Garden,9-ODA and 9-HDA,29,5,237,237,0,
Garden,9-ODA and 9-HDA,29,5,252,253,1,
Garden,9-ODA and 9-HDA,29,5,312,318,6,
Garden,9-ODA and 9-HDA,29,5,335,340,5,
Garden,9-ODA and 9-HDA,29,5,398,400,2,
Garden,9-ODA and 9-HDA,29,5,408,408,0,
Garden,9-ODA and 9-HDA,29,5,445,445,0,
Garden,9-ODA and 9-HDA,29,5,505,505,0,paper got moved to the side of the plate and the bees just kept walking over it. I think this plate is a bust. stopped recording touches
Garden,9-ODA and 9-HDA,30,2,66,73,7,
Garden,9-ODA and 9-HDA,30,2,78,78,0,
Garden,9-ODA and 9-HDA,30,2,79,79,0,
Garden,9-ODA and 9-HDA,30,2,103,105,2,
Garden,9-ODA and 9-HDA,30,2,122,123,1,
Garden,9-ODA and 9-HDA,30,2,209,209,0,
Garden,9-ODA and 9-HDA,30,2,230,231,1,
Garden,9-ODA and 9-HDA,30,2,315,315,0,
Garden,9-ODA and 9-HDA,30,2,415,415,0,
Garden,9-ODA and 9-HDA,30,2,500,500,0,
Garden,9-ODA and 9-HDA,30,2,518,518,0,
Garden,9-ODA and 9-HDA,30,2,561,561,0,
Garden,9-ODA and 9-HDA,30,2,603,603,0,
Garden,9-ODA and 9-HDA,30,2,615,615,0,
Garden,9-ODA and 9-HDA,30,2,654,654,0,
Garden,9-ODA and 9-HDA,30,2,663,667,4,
Garden,9-ODA and 9-HDA,30,2,719,720,1,
Garden,9-ODA and 9-HDA,30,2,782,782,0,
Garden,9-ODA and 9-HDA,30,2,851,851,0,
Garden,9-ODA and 9-HDA,30,2,859,859,0,
Garden,9-ODA and 9-HDA,30,2,895,895,0,
Garden,9-ODA and 9-HDA,30,2,1048,1049,1,
Garden,9-ODA and 9-HDA,30,2,1052,1052,0,
Garden,9-ODA and 9-HDA,30,2,1250,1250,0,
Garden,9-ODA and 9-HDA,30,2,1295,1295,0,
Garden,9-ODA and 9-HDA,30,2,1301,1301,0,
Garden,9-ODA and 9-HDA,30,2,1317,1317,0,
Garden,9-ODA and 9-HDA,30,2,1411,1411,0,
Garden,9-ODA and 9-HDA,30,2,1613,1614,1,
Garden,9-ODA and 9-HDA,30,2,1641,1641,0,
Garden,9-ODA and 9-HDA,30,2,1689,1751,62,
Garden,9-ODA and 9-HDA,31,1,14,16,2,
Garden,9-ODA and 9-HDA,31,1,23,24,1,
Garden,9-ODA and 9-HDA,31,1,28,38,10,bee sits on top of paper
Garden,9-ODA and 9-HDA,31,1,40,44,4,
Garden,9-ODA and 9-HDA,31,1,42,46,4,bee walks over paper but sniffs a little
Garden,9-ODA and 9-HDA,31,1,49,49,0,
Garden,9-ODA and 9-HDA,31,1,51,51,0,
Garden,9-ODA and 9-HDA,31,1,57,63,6,
Garden,9-ODA and 9-HDA,31,1,67,71,4,
Garden,9-ODA and 9-HDA,31,1,71,74,3,
Garden,9-ODA and 9-HDA,31,1,75,87,12,bee sits on paper
Garden,9-ODA and 9-HDA,31,1,83,85,2,
Garden,9-ODA and 9-HDA,31,1,113,137,24,
Garden,9-ODA and 9-HDA,31,1,139,141,2,
Garden,9-ODA and 9-HDA,31,1,144,151,7,
Garden,9-ODA and 9-HDA,31,1,149,152,3,
Garden,9-ODA and 9-HDA,31,1,154,156,2,
Garden,9-ODA and 9-HDA,31,1,154,185,31,
Garden,9-ODA and 9-HDA,31,1,160,160,0,
Garden,9-ODA and 9-HDA,31,1,184,186,2,
Garden,9-ODA and 9-HDA,31,1,215,216,1,
Garden,9-ODA and 9-HDA,31,1,222,222,0,
Garden,9-ODA and 9-HDA,31,1,225,230,5,
Garden,9-ODA and 9-HDA,31,1,243,256,13,
Garden,9-ODA and 9-HDA,31,1,261,276,15,bee sitting on paper
Garden,9-ODA and 9-HDA,31,1,303,306,3,
Garden,9-ODA and 9-HDA,31,1,341,341,0,
Garden,9-ODA and 9-HDA,31,1,355,370,15,
Garden,9-ODA and 9-HDA,31,1,380,382,2,
Garden,9-ODA and 9-HDA,31,1,413,413,0,bee walks over paper
Garden,9-ODA and 9-HDA,31,1,429,432,3,
Garden,9-ODA and 9-HDA,31,1,476,489,13,
Garden,9-ODA and 9-HDA,31,1,494,499,5,
Garden,9-ODA and 9-HDA,31,1,504,506,2,
Garden,9-ODA and 9-HDA,31,1,510,518,8,
Garden,9-ODA and 9-HDA,31,1,513,513,0,
Garden,9-ODA and 9-HDA,31,1,527,527,0,
Garden,9-ODA and 9-HDA,31,1,530,554,24,
Garden,9-ODA and 9-HDA,31,1,548,552,4,
Garden,9-ODA and 9-HDA,31,1,561,564,3,
Garden,9-ODA and 9-HDA,31,1,557,573,16,
Garden,9-ODA and 9-HDA,31,1,641,642,1,bee walks over paper
Garden,9-ODA and 9-HDA,31,1,646,648,2,
Garden,9-ODA and 9-HDA,31,1,662,664,2,bee walks over paper
Garden,9-ODA and 9-HDA,31,1,671,675,4,
Garden,9-ODA and 9-HDA,31,1,680,687,7,
Garden,9-ODA and 9-HDA,31,1,690,692,2,
Garden,9-ODA and 9-HDA,31,1,699,699,0,
Garden,9-ODA and 9-HDA,31,1,704,706,2,
Garden,9-ODA and 9-HDA,31,1,737,738,1,bee walks over paper
Garden,9-ODA and 9-HDA,31,1,739,742,3,
Garden,9-ODA and 9-HDA,31,1,774,774,0,
Garden,9-ODA and 9-HDA,31,1,774,775,1,
Garden,9-ODA and 9-HDA,31,1,794,795,1,
Garden,9-ODA and 9-HDA,31,1,810,813,3,
Garden,9-ODA and 9-HDA,31,1,814,815,1,bee walks over paper
Garden,9-ODA and 9-HDA,31,1,863,869,6,
Garden,9-ODA and 9-HDA,31,1,881,883,2,
Garden,9-ODA and 9-HDA,31,1,916,917,1,
Garden,9-ODA and 9-HDA,31,1,925,926,1,
Garden,9-ODA and 9-HDA,31,1,942,942,0,
Garden,9-ODA and 9-HDA,31,1,951,952,1,bee walks over paper
Garden,9-ODA and 9-HDA,31,1,973,973,0,
Garden,9-ODA and 9-HDA,31,1,982,983,1,
Garden,9-ODA and 9-HDA,31,1,985,986,1,
Garden,9-ODA and 9-HDA,31,1,994,995,1,bee walks over paper
Garden,9-ODA and 9-HDA,31,1,995,996,1,bee walks over paper
Garden,9-ODA and 9-HDA,31,1,1001,1002,1,
Garden,9-ODA and 9-HDA,31,1,1033,1034,1,bee walks over paper
Garden,9-ODA and 9-HDA,31,1,1040,1045,5,
Garden,9-ODA and 9-HDA,31,1,1063,1064,1,bee walks over paper
Garden,9-ODA and 9-HDA,31,1,1077,1077,0,
Garden,9-ODA and 9-HDA,31,1,1104,1104,0,bee walks over paper
Garden,9-ODA and 9-HDA,31,1,1107,1107,0,bee walks over paper
Garden,9-ODA and 9-HDA,31,1,1119,1119,0,
Garden,9-ODA and 9-HDA,31,1,1131,1131,0,
Garden,9-ODA and 9-HDA,31,1,1174,1174,0,
Garden,9-ODA and 9-HDA,31,1,1177,1179,2,
Garden,9-ODA and 9-HDA,31,1,1180,1181,1,
Garden,9-ODA and 9-HDA,31,1,1254,1259,5,
Garden,9-ODA and 9-HDA,31,1,1274,1274,0,
Garden,9-ODA and 9-HDA,31,1,1312,1314,2,bee walks over paper
Garden,9-ODA and 9-HDA,31,1,1317,1318,1,bee walks over paper
Garden,9-ODA and 9-HDA,31,1,1320,1320,0,
Garden,9-ODA and 9-HDA,31,1,1323,1324,1,
Garden,9-ODA and 9-HDA,31,1,1329,1329,0,
Garden,9-ODA and 9-HDA,31,1,1330,1330,0,
Garden,9-ODA and 9-HDA,31,1,1333,1333,0,
Garden,9-ODA and 9-HDA,31,1,1336,1337,1,
Garden,9-ODA and 9-HDA,31,1,1349,1349,0,bee walks over paper
Garden,9-ODA and 9-HDA,31,1,1350,1350,0,bee walks over paper
Garden,9-ODA and 9-HDA,31,1,1383,1383,0,
Garden,9-ODA and 9-HDA,31,1,1388,1392,4,
Garden,9-ODA and 9-HDA,31,1,1406,1409,3,bee walks over paper
Garden,9-ODA and 9-HDA,31,1,1450,1450,0,
Garden,9-ODA and 9-HDA,31,1,1459,1459,0,
Garden,9-ODA and 9-HDA,31,1,1463,1464,1,bee walks over paper
Garden,9-ODA and 9-HDA,31,1,1483,1483,0,
Garden,9-ODA and 9-HDA,31,1,1488,1491,3,
Garden,9-ODA and 9-HDA,31,1,1494,1496,2,
Garden,9-ODA and 9-HDA,31,1,1511,1514,3,
Garden,9-ODA and 9-HDA,31,1,1515,1517,2,
Garden,9-ODA and 9-HDA,31,1,1523,1524,1,
Garden,9-ODA and 9-HDA,31,1,1561,1562,1,
Garden,9-ODA and 9-HDA,31,1,1563,1566,3,
Garden,9-ODA and 9-HDA,31,1,1635,1638,3,
Garden,9-ODA and 9-HDA,31,1,1643,1644,1,
Garden,9-ODA and 9-HDA,31,1,1674,1674,0,
Garden,9-ODA and 9-HDA,31,1,1687,1690,3,
Garden,9-ODA and 9-HDA,31,1,1696,1703,7,bee sits on paper
Garden,9-ODA and 9-HDA,31,1,1715,1715,0,
Garden,9-ODA and 9-HDA,31,1,1672,1737,65,
Garden,9-ODA and 9-HDA,31,1,1757,1758,1,
Garden,9-ODA and 9-HDA,31,1,1785,1786,1,
Garden,9-ODA and 9-HDA,31,1,1797,1799,2,
Garden,9-ODA and 9-HDA,33,12,8,8,0,
Garden,9-ODA and 9-HDA,33,12,49,49,0,
Garden,9-ODA and 9-HDA,33,12,144,146,2,
Garden,9-ODA and 9-HDA,33,12,165,165,0,
Garden,9-ODA and 9-HDA,33,12,171,171,0,
Garden,9-ODA and 9-HDA,33,12,201,201,0,
Garden,9-ODA and 9-HDA,33,12,238,238,0,
Garden,9-ODA and 9-HDA,33,12,285,285,0,
Garden,9-ODA and 9-HDA,33,12,304,305,1,
Garden,9-ODA and 9-HDA,33,12,317,317,0,
Garden,9-ODA and 9-HDA,33,12,426,426,0,
Garden,9-ODA and 9-HDA,33,12,450,450,0,
Garden,9-ODA and 9-HDA,33,12,488,488,0,
Garden,9-ODA and 9-HDA,33,12,511,511,0,
Garden,9-ODA and 9-HDA,33,12,518,518,0,
Garden,9-ODA and 9-HDA,33,12,535,535,0,
Garden,9-ODA and 9-HDA,33,12,543,543,0,
Garden,9-ODA and 9-HDA,33,12,545,548,3,
Garden,9-ODA and 9-HDA,33,12,553,553,0,
Garden,9-ODA and 9-HDA,33,12,559,559,0,
Garden,9-ODA and 9-HDA,33,12,563,563,0,
Garden,9-ODA and 9-HDA,33,12,569,569,0,bee walks over a corner of thr paper
Garden,9-ODA and 9-HDA,33,12,629,629,0,
Garden,9-ODA and 9-HDA,33,12,644,654,10,
Garden,9-ODA and 9-HDA,33,12,657,658,1,
Garden,9-ODA and 9-HDA,33,12,676,676,0,
Garden,9-ODA and 9-HDA,33,12,755,755,0,bee moves paper with leg
Garden,9-ODA and 9-HDA,33,12,763,763,0,
Garden,9-ODA and 9-HDA,33,12,775,777,2,bee crashes in to it as it walks past
Garden,9-ODA and 9-HDA,33,12,806,806,0,
Garden,9-ODA and 9-HDA,33,12,866,868,2,Bee walks over it but doesn't stop
Garden,9-ODA and 9-HDA,33,12,896,896,0,
Garden,9-ODA and 9-HDA,33,12,936,936,0,
Garden,9-ODA and 9-HDA,33,12,942,1246,304,bee intitially seems super interrested then just seems to fall asleep touching the paper until it is pushed away from it
Garden,9-ODA and 9-HDA,33,12,948,948,0,
Garden,9-ODA and 9-HDA,33,12,961,961,0,
Garden,9-ODA and 9-HDA,33,12,992,993,1,
Garden,9-ODA and 9-HDA,33,12,1001,1001,0,
Garden,9-ODA and 9-HDA,33,12,1007,1007,0,
Garden,9-ODA and 9-HDA,33,12,1008,1008,0,
Garden,9-ODA and 9-HDA,33,12,1016,1031,15,
Garden,9-ODA and 9-HDA,33,12,1024,1032,8,
Garden,9-ODA and 9-HDA,33,12,1045,1045,0,
Garden,9-ODA and 9-HDA,33,12,1055,1057,2,
Garden,9-ODA and 9-HDA,33,12,1110,1110,0,
Garden,9-ODA and 9-HDA,33,12,1121,1121,0,
Garden,9-ODA and 9-HDA,33,12,1134,1134,0,
Garden,9-ODA and 9-HDA,33,12,1140,1140,0,bee moves paper with leg as it walks past
Garden,9-ODA and 9-HDA,33,12,1163,1163,0,
Garden,9-ODA and 9-HDA,33,12,1174,1174,0,
Garden,9-ODA and 9-HDA,33,12,1241,1246,5,
Garden,9-ODA and 9-HDA,33,12,1405,1405,0,
Garden,9-ODA and 9-HDA,33,12,1536,1536,0,
Garden,9-ODA and 9-HDA,33,12,1599,1599,0,
Garden,9-ODA and 9-HDA,33,12,1631,1632,1,
Garden,9-ODA and 9-HDA,33,12,1636,1641,5,bee sort of smooshes past it
Garden,9-ODA and 9-HDA,33,12,1648,1648,0,
Garden,9-ODA and 9-HDA,33,12,1699,1699,0,
Garden,9-ODA and 9-HDA,33,12,1712,1714,2,
Garden,9-ODA and 9-HDA,33,12,1718,1800,82,bee remains motionless touching the paper
Garden,9-ODA and 9-HDA,33,12,1725,1726,1,
Garden,9-ODA and 9-HDA,33,12,1763,1763,0,
Garden,9-ODA and 9-HDA,33,12,1783,1786,3,
Garden,9-ODA and 9-HDA,33,12,1770,1770,0,
Garden,9-ODA and 9-HDA,34,9,78,78,0,
Garden,9-ODA and 9-HDA,34,9,210,210,0,
Garden,9-ODA and 9-HDA,34,9,237,237,0,
Garden,9-ODA and 9-HDA,34,9,262,267,5,
Garden,9-ODA and 9-HDA,34,9,303,303,0,
Garden,9-ODA and 9-HDA,34,9,342,342,0,
Garden,9-ODA and 9-HDA,34,9,394,394,0,
Garden,9-ODA and 9-HDA,34,9,472,472,0,
Garden,9-ODA and 9-HDA,34,9,528,528,0,
Garden,9-ODA and 9-HDA,34,9,560,560,0,
Garden,9-ODA and 9-HDA,34,9,589,589,0,
Garden,9-ODA and 9-HDA,34,9,604,604,0,
Garden,9-ODA and 9-HDA,34,9,610,617,7,Bee very close - not sure if it counts
Garden,9-ODA and 9-HDA,34,9,616,616,0,
Garden,9-ODA and 9-HDA,34,9,621,622,1,
Garden,9-ODA and 9-HDA,34,9,632,633,1,bee brushes up against it as its walking past
Garden,9-ODA and 9-HDA,34,9,677,677,0,
Garden,9-ODA and 9-HDA,34,9,681,683,2,bee walks past and touches it with its legs
Garden,9-ODA and 9-HDA,34,9,701,701,0,
Garden,9-ODA and 9-HDA,34,9,719,726,7,
Garden,9-ODA and 9-HDA,34,9,732,732,0,
Garden,9-ODA and 9-HDA,34,9,746,746,0,
Garden,9-ODA and 9-HDA,34,9,820,820,0,
Garden,9-ODA and 9-HDA,34,9,821,821,0,
Garden,9-ODA and 9-HDA,34,9,833,833,0,
Garden,9-ODA and 9-HDA,34,9,885,885,0,
Garden,9-ODA and 9-HDA,34,9,1013,1054,41,Bee very close to circle of pheromone leeched around paper -may not count it just sits motionless
Garden,9-ODA and 9-HDA,34,9,1061,1061,0,
Garden,9-ODA and 9-HDA,34,9,1085,1085,0,
Garden,9-ODA and 9-HDA,34,9,1156,1156,0,
Garden,9-ODA and 9-HDA,34,9,1535,1535,0,
Garden,9-ODA and 9-HDA,34,9,1571,1571,0,
Garden,9-ODA and 9-HDA,34,9,1614,1614,0,
Garden,9-ODA and 9-HDA,34,9,1682,1682,0,
Garden,9-ODA and 9-HDA,34,9,1716,1716,0,
Garden,9-ODA and 9-HDA,34,9,1755,1755,0,
Garden,9-ODA and 9-HDA,34,9,1761,1761,0,
Garden,9-ODA and 9-HDA,35,1,395,395,0,less than one second touch - seems to go in for a second sniff two seconds later
Garden,9-ODA and 9-HDA,35,1,397,397,0,
Garden,9-ODA and 9-HDA,35,1,463,463,0,Very short touch
Garden,9-ODA and 9-HDA,35,1,762,762,0,Very short touch
Garden,9-ODA and 9-HDA,35,1,862,862,0,
Garden,9-ODA and 9-HDA,35,1,953,953,0,
Garden,9-ODA and 9-HDA,35,1,1303,1303,0,
Garden,9-ODA and 9-HDA,35,1,1496,1496,0,
Garden,9-ODA and 9-HDA,35,1,1752,1753,1,
Skylab,Solvent control,1,12,3,3,0,
Skylab,Solvent control,1,12,9,13,4,
Skylab,Solvent control,1,12,14,14,0,
Skylab,Solvent control,1,12,16,16,0,
Skylab,Solvent control,1,12,17,21,4,
Skylab,Solvent control,1,12,25,25,0,
Skylab,Solvent control,1,12,33,33,0,
Skylab,Solvent control,1,12,111,112,1,
Skylab,Solvent control,1,12,87,87,0,
Skylab,Solvent control,1,12,89,93,4,
Skylab,Solvent control,1,12,95,96,1,
Skylab,Solvent control,1,12,99,100,1,
Skylab,Solvent control,1,12,103,105,2,
Skylab,Solvent control,1,12,133,134,1,
Skylab,Solvent control,1,12,136,137,1,
Skylab,Solvent control,1,12,141,141,0,
Skylab,Solvent control,1,12,157,157,0,
Skylab,Solvent control,1,12,162,164,2,
Skylab,Solvent control,1,12,166,172,6,
Skylab,Solvent control,1,12,168,168,0,
Skylab,Solvent control,1,12,231,232,1,
Skylab,Solvent control,1,12,243,243,0,
Skylab,Solvent control,1,12,252,253,1,
Skylab,Solvent control,1,12,280,280,0,
Skylab,Solvent control,1,12,281,281,0,
Skylab,Solvent control,1,12,287,287,0,
Skylab,Solvent control,1,12,305,305,0,
Skylab,Solvent control,1,12,314,314,0,
Skylab,Solvent control,1,12,321,321,0,
Skylab,Solvent control,1,12,325,326,1,
Skylab,Solvent control,1,12,348,349,1,
Skylab,Solvent control,1,12,363,363,0,
Skylab,Solvent control,1,12,366,366,0,
Skylab,Solvent control,1,12,371,371,0,
Skylab,Solvent control,1,12,375,375,0,
Skylab,Solvent control,1,12,388,388,0,
Skylab,Solvent control,1,12,287,287,0,
Skylab,Solvent control,1,12,424,424,0,
Skylab,Solvent control,1,12,217,218,1,
Skylab,Solvent control,1,12,462,462,0,
Skylab,Solvent control,1,12,468,469,1,
Skylab,Solvent control,1,12,472,473,1,
Skylab,Solvent control,1,12,488,488,0,
Skylab,Solvent control,1,12,498,498,0,
Skylab,Solvent control,1,12,514,514,0,
Skylab,Solvent control,1,12,548,548,0,
Skylab,Solvent control,1,12,555,555,0,
Skylab,Solvent control,1,12,557,557,0,
Skylab,Solvent control,1,12,564,564,0,
Skylab,Solvent control,1,12,576,577,1,
Skylab,Solvent control,1,12,584,585,1,
Skylab,Solvent control,1,12,585,585,0,
Skylab,Solvent control,1,12,599,599,0,
Skylab,Solvent control,1,12,611,611,0,
Skylab,Solvent control,1,12,671,671,0,
Skylab,Solvent control,1,12,674,674,0,
Skylab,Solvent control,1,12,690,692,2,
Skylab,Solvent control,1,12,692,692,0,
Skylab,Solvent control,1,12,734,735,1,
Skylab,Solvent control,1,12,764,764,0,
Skylab,Solvent control,1,12,766,766,0,
Skylab,Solvent control,1,12,772,772,0,
Skylab,Solvent control,1,12,773,773,0,
Skylab,Solvent control,1,12,782,782,0,
Skylab,Solvent control,1,12,788,788,0,
Skylab,Solvent control,1,12,795,795,0,
Skylab,Solvent control,1,12,809,810,1,
Skylab,Solvent control,1,12,841,841,0,
Skylab,Solvent control,1,12,857,858,1,
Skylab,Solvent control,1,12,861,861,0,
Skylab,Solvent control,1,12,871,872,1,
Skylab,Solvent control,1,12,891,892,1,
Skylab,Solvent control,1,12,901,901,0,
Skylab,Solvent control,1,12,910,910,0,
Skylab,Solvent control,1,12,914,915,1,
Skylab,Solvent control,1,12,917,917,0,
Skylab,Solvent control,1,12,923,924,1,
Skylab,Solvent control,1,12,925,925,0,
Skylab,Solvent control,1,12,930,930,0,
Skylab,Solvent control,1,12,938,939,1,
Skylab,Solvent control,1,12,950,951,1,
Skylab,Solvent control,1,12,965,965,0,
Skylab,Solvent control,1,12,967,967,0,
Skylab,Solvent control,1,12,988,989,1,
Skylab,Solvent control,1,12,996,997,1,
Skylab,Solvent control,1,12,1006,1007,1,
Skylab,Solvent control,1,12,1019,1019,0,
Skylab,Solvent control,1,12,1037,1038,1,
Skylab,Solvent control,1,12,1041,1041,0,
Skylab,Solvent control,1,12,1055,1055,0,
Skylab,Solvent control,1,12,1067,1067,0,
Skylab,Solvent control,1,12,1082,1082,0,
Skylab,Solvent control,1,12,1097,1097,0,
Skylab,Solvent control,1,12,1104,1105,1,
Skylab,Solvent control,1,12,1122,1123,1,
Skylab,Solvent control,1,12,1144,1144,0,
Skylab,Solvent control,1,12,1151,1152,1,
Skylab,Solvent control,1,12,1166,1167,1,
Skylab,Solvent control,1,12,1173,1173,0,
Skylab,Solvent control,1,12,1200,1200,0,
Skylab,Solvent control,1,12,1213,1213,0,
Skylab,Solvent control,1,12,1218,1219,1,
Skylab,Solvent control,1,12,1222,1223,1,
Skylab,Solvent control,1,12,1224,1224,0,
Skylab,Solvent control,1,12,1230,1230,0,
Skylab,Solvent control,1,12,1245,1246,1,
Skylab,Solvent control,1,12,1247,1247,0,
Skylab,Solvent control,1,12,1258,1258,0,
Skylab,Solvent control,1,12,1258,1258,0,
Skylab,Solvent control,1,12,1273,1273,0,
Skylab,Solvent control,1,12,1301,1303,2,
Skylab,Solvent control,1,12,1315,1315,0,
Skylab,Solvent control,1,12,1326,1326,0,
Skylab,Solvent control,1,12,1352,1352,0,
Skylab,Solvent control,1,12,1359,1359,0,
Skylab,Solvent control,1,12,1361,1361,0,
Skylab,Solvent control,1,12,1373,1374,1,
Skylab,Solvent control,1,12,1384,1384,0,
Skylab,Solvent control,1,12,1385,1385,0,
Skylab,Solvent control,1,12,1386,1387,1,
Skylab,Solvent control,1,12,1407,1407,0,
Skylab,Solvent control,1,12,1412,1413,1,
Skylab,Solvent control,1,12,1417,1418,1,
Skylab,Solvent control,1,12,1425,1425,0,
Skylab,Solvent control,1,12,1430,1431,1,
Skylab,Solvent control,1,12,1433,1434,1,
Skylab,Solvent control,1,12,1442,1443,1,
Skylab,Solvent control,1,12,1452,1453,1,
Skylab,Solvent control,1,12,1454,1454,0,
Skylab,Solvent control,1,12,1470,1471,1,
Skylab,Solvent control,1,12,1494,1494,0,
Skylab,Solvent control,1,12,1498,1500,2,
Skylab,Solvent control,1,12,1519,1521,2,
Skylab,Solvent control,1,12,1521,1521,0,
Skylab,Solvent control,1,12,1521,1525,4,
Skylab,Solvent control,1,12,1530,1530,0,
Skylab,Solvent control,1,12,1537,1537,0,
Skylab,Solvent control,1,12,1539,1539,0,
Skylab,Solvent control,1,12,1540,1540,0,
Skylab,Solvent control,1,12,1552,1552,0,
Skylab,Solvent control,1,12,1560,1560,0,
Skylab,Solvent control,1,12,1563,1572,9,
Skylab,Solvent control,1,12,1573,1573,0,
Skylab,Solvent control,1,12,1575,1579,4,
Skylab,Solvent control,1,12,1582,1583,1,
Skylab,Solvent control,1,12,1588,1593,5,
Skylab,Solvent control,1,12,1610,1610,0,
Skylab,Solvent control,1,12,1618,1619,1,
Skylab,Solvent control,1,12,1620,1620,0,
Skylab,Solvent control,1,12,1620,1620,0,
Skylab,Solvent control,1,12,1624,1624,0,
Skylab,Solvent control,1,12,1634,1635,1,
Skylab,Solvent control,1,12,1638,1639,1,
Skylab,Solvent control,1,12,1645,1645,0,
Skylab,Solvent control,1,12,1645,1646,1,
Skylab,Solvent control,1,12,1652,1652,0,
Skylab,Solvent control,1,12,1660,1666,6,
Skylab,Solvent control,1,12,1680,1681,1,
Skylab,Solvent control,1,12,1681,1684,3,
Skylab,Solvent control,1,12,1688,1688,0,
Skylab,Solvent control,1,12,1694,1702,8,
Skylab,Solvent control,1,12,1702,1703,1,
Skylab,Solvent control,1,12,1705,1798,93,
Skylab,Solvent control,1,12,1706,1707,1,
Skylab,Solvent control,1,12,1734,1736,2,
Skylab,Solvent control,1,12,1737,1738,1,
Skylab,Solvent control,1,12,1742,1742,0,
Skylab,Solvent control,1,12,1755,1755,0,
Skylab,Solvent control,1,12,1761,1761,0,
Skylab,Solvent control,1,12,1763,1763,0,
Skylab,Solvent control,1,12,1764,1764,0,
Skylab,Solvent control,1,12,1766,1766,0,
Skylab,Solvent control,1,12,1770,1771,1,
Skylab,Solvent control,1,12,1782,1782,0,
Skylab,Solvent control,1,12,1784,1785,1,
Skylab,Solvent control,1,12,1794,1798,4,
Skylab,Solvent control,2,12,23,37,14,
Skylab,Solvent control,2,12,267,274,7,
Skylab,Solvent control,2,12,344,346,2,
Skylab,Solvent control,2,12,487,488,1,
Skylab,Solvent control,2,12,501,502,1,
Skylab,Solvent control,2,12,586,587,1,
Skylab,Solvent control,2,12,710,711,1,
Skylab,Solvent control,2,12,752,752,0,
Skylab,Solvent control,2,12,755,758,3,
Skylab,Solvent control,2,12,762,763,1,
Skylab,Solvent control,2,12,799,799,0,
Skylab,Solvent control,2,12,826,828,2,
Skylab,Solvent control,2,12,845,853,8,
Skylab,Solvent control,2,12,928,931,3,
Skylab,Solvent control,2,12,1009,1009,0,
Skylab,Solvent control,2,12,1023,1024,1,
Skylab,Solvent control,2,12,1079,1079,0,
Skylab,Solvent control,2,12,1154,1154,0,
Skylab,Solvent control,2,12,936,1159,223,bee sits mostly still facing the paper a short distance from it
Skylab,Solvent control,2,12,1159,1159,0,
Skylab,Solvent control,2,12,1163,1175,12,
Skylab,Solvent control,2,12,1203,1203,0,
Skylab,Solvent control,2,12,1210,1211,1,
Skylab,Solvent control,2,12,1243,1244,1,
Skylab,Solvent control,2,12,1265,1265,0,
Skylab,Solvent control,2,12,1293,1293,0,
Skylab,Solvent control,2,12,1306,1306,0,
Skylab,Solvent control,2,12,1317,1318,1,
Skylab,Solvent control,2,12,1329,1329,0,
Skylab,Solvent control,2,12,1347,1348,1,
Skylab,Solvent control,2,12,1419,1419,0,
Skylab,Solvent control,2,12,1523,1524,1,
Skylab,Solvent control,2,12,1523,1524,1,
Skylab,Solvent control,2,12,1532,1533,1,
Skylab,Solvent control,2,12,1534,1536,2,
Skylab,Solvent control,2,12,1554,1554,0,
Skylab,Solvent control,2,12,1602,1602,0,
Skylab,Solvent control,2,12,1608,1609,1,
Skylab,Solvent control,2,12,1657,1657,0,
Skylab,Solvent control,2,12,1689,1691,2,
Skylab,Solvent control,2,12,1694,1696,2,
Skylab,Solvent control,2,12,1698,1699,1,
Skylab,Solvent control,2,12,1751,1752,1,
Skylab,Solvent control,2,12,1759,1759,0,
Skylab,Solvent control,2,12,1765,1766,1,
Skylab,Solvent control,2,12,1771,1772,1,
Skylab,Solvent control,3,12,24,25,1,
Skylab,Solvent control,3,12,44,44,0,
Skylab,Solvent control,3,12,55,60,5,
Skylab,Solvent control,3,12,75,76,1,
Skylab,Solvent control,3,12,167,168,1,
Skylab,Solvent control,3,12,189,191,2,
Skylab,Solvent control,3,12,210,211,1,
Skylab,Solvent control,3,12,215,217,2,
Skylab,Solvent control,3,12,249,250,1,
Skylab,Solvent control,3,12,254,254,0,
Skylab,Solvent control,3,12,259,259,0,
Skylab,Solvent control,3,12,261,262,1,
Skylab,Solvent control,3,12,287,295,8,
Skylab,Solvent control,3,12,360,360,0,
Skylab,Solvent control,3,12,388,388,0,
Skylab,Solvent control,3,12,389,389,0,
Skylab,Solvent control,3,12,413,413,0,
Skylab,Solvent control,3,12,451,452,1,
Skylab,Solvent control,3,12,452,453,1,
Skylab,Solvent control,3,12,478,478,0,
Skylab,Solvent control,3,12,485,487,2,
Skylab,Solvent control,3,12,507,507,0,
Skylab,Solvent control,3,12,531,534,3,
Skylab,Solvent control,3,12,599,600,1,
Skylab,Solvent control,3,12,613,613,0,
Skylab,Solvent control,3,12,620,621,1,
Skylab,Solvent control,3,12,626,626,0,
Skylab,Solvent control,3,12,637,638,1,
Skylab,Solvent control,3,12,634,658,24,
Skylab,Solvent control,3,12,647,647,0,
Skylab,Solvent control,3,12,678,679,1,
Skylab,Solvent control,3,12,685,686,1,
Skylab,Solvent control,3,12,700,701,1,
Skylab,Solvent control,3,12,710,722,12,
Skylab,Solvent control,3,12,727,728,1,
Skylab,Solvent control,3,12,831,833,2,
Skylab,Solvent control,3,12,857,858,1,
Skylab,Solvent control,3,12,878,878,0,
Skylab,Solvent control,3,12,890,891,1,
Skylab,Solvent control,3,12,907,908,1,
Skylab,Solvent control,3,12,912,912,0,
Skylab,Solvent control,3,12,965,965,0,
Skylab,Solvent control,3,12,974,975,1,
Skylab,Solvent control,3,12,995,995,0,
Skylab,Solvent control,3,12,996,998,2,
Skylab,Solvent control,3,12,1023,1025,2,
Skylab,Solvent control,3,12,1029,1029,0,
Skylab,Solvent control,3,12,1035,1036,1,
Skylab,Solvent control,3,12,1056,1057,1,
Skylab,Solvent control,3,12,1063,1064,1,
Skylab,Solvent control,3,12,1079,1085,6,
Skylab,Solvent control,3,12,1123,1124,1,
Skylab,Solvent control,3,12,1129,1129,0,
Skylab,Solvent control,3,12,1162,1167,5,
Skylab,Solvent control,3,12,1244,1248,4,
Skylab,Solvent control,3,12,1261,1261,0,
Skylab,Solvent control,3,12,1268,1268,0,
Skylab,Solvent control,3,12,1298,1298,0,
Skylab,Solvent control,3,12,1359,1359,0,
Skylab,Solvent control,3,12,1398,1398,0,
Skylab,Solvent control,3,12,1408,1410,2,
Skylab,Solvent control,3,12,1413,1414,1,
Skylab,Solvent control,3,12,1415,1416,1,
Skylab,Solvent control,3,12,1456,1458,2,
Skylab,Solvent control,3,12,1471,1471,0,
Skylab,Solvent control,3,12,1518,1518,0,
Skylab,Solvent control,3,12,1529,1533,4,
Skylab,Solvent control,3,12,1536,1536,0,
Skylab,Solvent control,3,12,1537,1537,0,
Skylab,Solvent control,3,12,1553,1553,0,
Skylab,Solvent control,3,12,1565,1565,0,
Skylab,Solvent control,3,12,1598,1600,2,
Skylab,Solvent control,3,12,1613,1614,1,
Skylab,Solvent control,3,12,1638,1638,0,
Skylab,Solvent control,3,12,1696,1696,0,
Skylab,Solvent control,3,12,1720,1720,0,
Skylab,Solvent control,3,12,1759,1759,0,
Skylab,Solvent control,3,12,1770,1770,0,
Skylab,Solvent control,3,12,1789,1791,2,
Skylab,Solvent control,10,12,87,88,1,
Skylab,Solvent control,10,12,138,138,0,
Skylab,Solvent control,10,12,148,148,0,
Skylab,Solvent control,10,12,263,264,1,
Skylab,Solvent control,10,12,308,314,6,
Skylab,Solvent control,10,12,316,320,4,
Skylab,Solvent control,10,12,387,387,0,
Skylab,Solvent control,10,12,409,409,0,
Skylab,Solvent control,10,12,412,414,2,
Skylab,Solvent control,10,12,425,426,1,
Skylab,Solvent control,10,12,527,528,1,
Skylab,Solvent control,10,12,578,578,0,
Skylab,Solvent control,10,12,622,623,1,
Skylab,Solvent control,10,12,625,625,0,
Skylab,Solvent control,10,12,633,634,1,
Skylab,Solvent control,10,12,704,704,0,
Skylab,Solvent control,10,12,766,767,1,
Skylab,Solvent control,10,12,941,943,2,
Skylab,Solvent control,10,12,976,978,2,
Skylab,Solvent control,10,12,979,980,1,
Skylab,Solvent control,10,12,993,996,3,
Skylab,Solvent control,10,12,1012,1013,1,
Skylab,Solvent control,10,12,1021,1024,3,not really touching but seems interrested
Skylab,Solvent control,10,12,1094,1096,2,
Skylab,Solvent control,10,12,1147,1147,0,
Skylab,Solvent control,10,12,1218,1223,5,
Skylab,Solvent control,10,12,1225,1226,1,
Skylab,Solvent control,10,12,1294,1294,0,
Skylab,Solvent control,10,12,1322,1323,1,
Skylab,Solvent control,10,12,1348,1348,0,
Skylab,Solvent control,10,12,1348,1348,0,
Skylab,Solvent control,10,12,1425,1425,0,
Skylab,Solvent control,10,12,1580,1581,1,
Skylab,Solvent control,10,12,1620,1620,0,
Skylab,Solvent control,10,12,1648,1654,6,
Skylab,Solvent control,10,12,1660,1662,2,
Skylab,Solvent control,10,12,1687,1687,0,maybe touch - seems to run in to paper as it turns around
Skylab,Solvent control,10,12,1732,1732,0,
Skylab,Solvent control,12,1,9,9,0,
Skylab,Solvent control,12,1,130,132,2,
Skylab,Solvent control,12,1,139,139,0,
Skylab,Solvent control,12,1,168,168,0,
Skylab,Solvent control,12,1,220,226,6,
Skylab,Solvent control,12,1,266,269,3,
Skylab,Solvent control,12,1,304,306,2,
Skylab,Solvent control,12,1,369,370,1,
Skylab,Solvent control,12,1,495,495,0,
Skylab,Solvent control,12,1,567,567,0,
Skylab,Solvent control,12,1,770,771,1,
Skylab,Solvent control,12,1,963,976,13,
Skylab,Solvent control,12,1,994,994,0,
Skylab,Solvent control,12,1,1093,1095,2,
Skylab,Solvent control,12,1,1106,1106,0,
Skylab,Solvent control,12,1,1124,1126,2,
Skylab,Solvent control,12,1,1191,1192,1,
Skylab,Solvent control,12,1,1320,1320,0,
Skylab,Solvent control,12,1,1342,1344,2,
Skylab,Solvent control,12,1,1350,1350,0,
Skylab,Solvent control,12,1,1479,1479,0,
Skylab,Solvent control,12,1,1494,1494,0,
Skylab,Solvent control,12,1,1544,1547,3,
Skylab,Solvent control,12,1,1547,1547,0,
Skylab,Solvent control,12,1,1558,1559,1,
Skylab,Solvent control,12,1,1620,1620,0,
Skylab,Solvent control,12,1,1635,1659,24,"bee a little far from paper, pretty sure it isn's siffing, mostly still"
Skylab,Solvent control,12,1,1658,1659,1,
Skylab,Solvent control,12,1,1663,1666,3,"bee a little far from paper but seems a bit interrested, mostly still"
Skylab,Solvent control,12,1,1688,1688,0,
Skylab,Solvent control,12,1,1694,1695,1,
Skylab,Solvent control,13,12,1765,1765,0,
Skylab,Solvent control,13,12,10,11,1,
Skylab,Solvent control,13,12,13,13,0,
Skylab,Solvent control,13,12,87,90,3,
Skylab,Solvent control,13,12,111,113,2,sniff from afar
Skylab,Solvent control,13,12,236,237,1,
Skylab,Solvent control,13,12,281,281,0,
Skylab,Solvent control,13,12,315,315,0,
Skylab,Solvent control,13,12,335,337,2,
Skylab,Solvent control,13,12,427,428,1,
Skylab,Solvent control,13,12,526,548,22,
Skylab,Solvent control,13,12,529,529,0,
Skylab,Solvent control,13,12,590,590,0,
Skylab,Solvent control,13,12,618,618,0,
Skylab,Solvent control,13,12,650,650,0,
Skylab,Solvent control,13,12,664,665,1,
Skylab,Solvent control,13,12,835,835,0,
Skylab,Solvent control,13,12,953,955,2,
Skylab,Solvent control,13,12,1035,1045,10,bee still next to paper
Skylab,Solvent control,13,12,1070,1070,0,
Skylab,Solvent control,13,12,1159,1162,3,
Skylab,Solvent control,13,12,1167,1168,1,
Skylab,Solvent control,13,12,1248,1252,4,
Skylab,Solvent control,13,12,1253,1255,2,
Skylab,Solvent control,13,12,1376,1377,1,
Skylab,Solvent control,13,12,1391,1393,2,
Skylab,Solvent control,13,12,1474,1476,2,
Skylab,Solvent control,13,12,1472,1538,66,"bee sitting still a little distance from the paper, facing it. Not sure if it counts. It also gets pushed a little further from the paper but remains facing it until 30:00"
Skylab,Solvent control,13,12,1562,1564,2,
Skylab,Solvent control,13,12,1575,1800,225,bee sits still next to paper not quite facing it
Skylab,Solvent control,13,12,1035,1142,107,"bee sitting still near paper, facing it"
Skylab,Solvent control,15,2,106,106,0,kinda seems like it just bumps in to the paper
Skylab,Solvent control,15,2,188,189,1,
Skylab,Solvent control,15,2,198,206,8,
Skylab,Solvent control,15,2,298,299,1,
Skylab,Solvent control,15,2,325,325,0,
Skylab,Solvent control,15,2,498,501,3,
Skylab,Solvent control,15,2,499,506,7,
Skylab,Solvent control,15,2,515,518,3,
Skylab,Solvent control,15,2,532,533,1,
Skylab,Solvent control,15,2,619,623,4,
Skylab,Solvent control,15,2,651,656,5,
Skylab,Solvent control,15,2,678,680,2,
Skylab,Solvent control,15,2,788,788,0,
Skylab,Solvent control,15,2,871,874,3,
Skylab,Solvent control,15,2,885,899,14,
Skylab,Solvent control,15,2,903,909,6,
Skylab,Solvent control,15,2,918,918,0,
Skylab,Solvent control,15,2,933,935,2,
Skylab,Solvent control,15,2,957,961,4,
Skylab,Solvent control,15,2,992,992,0,
Skylab,Solvent control,15,2,1003,1005,2,
Skylab,Solvent control,15,2,1073,1074,1,
Skylab,Solvent control,15,2,1081,1081,0,
Skylab,Solvent control,15,2,1262,1262,0,not sure if it counts sideways touch
Skylab,Solvent control,15,2,1367,1367,0,
Skylab,Solvent control,15,2,1387,1389,2,
Skylab,Solvent control,15,2,1462,1463,1,
Skylab,Solvent control,15,2,1588,1588,0,
Skylab,Solvent control,15,2,1597,1599,2,
Skylab,Solvent control,15,2,1633,1637,4,
Skylab,Solvent control,15,2,1649,1800,151,bee sits really close to the paper but not quite facing it - don't really think it counts
Skylab,Solvent control,16,8,2,5,3,
Skylab,Solvent control,16,8,13,14,1,
Skylab,Solvent control,16,8,14,17,3,
Skylab,Solvent control,16,8,116,117,1,not sure it counts - bee doesn't touch paper but seems interested
Skylab,Solvent control,16,8,131,131,0,
Skylab,Solvent control,16,8,135,139,4,
Skylab,Solvent control,16,8,321,321,0,
Skylab,Solvent control,16,8,503,505,2,
Skylab,Solvent control,16,8,540,549,9,
Skylab,Solvent control,16,8,552,556,4,
Skylab,Solvent control,16,8,586,590,4,
Skylab,Solvent control,16,8,674,677,3,
Skylab,Solvent control,16,8,689,690,1,
Skylab,Solvent control,16,8,715,716,1,
Skylab,Solvent control,16,8,816,816,0,
Skylab,Solvent control,16,8,838,843,5,
Skylab,Solvent control,16,8,939,943,4,
Skylab,Solvent control,16,8,1078,1078,0,
Skylab,Solvent control,16,8,1138,1139,1,
Skylab,Solvent control,16,8,1359,1360,1,
Skylab,Solvent control,16,8,1397,1398,1,
Skylab,Solvent control,16,8,1416,1417,1,
Skylab,Solvent control,16,8,1550,1551,1,
Skylab,Solvent control,16,8,1783,1784,1,
Skylab,Solvent control,17,4,24,25,1,
Skylab,Solvent control,17,4,50,50,0,
Skylab,Solvent control,17,4,93,93,0,
Skylab,Solvent control,17,4,137,137,0,
Skylab,Solvent control,17,4,160,160,0,
Skylab,Solvent control,17,4,163,163,0,
Skylab,Solvent control,17,4,234,234,0,
Skylab,Solvent control,17,4,275,275,0,
Skylab,Solvent control,17,4,304,306,2,
Skylab,Solvent control,17,4,320,320,0,
Skylab,Solvent control,17,4,356,359,3,
Skylab,Solvent control,17,4,438,438,0,
Skylab,Solvent control,17,4,487,487,0,
Skylab,Solvent control,17,4,498,498,0,
Skylab,Solvent control,17,4,519,519,0,
Skylab,Solvent control,17,4,559,560,1,
Skylab,Solvent control,17,4,622,622,0,
Skylab,Solvent control,17,4,628,628,0,
Skylab,Solvent control,17,4,653,653,0,
Skylab,Solvent control,17,4,677,677,0,
Skylab,Solvent control,17,4,689,690,1,
Skylab,Solvent control,17,4,753,753,0,
Skylab,Solvent control,17,4,818,819,1,
Skylab,Solvent control,17,4,839,840,1,
Skylab,Solvent control,17,4,891,891,0,
Skylab,Solvent control,17,4,908,908,0,
Skylab,Solvent control,17,4,922,923,1,
Skylab,Solvent control,17,4,935,937,2,
Skylab,Solvent control,17,4,941,941,0,
Skylab,Solvent control,17,4,960,961,1,bee walks over the paper's edge
Skylab,Solvent control,17,4,967,967,0,
Skylab,Solvent control,17,4,979,980,1,
Skylab,Solvent control,17,4,986,986,0,
Skylab,Solvent control,17,4,991,991,0,
Skylab,Solvent control,17,4,1021,1021,0,
Skylab,Solvent control,17,4,1027,1029,2,"bee sort of acts wird near paper, i think it's antennating"
Skylab,Solvent control,17,4,1050,1052,2,
Skylab,Solvent control,17,4,1146,1146,0,
Skylab,Solvent control,17,4,1176,1176,0,
Skylab,Solvent control,17,4,1179,1182,3,
Skylab,Solvent control,17,4,1183,1184,1,
Skylab,Solvent control,17,4,1190,1191,1,
Skylab,Solvent control,17,4,1271,1278,7,
Skylab,Solvent control,17,4,1425,1429,4,
Skylab,Solvent control,17,4,1480,1484,4,
Skylab,Solvent control,17,4,1492,1494,2,
Skylab,Solvent control,17,4,1574,1575,1,
Skylab,Solvent control,17,4,1637,1637,0,
Skylab,Solvent control,17,4,1690,1701,11,bee really close but not touching paper facing it
Skylab,10-HDA (worker control),1,11,23,23,0,
Skylab,10-HDA (worker control),1,11,32,35,3,
Skylab,10-HDA (worker control),1,11,42,42,0,
Skylab,10-HDA (worker control),1,11,44,44,0,
Skylab,10-HDA (worker control),1,11,88,89,1,
Skylab,10-HDA (worker control),1,11,90,90,0,
Skylab,10-HDA (worker control),1,11,125,125,0,
Skylab,10-HDA (worker control),1,11,126,126,0,
Skylab,10-HDA (worker control),1,11,127,127,0,
Skylab,10-HDA (worker control),1,11,195,195,0,
Skylab,10-HDA (worker control),1,11,203,203,0,
Skylab,10-HDA (worker control),1,11,230,231,1,
Skylab,10-HDA (worker control),1,11,260,262,2,
Skylab,10-HDA (worker control),1,11,305,308,3,
Skylab,10-HDA (worker control),1,11,380,381,1,
Skylab,10-HDA (worker control),1,11,392,392,0,
Skylab,10-HDA (worker control),1,11,468,468,0,
Skylab,10-HDA (worker control),1,11,519,519,0,
Skylab,10-HDA (worker control),1,11,548,549,1,
Skylab,10-HDA (worker control),1,11,561,561,0,
Skylab,10-HDA (worker control),1,11,562,569,7,
Skylab,10-HDA (worker control),1,11,645,645,0,
Skylab,10-HDA (worker control),1,11,715,715,0,
Skylab,10-HDA (worker control),1,11,728,728,0,
Skylab,10-HDA (worker control),1,11,738,738,0,
Skylab,10-HDA (worker control),1,11,744,744,0,
Skylab,10-HDA (worker control),1,11,754,754,0,
Skylab,10-HDA (worker control),1,11,785,785,0,
Skylab,10-HDA (worker control),1,11,812,813,1,
Skylab,10-HDA (worker control),1,11,867,867,0,
Skylab,10-HDA (worker control),1,11,897,899,2,
Skylab,10-HDA (worker control),1,11,913,913,0,
Skylab,10-HDA (worker control),1,11,944,944,0,
Skylab,10-HDA (worker control),1,11,1025,1027,2,
Skylab,10-HDA (worker control),1,11,1030,1032,2,
Skylab,10-HDA (worker control),1,11,1038,1039,1,
Skylab,10-HDA (worker control),1,11,1053,1059,6,
Skylab,10-HDA (worker control),1,11,1065,1065,0,
Skylab,10-HDA (worker control),1,11,1075,1075,0,
Skylab,10-HDA (worker control),1,11,1081,1081,0,
Skylab,10-HDA (worker control),1,11,1088,1089,1,
Skylab,10-HDA (worker control),1,11,1091,1095,4,
Skylab,10-HDA (worker control),1,11,1143,1143,0,
Skylab,10-HDA (worker control),1,11,1147,1156,9,
Skylab,10-HDA (worker control),1,11,1161,1161,0,
Skylab,10-HDA (worker control),1,11,1178,1180,2,
Skylab,10-HDA (worker control),1,11,1185,1194,9,
Skylab,10-HDA (worker control),1,11,1240,1242,2,
Skylab,10-HDA (worker control),1,11,1244,1245,1,
Skylab,10-HDA (worker control),1,11,1277,1278,1,
Skylab,10-HDA (worker control),1,11,1325,1326,1,
Skylab,10-HDA (worker control),1,11,1333,1334,1,
Skylab,10-HDA (worker control),1,11,1367,1367,0,
Skylab,10-HDA (worker control),1,11,1369,1373,4,
Skylab,10-HDA (worker control),1,11,1377,1381,4,
Skylab,10-HDA (worker control),1,11,1388,1389,1,
Skylab,10-HDA (worker control),1,11,1393,1398,5,
Skylab,10-HDA (worker control),1,11,1400,1401,1,
Skylab,10-HDA (worker control),1,11,1432,1435,3,
Skylab,10-HDA (worker control),1,11,1449,1449,0,
Skylab,10-HDA (worker control),1,11,1475,1475,0,
Skylab,10-HDA (worker control),1,11,1527,1528,1,
Skylab,10-HDA (worker control),1,11,1564,1564,0,
Skylab,10-HDA (worker control),1,11,1579,1580,1,
Skylab,10-HDA (worker control),1,11,1669,1673,4,
Skylab,10-HDA (worker control),1,11,1692,1694,2,
Skylab,10-HDA (worker control),1,11,1712,1712,0,
Skylab,10-HDA (worker control),1,11,1732,1732,0,
Skylab,10-HDA (worker control),1,11,1771,1780,9,
Skylab,10-HDA (worker control),2,11,23,25,2,
Skylab,10-HDA (worker control),2,11,113,114,1,
Skylab,10-HDA (worker control),2,11,121,126,5,
Skylab,10-HDA (worker control),2,11,128,129,1,
Skylab,10-HDA (worker control),2,11,133,135,2,
Skylab,10-HDA (worker control),2,11,145,146,1,
Skylab,10-HDA (worker control),2,11,205,206,1,
Skylab,10-HDA (worker control),2,11,205,206,1,
Skylab,10-HDA (worker control),2,11,213,215,2,
Skylab,10-HDA (worker control),2,11,238,238,0,
Skylab,10-HDA (worker control),2,11,312,313,1,
Skylab,10-HDA (worker control),2,11,339,340,1,
Skylab,10-HDA (worker control),2,11,373,374,1,
Skylab,10-HDA (worker control),2,11,374,374,0,
Skylab,10-HDA (worker control),2,11,411,411,0,
Skylab,10-HDA (worker control),2,11,479,480,1,
Skylab,10-HDA (worker control),2,11,516,518,2,
Skylab,10-HDA (worker control),2,11,534,534,0,
Skylab,10-HDA (worker control),2,11,556,556,0,
Skylab,10-HDA (worker control),2,11,599,600,1,
Skylab,10-HDA (worker control),2,11,665,666,1,
Skylab,10-HDA (worker control),2,11,673,674,1,
Skylab,10-HDA (worker control),2,11,678,678,0,
Skylab,10-HDA (worker control),2,11,682,684,2,
Skylab,10-HDA (worker control),2,11,709,713,4,
Skylab,10-HDA (worker control),2,11,709,710,1,
Skylab,10-HDA (worker control),2,11,720,721,1,
Skylab,10-HDA (worker control),2,11,736,736,0,
Skylab,10-HDA (worker control),2,11,742,743,1,
Skylab,10-HDA (worker control),2,11,823,824,1,
Skylab,10-HDA (worker control),2,11,861,861,0,
Skylab,10-HDA (worker control),2,11,866,873,7,
Skylab,10-HDA (worker control),2,11,958,958,0,
Skylab,10-HDA (worker control),2,11,970,971,1,
Skylab,10-HDA (worker control),2,11,971,972,1,
Skylab,10-HDA (worker control),2,11,1e3,1e3,0,
Skylab,10-HDA (worker control),2,11,1021,1021,0,
Skylab,10-HDA (worker control),2,11,1058,1058,0,
Skylab,10-HDA (worker control),2,11,1099,1100,1,
Skylab,10-HDA (worker control),2,11,1154,1154,0,
Skylab,10-HDA (worker control),2,11,1184,1185,1,
Skylab,10-HDA (worker control),2,11,1195,1196,1,
Skylab,10-HDA (worker control),2,11,1215,1215,0,
Skylab,10-HDA (worker control),2,11,1220,1221,1,
Skylab,10-HDA (worker control),2,11,1225,1225,0,
Skylab,10-HDA (worker control),2,11,1334,1335,1,
Skylab,10-HDA (worker control),2,11,1342,1342,0,
Skylab,10-HDA (worker control),2,11,1356,1356,0,
Skylab,10-HDA (worker control),2,11,1359,1359,0,
Skylab,10-HDA (worker control),2,11,1386,1386,0,
Skylab,10-HDA (worker control),2,11,1456,1457,1,
Skylab,10-HDA (worker control),2,11,1464,1465,1,
Skylab,10-HDA (worker control),2,11,1472,1473,1,
Skylab,10-HDA (worker control),2,11,1502,1503,1,
Skylab,10-HDA (worker control),2,11,1576,1577,1,
Skylab,10-HDA (worker control),2,11,1611,1614,3,
Skylab,10-HDA (worker control),2,11,1618,1621,3,
Skylab,10-HDA (worker control),2,11,1633,1633,0,
Skylab,10-HDA (worker control),2,11,1635,1636,1,
Skylab,10-HDA (worker control),2,11,1668,1668,0,
Skylab,10-HDA (worker control),2,11,1729,1729,0,
Skylab,10-HDA (worker control),2,11,1740,1743,3,
Skylab,10-HDA (worker control),2,11,1784,1788,4,
Skylab,10-HDA (worker control),3,11,7,7,0,
Skylab,10-HDA (worker control),3,11,63,63,0,
Skylab,10-HDA (worker control),3,11,133,133,0,
Skylab,10-HDA (worker control),3,11,325,325,0,
Skylab,10-HDA (worker control),3,11,351,351,0,
Skylab,10-HDA (worker control),3,11,420,423,3,
Skylab,10-HDA (worker control),3,11,431,433,2,
Skylab,10-HDA (worker control),3,11,456,457,1,
Skylab,10-HDA (worker control),3,11,485,485,0,
Skylab,10-HDA (worker control),3,11,493,493,0,
Skylab,10-HDA (worker control),3,11,563,565,2,
Skylab,10-HDA (worker control),3,11,578,578,0,
Skylab,10-HDA (worker control),3,11,801,802,1,
Skylab,10-HDA (worker control),3,11,853,853,0,
Skylab,10-HDA (worker control),3,11,868,869,1,
Skylab,10-HDA (worker control),3,11,977,978,1,
Skylab,10-HDA (worker control),3,11,1057,1060,3,
Skylab,10-HDA (worker control),3,11,1106,1136,30,
Skylab,10-HDA (worker control),3,11,1134,1134,0,
Skylab,10-HDA (worker control),3,11,1201,1217,16,
Skylab,10-HDA (worker control),3,11,1203,1204,1,
Skylab,10-HDA (worker control),3,11,1238,1238,0,
Skylab,10-HDA (worker control),3,11,1278,1278,0,
Skylab,10-HDA (worker control),3,11,1375,1375,0,
Skylab,10-HDA (worker control),3,11,1387,1391,4,
Skylab,10-HDA (worker control),3,11,1400,1400,0,
Skylab,10-HDA (worker control),3,11,1403,1403,0,
Skylab,10-HDA (worker control),3,11,1427,1427,0,
Skylab,10-HDA (worker control),3,11,1444,1444,0,
Skylab,10-HDA (worker control),3,11,1496,1497,1,
Skylab,10-HDA (worker control),3,11,1604,1605,1,
Skylab,10-HDA (worker control),3,11,1657,1658,1,
Skylab,10-HDA (worker control),3,11,1663,1664,1,
Skylab,10-HDA (worker control),3,11,1716,1716,0,
Skylab,10-HDA (worker control),3,11,1768,1768,0,
Skylab,10-HDA (worker control),10,11,76,78,2,
Skylab,10-HDA (worker control),10,11,81,84,3,
Skylab,10-HDA (worker control),10,11,90,90,0,
Skylab,10-HDA (worker control),10,11,105,106,1,
Skylab,10-HDA (worker control),10,11,131,134,3,
Skylab,10-HDA (worker control),10,11,155,155,0,
Skylab,10-HDA (worker control),10,11,194,195,1,
Skylab,10-HDA (worker control),10,11,299,300,1,
Skylab,10-HDA (worker control),10,11,306,307,1,
Skylab,10-HDA (worker control),10,11,337,341,4,
Skylab,10-HDA (worker control),10,11,379,379,0,
Skylab,10-HDA (worker control),10,11,393,394,1,
Skylab,10-HDA (worker control),10,11,396,466,70,
Skylab,10-HDA (worker control),10,11,415,416,1,
Skylab,10-HDA (worker control),10,11,427,428,1,
Skylab,10-HDA (worker control),10,11,446,446,0,
Skylab,10-HDA (worker control),10,11,471,476,5,
Skylab,10-HDA (worker control),10,11,477,478,1,
Skylab,10-HDA (worker control),10,11,480,483,3,
Skylab,10-HDA (worker control),10,11,487,494,7,
Skylab,10-HDA (worker control),10,11,522,522,0,
Skylab,10-HDA (worker control),10,11,524,524,0,
Skylab,10-HDA (worker control),10,11,532,550,18,
Skylab,10-HDA (worker control),10,11,539,541,2,
Skylab,10-HDA (worker control),10,11,565,572,7,
Skylab,10-HDA (worker control),10,11,595,597,2,
Skylab,10-HDA (worker control),10,11,611,615,4,
Skylab,10-HDA (worker control),10,11,617,620,3,
Skylab,10-HDA (worker control),10,11,636,637,1,
Skylab,10-HDA (worker control),10,11,639,640,1,
Skylab,10-HDA (worker control),10,11,642,644,2,
Skylab,10-HDA (worker control),10,11,673,674,1,
Skylab,10-HDA (worker control),10,11,677,678,1,
Skylab,10-HDA (worker control),10,11,732,732,0,
Skylab,10-HDA (worker control),10,11,734,736,2,
Skylab,10-HDA (worker control),10,11,753,753,0,
Skylab,10-HDA (worker control),10,11,847,848,1,
Skylab,10-HDA (worker control),10,11,935,937,2,
Skylab,10-HDA (worker control),10,11,950,950,0,
Skylab,10-HDA (worker control),10,11,971,972,1,
Skylab,10-HDA (worker control),10,11,1004,1004,0,
Skylab,10-HDA (worker control),10,11,1014,1014,0,
Skylab,10-HDA (worker control),10,11,1023,1023,0,
Skylab,10-HDA (worker control),10,11,1036,1036,0,
Skylab,10-HDA (worker control),10,11,1054,1055,1,
Skylab,10-HDA (worker control),10,11,1069,1069,0,
Skylab,10-HDA (worker control),10,11,1077,1079,2,
Skylab,10-HDA (worker control),10,11,1078,1080,2,
Skylab,10-HDA (worker control),10,11,1140,1140,0,
Skylab,10-HDA (worker control),10,11,1147,1149,2,
Skylab,10-HDA (worker control),10,11,1159,1161,2,
Skylab,10-HDA (worker control),10,11,1164,1165,1,
Skylab,10-HDA (worker control),10,11,1192,1193,1,
Skylab,10-HDA (worker control),10,11,1203,1204,1,
Skylab,10-HDA (worker control),10,11,1207,1210,3,
Skylab,10-HDA (worker control),10,11,1215,1217,2,
Skylab,10-HDA (worker control),10,11,1281,1281,0,maybe
Skylab,10-HDA (worker control),10,11,1284,1284,0,
Skylab,10-HDA (worker control),10,11,1287,1294,7,
Skylab,10-HDA (worker control),10,11,1319,1319,0,
Skylab,10-HDA (worker control),10,11,1423,1425,2,
Skylab,10-HDA (worker control),10,11,1441,1442,1,
Skylab,10-HDA (worker control),10,11,1559,1561,2,
Skylab,10-HDA (worker control),10,11,1580,1581,1,
Skylab,10-HDA (worker control),10,11,1620,1621,1,
Skylab,10-HDA (worker control),10,11,1657,1657,0,maybe fast side touch
Skylab,10-HDA (worker control),10,11,1681,1684,3,
Skylab,10-HDA (worker control),10,11,1788,1788,0,
Skylab,10-HDA (worker control),12,2,24,28,4,
Skylab,10-HDA (worker control),12,2,39,40,1,
Skylab,10-HDA (worker control),12,2,45,45,0,
Skylab,10-HDA (worker control),12,2,218,219,1,
Skylab,10-HDA (worker control),12,2,231,231,0,
Skylab,10-HDA (worker control),12,2,250,254,4,
Skylab,10-HDA (worker control),12,2,331,331,0,
Skylab,10-HDA (worker control),12,2,357,358,1,
Skylab,10-HDA (worker control),12,2,395,401,6,
Skylab,10-HDA (worker control),12,2,404,406,2,
Skylab,10-HDA (worker control),12,2,487,487,0,
Skylab,10-HDA (worker control),12,2,548,558,10,
Skylab,10-HDA (worker control),12,2,600,605,5,
Skylab,10-HDA (worker control),12,2,607,607,0,
Skylab,10-HDA (worker control),12,2,610,620,10,
Skylab,10-HDA (worker control),12,2,620,621,1,
Skylab,10-HDA (worker control),12,2,648,649,1,
Skylab,10-HDA (worker control),12,2,697,697,0,
Skylab,10-HDA (worker control),12,2,702,703,1,
Skylab,10-HDA (worker control),12,2,704,716,12,
Skylab,10-HDA (worker control),12,2,740,755,15,"bee definitely interrested - playing with the paper, not sure if its quite facing the paper though"
Skylab,10-HDA (worker control),12,2,761,762,1,
Skylab,10-HDA (worker control),12,2,766,770,4,
Skylab,10-HDA (worker control),12,2,779,781,2,
Skylab,10-HDA (worker control),12,2,782,784,2,
Skylab,10-HDA (worker control),12,2,785,785,0,
Skylab,10-HDA (worker control),12,2,790,802,12,"bee sort of facing paper close to it, mostly still, parallel to paper until 14:40. Close to it."
Skylab,10-HDA (worker control),12,2,871,873,2,
Skylab,10-HDA (worker control),12,2,939,949,10,"maybe, bee sits a little distance from the paper being strange whilst facing it"
Skylab,10-HDA (worker control),12,2,943,948,5,
Skylab,10-HDA (worker control),12,2,982,983,1,
Skylab,10-HDA (worker control),12,2,959,981,22,"bee facing paper close to it, mostly still"
Skylab,10-HDA (worker control),12,2,995,996,1,
Skylab,10-HDA (worker control),12,2,1008,1008,0,
Skylab,10-HDA (worker control),12,2,1011,1012,1,
Skylab,10-HDA (worker control),12,2,1036,1037,1,
Skylab,10-HDA (worker control),12,2,1056,1059,3,
Skylab,10-HDA (worker control),12,2,1066,1067,1,
Skylab,10-HDA (worker control),12,2,1092,1094,2,
Skylab,10-HDA (worker control),12,2,1097,1098,1,
Skylab,10-HDA (worker control),12,2,1119,1127,8,
Skylab,10-HDA (worker control),12,2,1126,1126,0,
Skylab,10-HDA (worker control),12,2,1130,1130,0,
Skylab,10-HDA (worker control),12,2,1148,1149,1,
Skylab,10-HDA (worker control),12,2,1154,1154,0,
Skylab,10-HDA (worker control),12,2,1162,1170,8,
Skylab,10-HDA (worker control),12,2,1179,1192,13,
Skylab,10-HDA (worker control),12,2,1184,1184,0,
Skylab,10-HDA (worker control),12,2,1212,1234,22,
Skylab,10-HDA (worker control),12,2,1259,1261,2,
Skylab,10-HDA (worker control),12,2,1272,1272,0,
Skylab,10-HDA (worker control),12,2,1323,1323,0,
Skylab,10-HDA (worker control),12,2,1359,1366,7,
Skylab,10-HDA (worker control),12,2,1409,1410,1,
Skylab,10-HDA (worker control),12,2,1448,1451,3,
Skylab,10-HDA (worker control),12,2,1454,1456,2,
Skylab,10-HDA (worker control),12,2,1472,1472,0,
Skylab,10-HDA (worker control),12,2,1490,1495,5,
Skylab,10-HDA (worker control),12,2,1513,1513,0,
Skylab,10-HDA (worker control),12,2,1548,1549,1,
Skylab,10-HDA (worker control),12,2,1559,1559,0,
Skylab,10-HDA (worker control),12,2,1624,1625,1,
Skylab,10-HDA (worker control),12,2,1678,1678,0,
Skylab,10-HDA (worker control),12,2,1729,1729,0,
Skylab,10-HDA (worker control),12,2,1758,1761,3,
Skylab,10-HDA (worker control),12,2,1773,1775,2,bee sort of sniffing as it walks towards paper. never touches
Skylab,10-HDA (worker control),13,8,7,7,0,
Skylab,10-HDA (worker control),13,8,16,16,0,
Skylab,10-HDA (worker control),13,8,52,52,0,
Skylab,10-HDA (worker control),13,8,84,85,1,
Skylab,10-HDA (worker control),13,8,95,97,2,
Skylab,10-HDA (worker control),13,8,227,232,5,maybe - not actually touching but it walks up and sems to be sniffing
Skylab,10-HDA (worker control),13,8,581,588,7,
Skylab,10-HDA (worker control),13,8,708,710,2,bee not touching it just seems very interrested
Skylab,10-HDA (worker control),13,8,713,715,2,same bee as entry above not touching it just seems very interrested
Skylab,10-HDA (worker control),13,8,738,738,0,
Skylab,10-HDA (worker control),13,8,912,914,2,
Skylab,10-HDA (worker control),13,8,1082,1082,0,
Skylab,10-HDA (worker control),13,8,1130,1131,1,
Skylab,10-HDA (worker control),13,8,1193,1195,2,
Skylab,10-HDA (worker control),13,8,1609,1622,13,
Skylab,10-HDA (worker control),13,8,1627,1630,3,
Skylab,10-HDA (worker control),13,8,1649,1649,0,maybe - not actually touching but it walks up and sems to be sniffing
Skylab,10-HDA (worker control),13,8,1650,1651,1,maybe - not actually touching but it walks up and sems to be sniffing
Skylab,10-HDA (worker control),13,8,1657,1657,0,
Skylab,10-HDA (worker control),13,8,1710,1710,0,
Skylab,10-HDA (worker control),13,8,1727,1729,2,
Skylab,10-HDA (worker control),13,8,1736,1800,64,
Skylab,10-HDA (worker control),15,3,31,31,0,
Skylab,10-HDA (worker control),15,3,35,36,1,
Skylab,10-HDA (worker control),15,3,36,38,2,
Skylab,10-HDA (worker control),15,3,43,45,2,
Skylab,10-HDA (worker control),15,3,106,107,1,
Skylab,10-HDA (worker control),15,3,142,142,0,
Skylab,10-HDA (worker control),15,3,149,150,1,
Skylab,10-HDA (worker control),15,3,192,193,1,
Skylab,10-HDA (worker control),15,3,203,203,0,
Skylab,10-HDA (worker control),15,3,214,214,0,
Skylab,10-HDA (worker control),15,3,224,224,0,not entirely sure if it counts it seems to bump in to the paper
Skylab,10-HDA (worker control),15,3,228,229,1,
Skylab,10-HDA (worker control),15,3,266,266,0,
Skylab,10-HDA (worker control),15,3,304,304,0,
Skylab,10-HDA (worker control),15,3,321,321,0,
Skylab,10-HDA (worker control),15,3,351,352,1,
Skylab,10-HDA (worker control),15,3,383,387,4,
Skylab,10-HDA (worker control),15,3,393,396,3,
Skylab,10-HDA (worker control),15,3,479,483,4,
Skylab,10-HDA (worker control),15,3,482,483,1,
Skylab,10-HDA (worker control),15,3,706,709,3,
Skylab,10-HDA (worker control),15,3,719,719,0,
Skylab,10-HDA (worker control),15,3,839,839,0,
Skylab,10-HDA (worker control),15,3,867,868,1,
Skylab,10-HDA (worker control),15,3,891,892,1,
Skylab,10-HDA (worker control),15,3,909,909,0,not entirely sure if it counts it seems to bump in to the paper
Skylab,10-HDA (worker control),15,3,922,922,0,
Skylab,10-HDA (worker control),15,3,983,984,1,
Skylab,10-HDA (worker control),15,3,995,995,0,
Skylab,10-HDA (worker control),15,3,1060,1069,9,
Skylab,10-HDA (worker control),15,3,1071,1073,2,
Skylab,10-HDA (worker control),15,3,1085,1088,3,
Skylab,10-HDA (worker control),15,3,1105,1106,1,
Skylab,10-HDA (worker control),15,3,1122,1125,3,
Skylab,10-HDA (worker control),15,3,1216,1219,3,
Skylab,10-HDA (worker control),15,3,1225,1226,1,
Skylab,10-HDA (worker control),15,3,1238,1238,0,
Skylab,10-HDA (worker control),15,3,1246,1246,0,
Skylab,10-HDA (worker control),15,3,1250,1250,0,
Skylab,10-HDA (worker control),15,3,1272,1273,1,
Skylab,10-HDA (worker control),15,3,1289,1289,0,
Skylab,10-HDA (worker control),15,3,1298,1304,6,
Skylab,10-HDA (worker control),15,3,1324,1325,1,
Skylab,10-HDA (worker control),15,3,1341,1341,0,
Skylab,10-HDA (worker control),15,3,1371,1373,2,
Skylab,10-HDA (worker control),15,3,1401,1401,0,
Skylab,10-HDA (worker control),15,3,1524,1531,7,
Skylab,10-HDA (worker control),15,3,1535,1535,0,not entirely sure if it counts it seems to bump in to the paper
Skylab,10-HDA (worker control),15,3,1556,1556,0,
Skylab,10-HDA (worker control),15,3,1561,1563,2,
Skylab,10-HDA (worker control),15,3,1590,1590,0,
Skylab,10-HDA (worker control),15,3,1599,1599,0,
Skylab,10-HDA (worker control),15,3,1639,1640,1,
Skylab,10-HDA (worker control),15,3,1642,1646,4,
Skylab,10-HDA (worker control),15,3,1687,1690,3,
Skylab,10-HDA (worker control),15,3,1696,1697,1,
Skylab,10-HDA (worker control),15,3,1703,1704,1,
Skylab,10-HDA (worker control),15,3,1790,1790,0,
Skylab,10-HDA (worker control),16,7,12,12,0,
Skylab,10-HDA (worker control),16,7,30,31,1,
Skylab,10-HDA (worker control),16,7,89,89,0,
Skylab,10-HDA (worker control),16,7,94,94,0,
Skylab,10-HDA (worker control),16,7,187,190,3,
Skylab,10-HDA (worker control),16,7,218,219,1,
Skylab,10-HDA (worker control),16,7,231,236,5,
Skylab,10-HDA (worker control),16,7,280,281,1,
Skylab,10-HDA (worker control),16,7,314,314,0,
Skylab,10-HDA (worker control),16,7,321,322,1,
Skylab,10-HDA (worker control),16,7,410,413,3,
Skylab,10-HDA (worker control),16,7,412,417,5,
Skylab,10-HDA (worker control),16,7,481,481,0,
Skylab,10-HDA (worker control),16,7,623,625,2,
Skylab,10-HDA (worker control),16,7,650,651,1,
Skylab,10-HDA (worker control),16,7,656,656,0,
Skylab,10-HDA (worker control),16,7,672,673,1,
Skylab,10-HDA (worker control),16,7,735,737,2,
Skylab,10-HDA (worker control),16,7,759,760,1,
Skylab,10-HDA (worker control),16,7,766,766,0,
Skylab,10-HDA (worker control),16,7,885,886,1,
Skylab,10-HDA (worker control),16,7,1004,1004,0,
Skylab,10-HDA (worker control),16,7,1019,1021,2,
Skylab,10-HDA (worker control),16,7,1043,1045,2,
Skylab,10-HDA (worker control),16,7,1078,1082,4,
Skylab,10-HDA (worker control),16,7,1080,1082,2,
Skylab,10-HDA (worker control),16,7,1100,1101,1,
Skylab,10-HDA (worker control),16,7,1114,1116,2,
Skylab,10-HDA (worker control),16,7,1172,1175,3,
Skylab,10-HDA (worker control),16,7,1180,1182,2,
Skylab,10-HDA (worker control),16,7,1267,1267,0,
Skylab,10-HDA (worker control),16,7,1288,1288,0,
Skylab,10-HDA (worker control),16,7,1527,1531,4,
Skylab,10-HDA (worker control),16,7,1533,1533,0,
Skylab,10-HDA (worker control),16,7,1555,1558,3,
Skylab,10-HDA (worker control),16,7,1596,1597,1,
Skylab,10-HDA (worker control),16,7,1648,1648,0,
Skylab,10-HDA (worker control),16,7,1662,1662,0,
Skylab,10-HDA (worker control),16,7,1711,1713,2,
Skylab,10-HDA (worker control),16,7,1716,1716,0,
Skylab,10-HDA (worker control),16,7,1729,1730,1,
Skylab,10-HDA (worker control),17,9,2,2,0,
Skylab,10-HDA (worker control),17,9,37,37,0,
Skylab,10-HDA (worker control),17,9,45,45,0,
Skylab,10-HDA (worker control),17,9,98,99,1,
Skylab,10-HDA (worker control),17,9,137,137,0,
Skylab,10-HDA (worker control),17,9,190,190,0,"not super super sure, very light touch, very fast"
Skylab,10-HDA (worker control),17,9,211,212,1,
Skylab,10-HDA (worker control),17,9,224,224,0,
Skylab,10-HDA (worker control),17,9,261,261,0,
Skylab,10-HDA (worker control),17,9,265,267,2,
Skylab,10-HDA (worker control),17,9,275,286,11,
Skylab,10-HDA (worker control),17,9,290,290,0,
Skylab,10-HDA (worker control),17,9,309,309,0,
Skylab,10-HDA (worker control),17,9,314,314,0,
Skylab,10-HDA (worker control),17,9,334,336,2,
Skylab,10-HDA (worker control),17,9,366,366,0,"not sure, doesnt seem to stop"
Skylab,10-HDA (worker control),17,9,394,395,1,
Skylab,10-HDA (worker control),17,9,437,438,1,
Skylab,10-HDA (worker control),17,9,467,467,0,
Skylab,10-HDA (worker control),17,9,517,517,0,
Skylab,10-HDA (worker control),17,9,536,537,1,
Skylab,10-HDA (worker control),17,9,576,576,0,
Skylab,10-HDA (worker control),17,9,664,665,1,
Skylab,10-HDA (worker control),17,9,673,674,1,
Skylab,10-HDA (worker control),17,9,687,689,2,
Skylab,10-HDA (worker control),17,9,700,700,0,
Skylab,10-HDA (worker control),17,9,711,711,0,
Skylab,10-HDA (worker control),17,9,716,716,0,
Skylab,10-HDA (worker control),17,9,718,718,0,
Skylab,10-HDA (worker control),17,9,723,724,1,
Skylab,10-HDA (worker control),17,9,742,742,0,
Skylab,10-HDA (worker control),17,9,918,918,0,
Skylab,10-HDA (worker control),17,9,1060,1061,1,
Skylab,10-HDA (worker control),17,9,1104,1104,0,
Skylab,10-HDA (worker control),17,9,1139,1139,0,"bee sort of bumps in to paper, seems purposeful"
Skylab,10-HDA (worker control),17,9,1174,1177,3,
Skylab,10-HDA (worker control),17,9,1229,1230,1,
Skylab,10-HDA (worker control),17,9,1243,1243,0,
Skylab,10-HDA (worker control),17,9,1281,1282,1,
Skylab,10-HDA (worker control),17,9,1372,1372,0,
Skylab,10-HDA (worker control),17,9,1380,1384,4,
Skylab,10-HDA (worker control),17,9,1401,1402,1,
Skylab,10-HDA (worker control),17,9,1434,1435,1,
Skylab,10-HDA (worker control),17,9,1507,1508,1,
Skylab,10-HDA (worker control),17,9,1515,1525,10,
Skylab,10-HDA (worker control),17,9,1560,1561,1,
Skylab,10-HDA (worker control),17,9,1575,1575,0,"maybe a touch, bee a bit far from paper"
Skylab,10-HDA (worker control),17,9,1579,1579,0,
Skylab,10-HDA (worker control),17,9,1593,1593,0,
Skylab,10-HDA (worker control),17,9,1627,1627,0,
Skylab,10-HDA (worker control),17,9,1634,1636,2,
Skylab,10-HDA (worker control),17,9,1676,1676,0,
Skylab,10-HDA (worker control),17,9,1687,1688,1,
Skylab,10-HDA (worker control),17,9,1772,1772,0,"maybe a touch, bee a bit far from paper"
Skylab,HOB,1,10,100,101,1,
Skylab,HOB,1,10,119,119,0,
Skylab,HOB,1,10,128,134,6,bee sort of walks over bee
Skylab,HOB,1,10,1429,1436,7,
Skylab,HOB,1,10,1476,1476,0,
Skylab,HOB,2,10,12,17,5,
Skylab,HOB,2,10,41,41,0,
Skylab,HOB,2,10,95,96,1,
Skylab,HOB,2,10,123,123,0,
Skylab,HOB,2,10,181,182,1,
Skylab,HOB,2,10,183,184,1,
Skylab,HOB,2,10,202,205,3,
Skylab,HOB,2,10,266,267,1,
Skylab,HOB,2,10,277,278,1,
Skylab,HOB,2,10,306,307,1,
Skylab,HOB,2,10,307,312,5,
Skylab,HOB,2,10,326,326,0,
Skylab,HOB,2,10,411,411,0,
Skylab,HOB,2,10,530,531,1,
Skylab,HOB,2,10,554,554,0,
Skylab,HOB,2,10,564,564,0,
Skylab,HOB,2,10,610,610,0,
Skylab,HOB,2,10,612,613,1,
Skylab,HOB,2,10,633,633,0,
Skylab,HOB,2,10,643,643,0,
Skylab,HOB,2,10,649,651,2,
Skylab,HOB,2,10,656,656,0,
Skylab,HOB,2,10,724,724,0,
Skylab,HOB,2,10,755,755,0,
Skylab,HOB,2,10,775,776,1,
Skylab,HOB,2,10,784,784,0,
Skylab,HOB,2,10,804,804,0,
Skylab,HOB,2,10,835,840,5,
Skylab,HOB,2,10,844,844,0,
Skylab,HOB,2,10,846,846,0,
Skylab,HOB,2,10,870,871,1,
Skylab,HOB,2,10,872,872,0,
Skylab,HOB,2,10,897,901,4,
Skylab,HOB,2,10,902,904,2,
Skylab,HOB,2,10,955,955,0,
Skylab,HOB,2,10,986,986,0,
Skylab,HOB,2,10,996,996,0,
Skylab,HOB,2,10,1003,1003,0,
Skylab,HOB,2,10,1037,1037,0,
Skylab,HOB,2,10,1080,1080,0,
Skylab,HOB,2,10,1090,1090,0,
Skylab,HOB,2,10,1103,1103,0,
Skylab,HOB,2,10,1107,1107,0,
Skylab,HOB,2,10,1128,1128,0,
Skylab,HOB,2,10,1195,1198,3,
Skylab,HOB,2,10,1226,1226,0,
Skylab,HOB,2,10,1236,1237,1,
Skylab,HOB,2,10,1247,1247,0,
Skylab,HOB,2,10,1309,1310,1,
Skylab,HOB,2,10,1326,1329,3,
Skylab,HOB,2,10,1325,1326,1,
Skylab,HOB,2,10,1348,1348,0,
Skylab,HOB,2,10,1377,1377,0,
Skylab,HOB,2,10,1357,1358,1,
Skylab,HOB,2,10,1423,1425,2,
Skylab,HOB,2,10,1438,1438,0,
Skylab,HOB,2,10,1435,1435,0,
Skylab,HOB,2,10,1440,1440,0,
Skylab,HOB,2,10,1462,1464,2,
Skylab,HOB,2,10,1525,1525,0,
Skylab,HOB,2,10,1544,1544,0,
Skylab,HOB,2,10,1553,1553,0,
Skylab,HOB,2,10,1579,1580,1,
Skylab,HOB,2,10,1579,1580,1,
Skylab,HOB,2,10,1588,1588,0,
Skylab,HOB,2,10,1594,1600,6,
Skylab,HOB,2,10,1607,1608,1,
Skylab,HOB,2,10,1617,1620,3,
Skylab,HOB,2,10,1791,1791,0,
Skylab,HOB,3,10,285,287,2,
Skylab,HOB,3,10,293,294,1,
Skylab,HOB,3,10,304,305,1,
Skylab,HOB,3,10,313,313,0,
Skylab,HOB,3,10,438,438,0,
Skylab,HOB,3,10,499,499,0,
Skylab,HOB,3,10,590,590,0,
Skylab,HOB,3,10,594,595,1,
Skylab,HOB,3,10,605,605,0,
Skylab,HOB,3,10,671,674,3,
Skylab,HOB,3,10,719,728,9,
Skylab,HOB,3,10,728,728,0,
Skylab,HOB,3,10,832,832,0,
Skylab,HOB,3,10,865,869,4,
Skylab,HOB,3,10,879,899,20,
Skylab,HOB,3,10,911,913,2,
Skylab,HOB,3,10,919,927,8,
Skylab,HOB,3,10,1099,1104,5,
Skylab,HOB,3,10,1139,1141,2,
Skylab,HOB,3,10,1269,1269,0,
Skylab,HOB,3,10,1283,1283,0,
Skylab,HOB,3,10,1354,1355,1,
Skylab,HOB,3,10,1374,1375,1,
Skylab,HOB,3,10,1384,1386,2,
Skylab,HOB,3,10,1452,1453,1,
Skylab,HOB,3,10,1478,1478,0,
Skylab,HOB,3,10,1535,1544,9,
Skylab,HOB,3,10,1606,1608,2,
Skylab,HOB,10,10,33,35,2,
Skylab,HOB,10,10,47,50,3,
Skylab,HOB,10,10,59,62,3,
Skylab,HOB,10,10,65,72,7,
Skylab,HOB,10,10,151,151,0,
Skylab,HOB,10,10,152,152,0,
Skylab,HOB,10,10,161,162,1,
Skylab,HOB,10,10,264,267,3,
Skylab,HOB,10,10,331,331,0,
Skylab,HOB,10,10,336,343,7,
Skylab,HOB,10,10,366,371,5,
Skylab,HOB,10,10,394,394,0,
Skylab,HOB,10,10,402,404,2,
Skylab,HOB,10,10,481,488,7,
Skylab,HOB,10,10,499,505,6,
Skylab,HOB,10,10,509,509,0,
Skylab,HOB,10,10,530,532,2,
Skylab,HOB,10,10,542,544,2,
Skylab,HOB,10,10,547,548,1,
Skylab,HOB,10,10,629,629,0,
Skylab,HOB,10,10,663,663,0,
Skylab,HOB,10,10,779,780,1,
Skylab,HOB,10,10,797,797,0,
Skylab,HOB,10,10,840,845,5,
Skylab,HOB,10,10,885,888,3,
Skylab,HOB,10,10,902,902,0,
Skylab,HOB,10,10,926,928,2,
Skylab,HOB,10,10,957,957,0,
Skylab,HOB,10,10,996,1e3,4,
Skylab,HOB,10,10,1017,1017,0,
Skylab,HOB,10,10,1084,1084,0,
Skylab,HOB,10,10,1085,1085,0,
Skylab,HOB,10,10,1102,1102,0,
Skylab,HOB,10,10,1109,1117,8,
Skylab,HOB,10,10,1117,1119,2,
Skylab,HOB,10,10,1120,1139,19,bee sitting on top of paper for some of this time
Skylab,HOB,10,10,1166,1166,0,
Skylab,HOB,10,10,1260,1262,2,
Skylab,HOB,10,10,1291,1292,1,
Skylab,HOB,10,10,1355,1357,2,
Skylab,HOB,10,10,1442,1447,5,
Skylab,HOB,10,10,1539,1539,0,
Skylab,HOB,10,10,1727,1727,0,
Skylab,HOB,12,3,60,60,0,
Skylab,HOB,12,3,92,92,0,
Skylab,HOB,12,3,134,134,0,
Skylab,HOB,12,3,165,165,0,
Skylab,HOB,12,3,230,230,0,
Skylab,HOB,12,3,264,264,0,
Skylab,HOB,12,3,291,291,0,
Skylab,HOB,12,3,307,314,7,
Skylab,HOB,12,3,311,311,0,
Skylab,HOB,12,3,381,381,0,
Skylab,HOB,12,3,478,479,1,
Skylab,HOB,12,3,505,507,2,
Skylab,HOB,12,3,524,524,0,
Skylab,HOB,12,3,567,567,0,
Skylab,HOB,12,3,589,590,1,
Skylab,HOB,12,3,591,593,2,
Skylab,HOB,12,3,649,649,0,
Skylab,HOB,12,3,681,681,0,
Skylab,HOB,12,3,752,752,0,
Skylab,HOB,12,3,761,761,0,
Skylab,HOB,12,3,802,802,0,
Skylab,HOB,12,3,816,817,1,
Skylab,HOB,12,3,860,863,3,
Skylab,HOB,12,3,999,1002,3,
Skylab,HOB,12,3,1077,1077,0,
Skylab,HOB,12,3,1079,1084,5,
Skylab,HOB,12,3,1201,1201,0,
Skylab,HOB,12,3,1207,1207,0,
Skylab,HOB,12,3,1244,1244,0,
Skylab,HOB,12,3,1250,1250,0,
Skylab,HOB,12,3,1263,1263,0,
Skylab,HOB,12,3,1302,1305,3,
Skylab,HOB,12,3,1497,1497,0,
Skylab,HOB,12,3,1512,1513,1,
Skylab,HOB,12,3,1515,1516,1,
Skylab,HOB,12,3,1528,1528,0,
Skylab,HOB,12,3,1648,1652,4,
Skylab,HOB,12,3,1693,1705,12,
Skylab,HOB,13,4,47,48,1,
Skylab,HOB,13,4,83,83,0,
Skylab,HOB,13,4,108,108,0,bee sort of bumps in to paper
Skylab,HOB,13,4,118,119,1,
Skylab,HOB,13,4,126,131,5,"bee sort of facing the paper, not too sure"
Skylab,HOB,13,4,136,138,2,bee sort of sniffs sideways
Skylab,HOB,13,4,185,185,0,
Skylab,HOB,13,4,608,609,1,bee sort of bumps of bumps in to paper
Skylab,HOB,13,4,604,615,11,
Skylab,HOB,13,4,833,833,0,bee sort of bumps of bumps in to paper
Skylab,HOB,13,4,851,851,0,
Skylab,HOB,13,4,899,899,0,
Skylab,HOB,13,4,900,900,0,
Skylab,HOB,13,4,971,972,1,
Skylab,HOB,13,4,1041,1041,0,
Skylab,HOB,13,4,1057,1057,0,
Skylab,HOB,13,4,1114,1114,0,
Skylab,HOB,13,4,1125,1125,0,
Skylab,HOB,13,4,1155,1155,0,
Skylab,HOB,13,4,1285,1285,0,
Skylab,HOB,13,4,1296,1297,1,
Skylab,HOB,13,4,1358,1358,0,
Skylab,HOB,13,4,1401,1401,0,maybe bumps in to paper
Skylab,HOB,13,4,1527,1527,0,
Skylab,HOB,13,4,1779,1779,0,maybe bumps in to paper
Skylab,HOB,15,4,2,8,6,
Skylab,HOB,15,4,13,14,1,
Skylab,HOB,15,4,105,106,1,
Skylab,HOB,15,4,165,165,0,not a touch but sort of lunges toward the paper
Skylab,HOB,15,4,201,201,0,
Skylab,HOB,15,4,210,211,1,
Skylab,HOB,15,4,248,248,0,
Skylab,HOB,15,4,270,271,1,
Skylab,HOB,15,4,279,280,1,
Skylab,HOB,15,4,287,288,1,
Skylab,HOB,15,4,306,309,3,
Skylab,HOB,15,4,330,331,1,
Skylab,HOB,15,4,354,355,1,
Skylab,HOB,15,4,366,366,0,
Skylab,HOB,15,4,396,396,0,
Skylab,HOB,15,4,439,439,0,
Skylab,HOB,15,4,449,449,0,
Skylab,HOB,15,4,492,493,1,
Skylab,HOB,15,4,510,514,4,
Skylab,HOB,15,4,523,523,0,
Skylab,HOB,15,4,548,548,0,
Skylab,HOB,15,4,644,646,2,
Skylab,HOB,15,4,694,694,0,
Skylab,HOB,15,4,709,713,4,
Skylab,HOB,15,4,908,909,1,sniff from afar
Skylab,HOB,15,4,952,953,1,
Skylab,HOB,15,4,1005,1005,0,
Skylab,HOB,15,4,1059,1059,0,
Skylab,HOB,15,4,1167,1168,1,
Skylab,HOB,15,4,1177,1177,0,
Skylab,HOB,15,4,1220,1220,0,not entirely sure if it counts it seems to bump in to the paper
Skylab,HOB,15,4,1229,1230,1,
Skylab,HOB,15,4,1235,1235,0,not entirely sure if it counts it seems to bump in to the paper
Skylab,HOB,15,4,1348,1354,6,
Skylab,HOB,15,4,1397,1398,1,
Skylab,HOB,15,4,1454,1454,0,
Skylab,HOB,15,4,1534,1535,1,
Skylab,HOB,15,4,1535,1536,1,
Skylab,HOB,15,4,1599,1601,2,
Skylab,HOB,15,4,1636,1637,1,
Skylab,HOB,15,4,1646,1646,0,
Skylab,HOB,15,4,1696,1700,4,
Skylab,HOB,15,4,1737,1737,0,
Skylab,HOB,15,4,1738,1740,2,
Skylab,HOB,15,4,1744,1744,0,not sure - snif from afar
Skylab,HOB,16,2,35,35,0,not super sure it is turning around and seems to have a snif from afar
Skylab,HOB,16,2,53,53,0,
Skylab,HOB,16,2,86,87,1,
Skylab,HOB,16,2,109,110,1,
Skylab,HOB,16,2,127,128,1,
Skylab,HOB,16,2,282,282,0,
Skylab,HOB,16,2,289,289,0,
Skylab,HOB,16,2,321,323,2,
Skylab,HOB,16,2,366,367,1,
Skylab,HOB,16,2,416,416,0,"not too sure, seems to touch as it walks past super breifly"
Skylab,HOB,16,2,463,464,1,
Skylab,HOB,16,2,467,467,0,"not too sure, seems to touch as it walks past super breifly"
Skylab,HOB,16,2,488,488,0,"not too sure, seems to touch as it walks past super breifly"
Skylab,HOB,16,2,515,516,1,
Skylab,HOB,16,2,530,531,1,
Skylab,HOB,16,2,603,603,0,
Skylab,HOB,16,2,792,795,3,
Skylab,HOB,16,2,875,878,3,
Skylab,HOB,16,2,936,936,0,bee sort of bumbles in to paper
Skylab,HOB,16,2,951,952,1,
Skylab,HOB,16,2,1002,1002,0,
Skylab,HOB,16,2,1019,1019,0,"not too sure, seems to touch as it walks past super breifly"
Skylab,HOB,16,2,1059,1060,1,
Skylab,HOB,16,2,1075,1075,0,
Skylab,HOB,16,2,1102,1102,0,
Skylab,HOB,16,2,1121,1121,0,
Skylab,HOB,16,2,1127,1128,1,
Skylab,HOB,16,2,1178,1178,0,
Skylab,HOB,16,2,1210,1214,4,
Skylab,HOB,16,2,1290,1290,0,could just be bumping in to paper
Skylab,HOB,16,2,1290,1290,0,could just be bumping in to paper
Skylab,HOB,16,2,1426,1430,4,
Skylab,HOB,16,2,1510,1511,1,
Skylab,HOB,16,2,1567,1567,0,
Skylab,HOB,16,2,1585,1585,0,
Skylab,HOB,16,2,1587,1587,0,
Skylab,HOB,16,2,1609,1609,0,
Skylab,HOB,16,2,1691,1695,4,
Skylab,HOB,16,2,1702,1702,0,
Skylab,HOB,16,2,1782,1782,0,
Skylab,HOB,17,8,36,36,0,
Skylab,HOB,17,8,54,54,0,
Skylab,HOB,17,8,64,65,1,
Skylab,HOB,17,8,79,81,2,
Skylab,HOB,17,8,85,85,0,
Skylab,HOB,17,8,133,133,0,seems sort of like an accidental bump
Skylab,HOB,17,8,141,142,1,
Skylab,HOB,17,8,262,267,5,
Skylab,HOB,17,8,278,279,1,
Skylab,HOB,17,8,283,284,1,
Skylab,HOB,17,8,291,293,2,
Skylab,HOB,17,8,291,294,3,
Skylab,HOB,17,8,365,366,1,
Skylab,HOB,17,8,427,428,1,
Skylab,HOB,17,8,461,463,2,
Skylab,HOB,17,8,470,470,0,
Skylab,HOB,17,8,572,572,0,
Skylab,HOB,17,8,608,608,0,
Skylab,HOB,17,8,652,654,2,
Skylab,HOB,17,8,664,665,1,
Skylab,HOB,17,8,692,692,0,
Skylab,HOB,17,8,694,694,0,
Skylab,HOB,17,8,696,696,0,
Skylab,HOB,17,8,725,725,0,bee seems to accidentally bump in to paper as it turns around
Skylab,HOB,17,8,766,766,0,
Skylab,HOB,17,8,840,844,4,walsk off paper at 14:08 but its head clears the paper at 14:04
Skylab,HOB,17,8,916,919,3,
Skylab,HOB,17,8,934,935,1,
Skylab,HOB,17,8,985,986,1,
Skylab,HOB,17,8,1021,1022,1,
Skylab,HOB,17,8,1028,1028,0,
Skylab,HOB,17,8,1075,1076,1,
Skylab,HOB,17,8,1123,1124,1,
Skylab,HOB,17,8,1145,1145,0,
Skylab,HOB,17,8,1217,1219,2,
Skylab,HOB,17,8,1250,1251,1,
Skylab,HOB,17,8,1321,1323,2,
Skylab,HOB,17,8,1409,1409,0,
Skylab,HOB,17,8,1446,1446,0,
Skylab,HOB,17,8,1455,1456,1,
Skylab,HOB,17,8,1540,1541,1,bee walks over paper
Skylab,HOB,17,8,1554,1555,1,
Skylab,HOB,17,8,1568,1569,1,
Skylab,HOB,17,8,1598,1599,1,
Skylab,HOB,17,8,1601,1601,0,
Skylab,HOB,17,8,1620,1620,0,
Skylab,HOB,17,8,1643,1644,1,
Skylab,HOB,17,8,1649,1650,1,
Skylab,HOB,17,8,1665,1666,1,
Skylab,HOB,17,8,1693,1693,0,
Skylab,HOB,17,8,1747,1748,1,
Skylab,HOB,17,8,1748,1749,1,
Skylab,HOB,17,8,1755,1756,1,
Skylab,HOB,17,8,1769,1773,4,
Skylab,HOB,17,8,1791,1792,1,
Skylab,HOB,17,8,1793,1794,1,
Skylab,HVA,1,9,0,7,7,
Skylab,HVA,1,9,9,10,1,
Skylab,HVA,1,9,11,15,4,
Skylab,HVA,1,9,28,29,1,
Skylab,HVA,1,9,36,37,1,
Skylab,HVA,1,9,45,45,0,
Skylab,HVA,1,9,47,49,2,
Skylab,HVA,1,9,50,51,1,
Skylab,HVA,1,9,53,54,1,
Skylab,HVA,1,9,59,59,0,
Skylab,HVA,1,9,61,61,0,
Skylab,HVA,1,9,62,64,2,
Skylab,HVA,1,9,66,68,2,
Skylab,HVA,1,9,81,81,0,
Skylab,HVA,1,9,83,83,0,
Skylab,HVA,1,9,96,96,0,
Skylab,HVA,1,9,101,101,0,
Skylab,HVA,1,9,103,103,0,
Skylab,HVA,1,9,105,107,2,
Skylab,HVA,1,9,112,112,0,
Skylab,HVA,1,9,116,116,0,
Skylab,HVA,1,9,126,130,4,
Skylab,HVA,1,9,142,142,0,
Skylab,HVA,1,9,148,149,1,
Skylab,HVA,1,9,151,151,0,
Skylab,HVA,1,9,162,162,0,bee sort of brushes against the pheromone spot
Skylab,HVA,1,9,167,168,1,
Skylab,HVA,1,9,169,169,0,
Skylab,HVA,1,9,172,172,0,bee sort of brushes against the pheromone spot
Skylab,HVA,1,9,183,183,0,
Skylab,HVA,1,9,185,185,0,
Skylab,HVA,1,9,190,190,0,
Skylab,HVA,1,9,196,196,0,
Skylab,HVA,1,9,198,198,0,
Skylab,HVA,1,9,204,204,0,
Skylab,HVA,1,9,206,212,6,
Skylab,HVA,1,9,207,207,0,
Skylab,HVA,1,9,217,218,1,
Skylab,HVA,1,9,222,225,3,
Skylab,HVA,1,9,229,229,0,
Skylab,HVA,1,9,235,235,0,
Skylab,HVA,1,9,248,249,1,
Skylab,HVA,1,9,253,255,2,
Skylab,HVA,1,9,262,263,1,
Skylab,HVA,1,9,269,270,1,
Skylab,HVA,1,9,284,284,0,
Skylab,HVA,1,9,293,294,1,
Skylab,HVA,1,9,303,304,1,
Skylab,HVA,1,9,315,316,1,
Skylab,HVA,1,9,322,322,0,
Skylab,HVA,1,9,330,330,0,
Skylab,HVA,1,9,336,336,0,
Skylab,HVA,1,9,344,345,1,
Skylab,HVA,1,9,364,365,1,
Skylab,HVA,1,9,372,372,0,
Skylab,HVA,1,9,374,374,0,
Skylab,HVA,1,9,381,381,0,
Skylab,HVA,1,9,389,389,0,
Skylab,HVA,1,9,392,392,0,
Skylab,HVA,1,9,411,412,1,
Skylab,HVA,1,9,420,424,4,
Skylab,HVA,1,9,429,429,0,
Skylab,HVA,1,9,437,437,0,
Skylab,HVA,1,9,449,449,0,
Skylab,HVA,1,9,455,455,0,
Skylab,HVA,1,9,458,458,0,
Skylab,HVA,1,9,469,470,1,
Skylab,HVA,1,9,475,475,0,
Skylab,HVA,1,9,483,483,0,
Skylab,HVA,1,9,489,489,0,
Skylab,HVA,1,9,495,495,0,
Skylab,HVA,1,9,503,503,0,
Skylab,HVA,1,9,505,506,1,
Skylab,HVA,1,9,513,513,0,
Skylab,HVA,1,9,532,534,2,
Skylab,HVA,1,9,540,540,0,
Skylab,HVA,1,9,541,545,4,
Skylab,HVA,1,9,562,566,4,
Skylab,HVA,1,9,572,572,0,
Skylab,HVA,1,9,577,578,1,
Skylab,HVA,1,9,581,584,3,
Skylab,HVA,1,9,585,585,0,
Skylab,HVA,1,9,595,596,1,
Skylab,HVA,1,9,602,602,0,
Skylab,HVA,1,9,609,613,4,
Skylab,HVA,1,9,621,623,2,
Skylab,HVA,1,9,629,629,0,
Skylab,HVA,1,9,643,644,1,
Skylab,HVA,1,9,650,650,0,
Skylab,HVA,1,9,605,605,0,
Skylab,HVA,1,9,673,673,0,
Skylab,HVA,1,9,678,678,0,
Skylab,HVA,1,9,685,685,0,
Skylab,HVA,1,9,690,690,0,
Skylab,HVA,1,9,692,693,1,
Skylab,HVA,1,9,699,699,0,
Skylab,HVA,1,9,704,711,7,
Skylab,HVA,1,9,709,709,0,
Skylab,HVA,1,9,714,714,0,
Skylab,HVA,1,9,716,717,1,
Skylab,HVA,1,9,718,722,4,
Skylab,HVA,1,9,729,730,1,
Skylab,HVA,1,9,735,735,0,
Skylab,HVA,1,9,799,801,2,
Skylab,HVA,1,9,822,822,0,
Skylab,HVA,1,9,832,838,6,
Skylab,HVA,1,9,843,845,2,
Skylab,HVA,1,9,853,863,10,
Skylab,HVA,1,9,854,856,2,
Skylab,HVA,1,9,864,864,0,
Skylab,HVA,1,9,871,871,0,
Skylab,HVA,1,9,882,885,3,
Skylab,HVA,1,9,890,890,0,
Skylab,HVA,1,9,907,908,1,
Skylab,HVA,1,9,916,916,0,
Skylab,HVA,1,9,920,920,0,
Skylab,HVA,1,9,938,941,3,
Skylab,HVA,1,9,948,950,2,
Skylab,HVA,1,9,955,955,0,
Skylab,HVA,1,9,961,961,0,
Skylab,HVA,1,9,968,968,0,
Skylab,HVA,1,9,974,974,0,
Skylab,HVA,1,9,979,979,0,
Skylab,HVA,1,9,992,994,2,
Skylab,HVA,1,9,1005,1006,1,
Skylab,HVA,1,9,1012,1012,0,
Skylab,HVA,1,9,1019,1019,0,
Skylab,HVA,1,9,1024,1025,1,
Skylab,HVA,1,9,1031,1032,1,
Skylab,HVA,1,9,1040,1040,0,
Skylab,HVA,1,9,1052,1052,0,
Skylab,HVA,1,9,1063,1063,0,
Skylab,HVA,1,9,1078,1078,0,
Skylab,HVA,1,9,1087,1088,1,
Skylab,HVA,1,9,1095,1095,0,
Skylab,HVA,1,9,1099,1100,1,
Skylab,HVA,1,9,1106,1106,0,
Skylab,HVA,1,9,1113,1114,1,
Skylab,HVA,1,9,1135,1135,0,
Skylab,HVA,1,9,1139,1140,1,
Skylab,HVA,1,9,1141,1142,1,
Skylab,HVA,1,9,1145,1145,0,
Skylab,HVA,1,9,1160,1161,1,
Skylab,HVA,1,9,1167,1167,0,
Skylab,HVA,1,9,1173,1174,1,
Skylab,HVA,1,9,1179,1179,0,
Skylab,HVA,1,9,1190,1193,3,
Skylab,HVA,1,9,1198,1198,0,
Skylab,HVA,1,9,1209,1220,11,
Skylab,HVA,1,9,1227,1228,1,
Skylab,HVA,1,9,1238,1245,7,
Skylab,HVA,1,9,1250,1250,0,
Skylab,HVA,1,9,1267,1267,0,
Skylab,HVA,1,9,1272,1272,0,
Skylab,HVA,1,9,1293,1293,0,
Skylab,HVA,1,9,1300,1300,0,
Skylab,HVA,1,9,1302,1303,1,
Skylab,HVA,1,9,1322,1324,2,
Skylab,HVA,1,9,1330,1332,2,
Skylab,HVA,1,9,1337,1340,3,
Skylab,HVA,1,9,1340,1341,1,
Skylab,HVA,1,9,1350,1351,1,
Skylab,HVA,1,9,1358,1359,1,
Skylab,HVA,1,9,1360,1361,1,
Skylab,HVA,1,9,1365,1366,1,
Skylab,HVA,1,9,1368,1370,2,
Skylab,HVA,1,9,1375,1375,0,
Skylab,HVA,1,9,1383,1383,0,
Skylab,HVA,1,9,1392,1392,0,
Skylab,HVA,1,9,1404,1404,0,
Skylab,HVA,1,9,1407,1407,0,
Skylab,HVA,1,9,1414,1414,0,
Skylab,HVA,1,9,1417,1421,4,
Skylab,HVA,1,9,1423,1424,1,
Skylab,HVA,1,9,1436,1436,0,
Skylab,HVA,1,9,1452,1455,3,
Skylab,HVA,1,9,1452,1464,12,
Skylab,HVA,1,9,1490,1491,1,
Skylab,HVA,1,9,1501,1502,1,
Skylab,HVA,1,9,1502,1504,2,
Skylab,HVA,1,9,1510,1510,0,
Skylab,HVA,1,9,1521,1524,3,
Skylab,HVA,1,9,1527,1527,0,
Skylab,HVA,1,9,1535,1535,0,
Skylab,HVA,1,9,1547,1552,5,
Skylab,HVA,1,9,1554,1554,0,
Skylab,HVA,1,9,1567,1573,6,
Skylab,HVA,1,9,1587,1587,0,
Skylab,HVA,1,9,1598,1598,0,
Skylab,HVA,1,9,1607,1608,1,
Skylab,HVA,1,9,1611,1611,0,
Skylab,HVA,1,9,1618,1618,0,
Skylab,HVA,1,9,1624,1624,0,
Skylab,HVA,1,9,1656,1656,0,
Skylab,HVA,1,9,1670,1672,2,
Skylab,HVA,1,9,1675,1677,2,
Skylab,HVA,1,9,1685,1686,1,
Skylab,HVA,1,9,1693,1695,2,
Skylab,HVA,1,9,1697,1699,2,
Skylab,HVA,1,9,1700,1700,0,
Skylab,HVA,1,9,1706,1706,0,
Skylab,HVA,1,9,1712,1713,1,
Skylab,HVA,1,9,1728,1728,0,
Skylab,HVA,1,9,1745,1745,0,
Skylab,HVA,1,9,1753,1753,0,
Skylab,HVA,1,9,1756,1756,0,
Skylab,HVA,1,9,1757,1761,4,
Skylab,HVA,1,9,1775,1775,0,
Skylab,HVA,1,9,1778,1778,0,
Skylab,HVA,1,9,1793,1795,2,
Skylab,HVA,2,9,33,39,6,
Skylab,HVA,2,9,88,88,0,
Skylab,HVA,2,9,127,129,2,
Skylab,HVA,2,9,157,158,1,
Skylab,HVA,2,9,182,183,1,
Skylab,HVA,2,9,194,194,0,
Skylab,HVA,2,9,204,205,1,
Skylab,HVA,2,9,296,297,1,
Skylab,HVA,2,9,356,357,1,
Skylab,HVA,2,9,406,407,1,
Skylab,HVA,2,9,509,509,0,
Skylab,HVA,2,9,520,520,0,
Skylab,HVA,2,9,538,538,0,
Skylab,HVA,2,9,553,553,0,
Skylab,HVA,2,9,594,594,0,
Skylab,HVA,2,9,613,613,0,
Skylab,HVA,2,9,631,631,0,
Skylab,HVA,2,9,643,643,0,
Skylab,HVA,2,9,784,784,0,
Skylab,HVA,2,9,844,844,0,
Skylab,HVA,2,9,865,865,0,
Skylab,HVA,2,9,959,963,4,
Skylab,HVA,2,9,969,970,1,
Skylab,HVA,2,9,998,998,0,
Skylab,HVA,2,9,1089,1089,0,
Skylab,HVA,2,9,1132,1132,0,
Skylab,HVA,2,9,1136,1137,1,
Skylab,HVA,2,9,1182,1182,0,
Skylab,HVA,2,9,1239,1239,0,
Skylab,HVA,2,9,1259,1259,0,
Skylab,HVA,2,9,1267,1383,116,bee sits still parallel to paper - then starts sniffing
Skylab,HVA,2,9,1328,1336,8,
Skylab,HVA,2,9,1337,1341,4,
Skylab,HVA,2,9,1364,1379,15,
Skylab,HVA,2,9,1380,1382,2,
Skylab,HVA,2,9,1424,1425,1,
Skylab,HVA,2,9,1484,1484,0,
Skylab,HVA,2,9,1490,1490,0,
Skylab,HVA,3,9,41,41,0,
Skylab,HVA,3,9,204,207,3,
Skylab,HVA,3,9,230,230,0,
Skylab,HVA,3,9,280,283,3,
Skylab,HVA,3,9,310,318,8,
Skylab,HVA,3,9,336,341,5,
Skylab,HVA,3,9,565,566,1,
Skylab,HVA,3,9,586,586,0,
Skylab,HVA,3,9,588,588,0,
Skylab,HVA,3,9,633,639,6,bee bumps in to paper and gets stuck there because of other bees
Skylab,HVA,3,9,669,669,0,
Skylab,HVA,3,9,708,708,0,
Skylab,HVA,3,9,753,754,1,
Skylab,HVA,3,9,864,865,1,
Skylab,HVA,3,9,898,899,1,
Skylab,HVA,3,9,1023,1027,4,
Skylab,HVA,3,9,1055,1059,4,
Skylab,HVA,3,9,1068,1069,1,
Skylab,HVA,3,9,1180,1181,1,
Skylab,HVA,3,9,1219,1220,1,
Skylab,HVA,3,9,1231,1231,0,
Skylab,HVA,3,9,1240,1242,2,
Skylab,HVA,3,9,1696,1700,4,
Skylab,HVA,3,9,1704,1707,3,
Skylab,HVA,3,9,1713,1713,0,
Skylab,HVA,3,9,1717,1717,0,
Skylab,HVA,3,9,1724,1724,0,
Skylab,HVA,3,9,1749,1755,6,
Skylab,HVA,10,9,0,38,38,
Skylab,HVA,10,9,103,107,4,
Skylab,HVA,10,9,152,152,0,
Skylab,HVA,10,9,175,175,0,
Skylab,HVA,10,9,205,209,4,
Skylab,HVA,10,9,231,240,9,
Skylab,HVA,10,9,243,244,1,
Skylab,HVA,10,9,250,250,0,
Skylab,HVA,10,9,254,254,0,
Skylab,HVA,10,9,283,299,16,bee sort of sniffs from afar
Skylab,HVA,10,9,298,298,0,not quite touching
Skylab,HVA,10,9,330,330,0,
Skylab,HVA,10,9,341,342,1,
Skylab,HVA,10,9,354,355,1,
Skylab,HVA,10,9,378,379,1,
Skylab,HVA,10,9,432,434,2,
Skylab,HVA,10,9,457,459,2,
Skylab,HVA,10,9,504,504,0,
Skylab,HVA,10,9,545,549,4,
Skylab,HVA,10,9,547,549,2,
Skylab,HVA,10,9,571,573,2,
Skylab,HVA,10,9,576,579,3,
Skylab,HVA,10,9,576,579,3,
Skylab,HVA,10,9,580,580,0,
Skylab,HVA,10,9,598,598,0,
Skylab,HVA,10,9,705,714,9,bee sniffing from afar i think
Skylab,HVA,10,9,754,771,17,
Skylab,HVA,10,9,760,792,32,
Skylab,HVA,10,9,781,781,0,
Skylab,HVA,10,9,792,795,3,ne touching but seems to be sniffing
Skylab,HVA,10,9,812,815,3,
Skylab,HVA,10,9,819,825,6,
Skylab,HVA,10,9,832,838,6,
Skylab,HVA,10,9,841,847,6,
Skylab,HVA,10,9,843,848,5,
Skylab,HVA,10,9,854,857,3,
Skylab,HVA,10,9,855,857,2,
Skylab,HVA,10,9,864,867,3,
Skylab,HVA,10,9,879,888,9,
Skylab,HVA,10,9,891,893,2,
Skylab,HVA,10,9,901,910,9,
Skylab,HVA,10,9,971,971,0,
Skylab,HVA,10,9,1032,1032,0,
Skylab,HVA,10,9,1085,1086,1,not quite touching
Skylab,HVA,10,9,1161,1166,5,
Skylab,HVA,10,9,1198,1200,2,
Skylab,HVA,10,9,1297,1297,0,
Skylab,HVA,10,9,1304,1306,2,
Skylab,HVA,10,9,1315,1318,3,
Skylab,HVA,10,9,1316,1316,0,
Skylab,HVA,10,9,1325,1328,3,
Skylab,HVA,10,9,1350,1351,1,
Skylab,HVA,10,9,1361,1361,0,
Skylab,HVA,10,9,1511,1512,1,
Skylab,HVA,10,9,1541,1541,0,
Skylab,HVA,10,9,1547,1547,0,
Skylab,HVA,10,9,1584,1585,1,
Skylab,HVA,10,9,1626,1626,0,
Skylab,HVA,10,9,1640,1642,2,
Skylab,HVA,10,9,1722,1723,1,
Skylab,HVA,12,4,11,15,4,
Skylab,HVA,12,4,26,27,1,
Skylab,HVA,12,4,27,27,0,
Skylab,HVA,12,4,50,51,1,
Skylab,HVA,12,4,74,74,0,
Skylab,HVA,12,4,80,81,1,
Skylab,HVA,12,4,121,121,0,
Skylab,HVA,12,4,193,193,0,
Skylab,HVA,12,4,254,255,1,
Skylab,HVA,12,4,267,269,2,
Skylab,HVA,12,4,345,353,8,
Skylab,HVA,12,4,383,383,0,
Skylab,HVA,12,4,622,622,0,
Skylab,HVA,12,4,639,649,10,
Skylab,HVA,12,4,658,659,1,
Skylab,HVA,12,4,662,666,4,
Skylab,HVA,12,4,763,851,88,"bee sits still near paper, facing it"
Skylab,HVA,12,4,821,822,1,
Skylab,HVA,12,4,859,869,10,bee sort of sits with its head at an angle to the paper close to it
Skylab,HVA,12,4,1033,1066,33,
Skylab,HVA,12,4,1361,1363,2,
Skylab,HVA,13,11,27,27,0,
Skylab,HVA,13,11,68,69,1,
Skylab,HVA,13,11,159,159,0,
Skylab,HVA,13,11,259,259,0,
Skylab,HVA,13,11,322,322,0,
Skylab,HVA,13,11,330,331,1,
Skylab,HVA,13,11,356,357,1,
Skylab,HVA,13,11,470,470,0,
Skylab,HVA,13,11,472,472,0,
Skylab,HVA,13,11,533,533,0,
Skylab,HVA,13,11,545,546,1,
Skylab,HVA,13,11,565,565,0,
Skylab,HVA,13,11,639,641,2,
Skylab,HVA,13,11,663,667,4,
Skylab,HVA,13,11,855,856,1,
Skylab,HVA,13,11,865,865,0,
Skylab,HVA,13,11,916,918,2,
Skylab,HVA,13,11,964,964,0,
Skylab,HVA,13,11,1063,1063,0,
Skylab,HVA,13,11,1269,1269,0,
Skylab,HVA,13,11,1382,1382,0,
Skylab,HVA,13,11,1463,1465,2,
Skylab,HVA,13,11,1472,1473,1,
Skylab,HVA,13,11,1528,1529,1,
Skylab,HVA,13,11,1572,1572,0,
Skylab,HVA,13,11,1596,1596,0,
Skylab,HVA,13,11,1724,1724,0,
Skylab,HVA,13,11,1734,1734,0,
Skylab,HVA,15,9,51,52,1,
Skylab,HVA,15,9,266,271,5,
Skylab,HVA,15,9,296,300,4,
Skylab,HVA,15,9,391,394,3,
Skylab,HVA,15,9,401,405,4,
Skylab,HVA,15,9,420,425,5,
Skylab,HVA,15,9,468,468,0,
Skylab,HVA,15,9,495,497,2,
Skylab,HVA,15,9,497,497,0,
Skylab,HVA,15,9,507,507,0,bee walks over paper not sure if it counts
Skylab,HVA,15,9,514,525,11,
Skylab,HVA,15,9,539,541,2,
Skylab,HVA,15,9,624,624,0,bee sideways touches paper very fast as it walks by
Skylab,HVA,15,9,696,697,1,
Skylab,HVA,15,9,857,857,0,
Skylab,HVA,15,9,920,932,12,
Skylab,HVA,15,9,943,944,1,bee sideways touches paper as it walks by
Skylab,HVA,15,9,953,956,3,
Skylab,HVA,15,9,1010,1014,4,16:57 bee sits on top of paper n ot sniffing until this time
Skylab,HVA,15,9,1213,1213,0,quick bump
Skylab,HVA,15,9,1319,1321,2,
Skylab,HVA,15,9,1364,1365,1,
Skylab,HVA,15,9,1388,1388,0,sideways touch
Skylab,HVA,15,9,1406,1410,4,
Skylab,HVA,15,9,1506,1509,3,
Skylab,HVA,15,9,1513,1513,0,
Skylab,HVA,15,9,1536,1538,2,
Skylab,HVA,15,9,1572,1573,1,
Skylab,HVA,15,9,1577,1578,1,
Skylab,HVA,15,9,1585,1586,1,
Skylab,HVA,15,9,1647,1653,6,
Skylab,HVA,15,9,1660,1662,2,
Skylab,HVA,15,9,1675,1677,2,
Skylab,HVA,15,9,1677,1679,2,
Skylab,HVA,15,9,1707,1709,2,
Skylab,HVA,16,1,145,147,2,
Skylab,HVA,16,1,369,372,3,
Skylab,HVA,16,1,441,441,0,
Skylab,HVA,16,1,555,557,2,
Skylab,HVA,16,1,574,576,2,
Skylab,HVA,16,1,644,646,2,
Skylab,HVA,16,1,630,631,1,
Skylab,HVA,16,1,632,634,2,
Skylab,HVA,16,1,953,955,2,
Skylab,HVA,16,1,1209,1209,0,turning around and seems to bump in to the paper - not super sure it counts
Skylab,HVA,16,1,1286,1292,6,
Skylab,HVA,16,1,1373,1375,2,
Skylab,HVA,16,1,1493,1494,1,
Skylab,HVA,16,1,1526,1528,2,
Skylab,HVA,16,1,1726,1730,4,
Skylab,HVA,16,1,1754,1754,0,
Skylab,HVA,17,10,7,7,0,
Skylab,HVA,17,10,26,27,1,
Skylab,HVA,17,10,127,127,0,
Skylab,HVA,17,10,165,165,0,
Skylab,HVA,17,10,239,239,0,"not sure, doesnt seem to stop"
Skylab,HVA,17,10,273,274,1,"bee seems to fall on to paper, maybe an accident"
Skylab,HVA,17,10,303,304,1,
Skylab,HVA,17,10,341,341,0,
Skylab,HVA,17,10,372,372,0,
Skylab,HVA,17,10,547,550,3,
Skylab,HVA,17,10,557,561,4,
Skylab,HVA,17,10,570,570,0,
Skylab,HVA,17,10,996,996,0,
Skylab,HVA,17,10,1215,1220,5,
Skylab,HVA,17,10,1229,1237,8,
Skylab,HVA,17,10,1425,1425,0,
Skylab,HVA,17,10,1446,1446,0,
Skylab,HVA,17,10,1476,1477,1,
Skylab,HVA,17,10,1548,1556,8,
Skylab,HVA,17,10,1561,1563,2,
Skylab,9-HDA,1,3,13,16,3,
Skylab,9-HDA,1,3,16,17,1,
Skylab,9-HDA,1,3,54,57,3,
Skylab,9-HDA,1,3,80,82,2,
Skylab,9-HDA,1,3,128,128,0,
Skylab,9-HDA,1,3,140,140,0,
Skylab,9-HDA,1,3,156,156,0,
Skylab,9-HDA,1,3,188,195,7,
Skylab,9-HDA,1,3,263,267,4,
Skylab,9-HDA,1,3,377,379,2,
Skylab,9-HDA,1,3,380,381,1,
Skylab,9-HDA,1,3,385,389,4,
Skylab,9-HDA,1,3,393,393,0,
Skylab,9-HDA,1,3,415,420,5,
Skylab,9-HDA,1,3,453,457,4,
Skylab,9-HDA,1,3,481,481,0,
Skylab,9-HDA,1,3,507,508,1,
Skylab,9-HDA,1,3,522,522,0,
Skylab,9-HDA,1,3,617,617,0,
Skylab,9-HDA,1,3,740,740,0,
Skylab,9-HDA,1,3,891,891,0,
Skylab,9-HDA,1,3,901,901,0,
Skylab,9-HDA,1,3,993,994,1,
Skylab,9-HDA,1,3,1056,1064,8,
Skylab,9-HDA,1,3,1068,1069,1,
Skylab,9-HDA,1,3,1219,1221,2,
Skylab,9-HDA,1,3,1278,1278,0,
Skylab,9-HDA,1,3,1271,1273,2,
Skylab,9-HDA,1,3,1304,1304,0,
Skylab,9-HDA,1,3,1329,1330,1,
Skylab,9-HDA,1,3,1334,1336,2,
Skylab,9-HDA,1,3,1368,1370,2,
Skylab,9-HDA,1,3,1424,1424,0,
Skylab,9-HDA,1,3,1434,1438,4,
Skylab,9-HDA,1,3,1462,1467,5,
Skylab,9-HDA,1,3,1509,1511,2,
Skylab,9-HDA,1,3,1520,1522,2,
Skylab,9-HDA,1,3,1539,1540,1,
Skylab,9-HDA,1,3,1547,1564,17,
Skylab,9-HDA,1,3,1572,1572,0,
Skylab,9-HDA,1,3,1585,1587,2,
Skylab,9-HDA,1,3,1609,1609,0,
Skylab,9-HDA,1,3,1667,1674,7,
Skylab,9-HDA,1,3,1669,1670,1,
Skylab,9-HDA,1,3,1717,1718,1,
Skylab,9-HDA,1,3,1725,1726,1,
Skylab,9-HDA,1,3,1731,1733,2,
Skylab,9-HDA,2,3,183,196,13,
Skylab,9-HDA,2,3,201,203,2,
Skylab,9-HDA,2,3,273,275,2,
Skylab,9-HDA,2,3,315,317,2,
Skylab,9-HDA,2,3,344,345,1,
Skylab,9-HDA,2,3,366,369,3,bee sort of sniffs from afar
Skylab,9-HDA,2,3,385,386,1,
Skylab,9-HDA,2,3,526,526,0,
Skylab,9-HDA,2,3,950,951,1,
Skylab,9-HDA,2,3,968,968,0,
Skylab,9-HDA,2,3,1087,1087,0,
Skylab,9-HDA,2,3,1104,1104,0,
Skylab,9-HDA,2,3,1153,1153,0,
Skylab,9-HDA,2,3,1203,1203,0,
Skylab,9-HDA,2,3,1215,1215,0,
Skylab,9-HDA,2,3,1283,1283,0,
Skylab,9-HDA,2,3,1299,1299,0,
Skylab,9-HDA,2,3,1355,1355,0,
Skylab,9-HDA,2,3,1453,1454,1,
Skylab,9-HDA,2,3,1456,1457,1,
Skylab,9-HDA,2,3,1469,1469,0,
Skylab,9-HDA,2,3,1494,1494,0,
Skylab,9-HDA,2,3,1540,1541,1,
Skylab,9-HDA,2,3,1540,1541,1,
Skylab,9-HDA,2,3,1542,1542,0,
Skylab,9-HDA,2,3,1545,1545,0,
Skylab,9-HDA,2,3,1561,1561,0,
Skylab,9-HDA,2,3,1654,1657,3,
Skylab,9-HDA,2,3,1660,1678,18,
Skylab,9-HDA,2,3,1671,1672,1,
Skylab,9-HDA,2,3,1696,1697,1,
Skylab,9-HDA,2,3,1714,1716,2,
Skylab,9-HDA,2,3,1729,1732,3,
Skylab,9-HDA,2,3,1735,1736,1,
Skylab,9-HDA,2,3,1749,1750,1,
Skylab,9-HDA,2,3,1759,1759,0,
Skylab,9-HDA,2,3,1770,1773,3,
Skylab,9-HDA,3,2,61,62,1,
Skylab,9-HDA,3,2,70,73,3,
Skylab,9-HDA,3,2,73,74,1,
Skylab,9-HDA,3,2,124,124,0,
Skylab,9-HDA,3,2,135,137,2,
Skylab,9-HDA,3,2,210,211,1,
Skylab,9-HDA,3,2,277,278,1,
Skylab,9-HDA,3,2,315,315,0,
Skylab,9-HDA,3,2,333,333,0,
Skylab,9-HDA,3,2,344,346,2,
Skylab,9-HDA,3,2,348,348,0,
Skylab,9-HDA,3,2,499,499,0,
Skylab,9-HDA,3,2,600,600,0,
Skylab,9-HDA,3,2,621,629,8,
Skylab,9-HDA,3,2,660,660,0,
Skylab,9-HDA,3,2,664,664,0,
Skylab,9-HDA,3,2,698,700,2,
Skylab,9-HDA,3,2,701,705,4,
Skylab,9-HDA,3,2,751,751,0,
Skylab,9-HDA,3,2,882,882,0,
Skylab,9-HDA,3,2,926,1527,601,
Skylab,9-HDA,3,2,931,931,0,
Skylab,9-HDA,3,2,933,948,15,
Skylab,9-HDA,3,2,944,945,1,
Skylab,9-HDA,3,2,976,976,0,
Skylab,9-HDA,3,2,977,977,0,
Skylab,9-HDA,3,2,982,982,0,
Skylab,9-HDA,3,2,985,987,2,
Skylab,9-HDA,3,2,1019,1019,0,
Skylab,9-HDA,3,2,1022,1023,1,
Skylab,9-HDA,3,2,1088,1089,1,
Skylab,9-HDA,3,2,1117,1179,62,
Skylab,9-HDA,3,2,1132,1136,4,
Skylab,9-HDA,3,2,1159,1162,3,
Skylab,9-HDA,3,2,1184,1184,0,
Skylab,9-HDA,3,2,1220,1220,0,
Skylab,9-HDA,3,2,1225,1229,4,
Skylab,9-HDA,3,2,1235,1236,1,
Skylab,9-HDA,3,2,1245,1245,0,
Skylab,9-HDA,3,2,1248,1249,1,
Skylab,9-HDA,3,2,1301,1301,0,
Skylab,9-HDA,3,2,1350,1351,1,
Skylab,9-HDA,3,2,1407,1407,0,
Skylab,9-HDA,3,2,1476,1478,2,
Skylab,9-HDA,3,2,1506,1508,2,
Skylab,9-HDA,3,2,1637,1637,0,
Skylab,9-HDA,3,2,1729,1729,0,
Skylab,9-HDA,10,3,23,30,7,
Skylab,9-HDA,10,3,56,56,0,
Skylab,9-HDA,10,3,68,68,0,
Skylab,9-HDA,10,3,76,76,0,
Skylab,9-HDA,10,3,78,80,2,
Skylab,9-HDA,10,3,88,88,0,
Skylab,9-HDA,10,3,94,95,1,
Skylab,9-HDA,10,3,95,95,0,
Skylab,9-HDA,10,3,99,99,0,
Skylab,9-HDA,10,3,105,105,0,
Skylab,9-HDA,10,3,140,142,2,
Skylab,9-HDA,10,3,295,295,0,
Skylab,9-HDA,10,3,348,348,0,
Skylab,9-HDA,10,3,405,405,0,
Skylab,9-HDA,10,3,478,479,1,
Skylab,9-HDA,10,3,516,518,2,
Skylab,9-HDA,10,3,525,541,16,
Skylab,9-HDA,10,3,545,551,6,
Skylab,9-HDA,10,3,556,559,3,
Skylab,9-HDA,10,3,559,559,0,
Skylab,9-HDA,10,3,561,561,0,
Skylab,9-HDA,10,3,561,563,2,
Skylab,9-HDA,10,3,582,584,2,
Skylab,9-HDA,10,3,597,612,15,
Skylab,9-HDA,10,3,622,624,2,
Skylab,9-HDA,10,3,636,639,3,
Skylab,9-HDA,10,3,697,701,4,
Skylab,9-HDA,10,3,711,711,0,
Skylab,9-HDA,10,3,714,714,0,
Skylab,9-HDA,10,3,716,717,1,
Skylab,9-HDA,10,3,791,791,0,
Skylab,9-HDA,10,3,834,836,2,
Skylab,9-HDA,10,3,920,970,50,bee not at all touching paper but facing it and sort of seems interrested
Skylab,9-HDA,10,3,989,989,0,
Skylab,9-HDA,10,3,1008,1008,0,
Skylab,9-HDA,10,3,1122,1122,0,
Skylab,9-HDA,10,3,1170,1170,0,
Skylab,9-HDA,10,3,1184,1184,0,not really touching maybe - sort of stops near paper as it turns around
Skylab,9-HDA,10,3,1189,1190,1,
Skylab,9-HDA,10,3,1199,1200,1,
Skylab,9-HDA,10,3,1255,1255,0,
Skylab,9-HDA,10,3,1324,1324,0,
Skylab,9-HDA,10,3,1347,1348,1,
Skylab,9-HDA,10,3,1366,1366,0,
Skylab,9-HDA,10,3,1379,1380,1,
Skylab,9-HDA,10,3,1387,1387,0,
Skylab,9-HDA,10,3,1445,1445,0,
Skylab,9-HDA,10,3,1446,1447,1,
Skylab,9-HDA,10,3,1463,1463,0,
Skylab,9-HDA,10,3,1483,1483,0,sideways touch
Skylab,9-HDA,10,3,1526,1526,0,
Skylab,9-HDA,10,3,1560,1562,2,
Skylab,9-HDA,10,3,1598,1599,1,
Skylab,9-HDA,10,3,1655,1655,0,
Skylab,9-HDA,10,3,1656,1660,4,
Skylab,9-HDA,10,3,1729,1733,4,
Skylab,9-HDA,10,3,1763,1764,1,
Skylab,9-HDA,10,3,1772,1773,1,
Skylab,9-HDA,10,3,1789,1789,0,
Skylab,9-HDA,12,10,0,0,0,
Skylab,9-HDA,12,10,24,24,0,
Skylab,9-HDA,12,10,99,99,0,
Skylab,9-HDA,12,10,341,341,0,not touching but turns towards paper and seems interrested in it
Skylab,9-HDA,12,10,373,375,2,
Skylab,9-HDA,12,10,405,407,2,
Skylab,9-HDA,12,10,410,426,16,bee sits mostly still next to the paper
Skylab,9-HDA,12,10,439,440,1,
Skylab,9-HDA,12,10,449,449,0,
Skylab,9-HDA,12,10,452,454,2,bee sniffs from afar
Skylab,9-HDA,12,10,480,482,2,
Skylab,9-HDA,12,10,488,490,2,
Skylab,9-HDA,12,10,501,508,7,
Skylab,9-HDA,12,10,510,514,4,
Skylab,9-HDA,12,10,512,512,0,
Skylab,9-HDA,12,10,517,525,8,
Skylab,9-HDA,12,10,536,566,30,bee mostly still short distance from paper facing it
Skylab,9-HDA,12,10,538,540,2,
Skylab,9-HDA,12,10,548,558,10,
Skylab,9-HDA,12,10,576,577,1,
Skylab,9-HDA,12,10,622,624,2,
Skylab,9-HDA,12,10,627,639,12,
Skylab,9-HDA,12,10,635,642,7,
Skylab,9-HDA,12,10,745,748,3,
Skylab,9-HDA,12,10,819,819,0,
Skylab,9-HDA,12,10,853,853,0,
Skylab,9-HDA,12,10,903,905,2,
Skylab,9-HDA,12,10,968,988,20,
Skylab,9-HDA,12,10,1008,1008,0,
Skylab,9-HDA,12,10,1027,1027,0,
Skylab,9-HDA,12,10,1070,1072,2,not quite touching
Skylab,9-HDA,12,10,1092,1092,0,very fast touch as it walks past
Skylab,9-HDA,12,10,1178,1181,3,
Skylab,9-HDA,12,10,1187,1191,4,
Skylab,9-HDA,12,10,1187,1189,2,
Skylab,9-HDA,12,10,1194,1195,1,
Skylab,9-HDA,12,10,1168,1169,1,
Skylab,9-HDA,12,10,1229,1233,4,
Skylab,9-HDA,12,10,1262,1263,1,
Skylab,9-HDA,12,10,1272,1273,1,
Skylab,9-HDA,12,10,1278,1278,0,
Skylab,9-HDA,12,10,1484,1484,0,
Skylab,9-HDA,12,10,1546,1552,6,
Skylab,9-HDA,12,10,1557,1558,1,
Skylab,9-HDA,12,10,1611,1615,4,
Skylab,9-HDA,12,10,1616,1616,0,
Skylab,9-HDA,12,10,1621,1639,18,
Skylab,9-HDA,13,9,34,38,4,
Skylab,9-HDA,13,9,40,41,1,
Skylab,9-HDA,13,9,65,65,0,
Skylab,9-HDA,13,9,119,120,1,
Skylab,9-HDA,13,9,121,121,0,maybe slight touch
Skylab,9-HDA,13,9,164,164,0,
Skylab,9-HDA,13,9,165,166,1,
Skylab,9-HDA,13,9,178,178,0,
Skylab,9-HDA,13,9,279,301,22,
Skylab,9-HDA,13,9,294,297,3,
Skylab,9-HDA,13,9,363,364,1,
Skylab,9-HDA,13,9,974,974,0,sideways touch
Skylab,9-HDA,13,9,402,402,0,
Skylab,9-HDA,13,9,409,410,1,
Skylab,9-HDA,13,9,480,480,0,accidental touch as bee turns around
Skylab,9-HDA,13,9,523,527,4,
Skylab,9-HDA,13,9,532,536,4,
Skylab,9-HDA,13,9,589,589,0,
Skylab,9-HDA,13,9,649,649,0,
Skylab,9-HDA,13,9,675,675,0,
Skylab,9-HDA,13,9,734,738,4,not touching but very close and seems interrested
Skylab,9-HDA,13,9,746,746,0,
Skylab,9-HDA,13,9,755,755,0,
Skylab,9-HDA,13,9,849,849,0,
Skylab,9-HDA,13,9,867,868,1,
Skylab,9-HDA,13,9,953,961,8,"maybe, not quite touching"
Skylab,9-HDA,13,9,956,956,0,
Skylab,9-HDA,13,9,986,989,3,
Skylab,9-HDA,13,9,1093,1093,0,
Skylab,9-HDA,13,9,1131,1131,0,
Skylab,9-HDA,13,9,1138,1138,0,
Skylab,9-HDA,13,9,1151,1151,0,
Skylab,9-HDA,13,9,1185,1191,6,
Skylab,9-HDA,13,9,1195,1195,0,
Skylab,9-HDA,13,9,1260,1262,2,
Skylab,9-HDA,13,9,1351,1351,0,
Skylab,9-HDA,13,9,1451,1452,1,
Skylab,9-HDA,13,9,1480,1483,3,
Skylab,9-HDA,13,9,1667,1667,0,
Skylab,9-HDA,13,9,1670,1677,7,"bee facing paper but not touching, seems to be sniffing"
Skylab,9-HDA,13,9,1678,1681,3,
Skylab,9-HDA,13,9,1716,1718,2,"bee facing paper but not touching, seems to be sniffing"
Skylab,9-HDA,15,5,3,5,2,
Skylab,9-HDA,15,5,10,10,0,
Skylab,9-HDA,15,5,11,11,0,
Skylab,9-HDA,15,5,12,14,2,
Skylab,9-HDA,15,5,18,18,0,
Skylab,9-HDA,15,5,21,21,0,
Skylab,9-HDA,15,5,27,30,3,
Skylab,9-HDA,15,5,33,33,0,
Skylab,9-HDA,15,5,36,39,3,
Skylab,9-HDA,15,5,41,41,0,
Skylab,9-HDA,15,5,45,45,0,
Skylab,9-HDA,15,5,92,98,6,
Skylab,9-HDA,15,5,100,104,4,
Skylab,9-HDA,15,5,108,111,3,
Skylab,9-HDA,15,5,114,114,0,
Skylab,9-HDA,15,5,114,117,3,
Skylab,9-HDA,15,5,116,118,2,
Skylab,9-HDA,15,5,118,125,7,not super sure it is sitting on top of paper paying attention to annother bee
Skylab,9-HDA,15,5,120,138,18,
Skylab,9-HDA,15,5,125,125,0,
Skylab,9-HDA,15,5,128,129,1,bee walks over paper
Skylab,9-HDA,15,5,135,135,0,
Skylab,9-HDA,15,5,157,158,1,bee sniffs from afar
Skylab,9-HDA,15,5,161,163,2,
Skylab,9-HDA,15,5,162,163,1,
Skylab,9-HDA,15,5,167,168,1,
Skylab,9-HDA,15,5,182,185,3,
Skylab,9-HDA,15,5,192,194,2,
Skylab,9-HDA,15,5,224,224,0,
Skylab,9-HDA,15,5,226,228,2,
Skylab,9-HDA,15,5,266,267,1,
Skylab,9-HDA,15,5,293,296,3,
Skylab,9-HDA,15,5,350,352,2,
Skylab,9-HDA,15,5,368,369,1,
Skylab,9-HDA,15,5,572,572,0,bee sort of side touches it as it walks past
Skylab,9-HDA,15,5,684,684,0,
Skylab,9-HDA,15,5,724,726,2,
Skylab,9-HDA,15,5,730,731,1,
Skylab,9-HDA,15,5,797,798,1,
Skylab,9-HDA,15,5,854,856,2,
Skylab,9-HDA,15,5,862,863,1,
Skylab,9-HDA,15,5,886,886,0,
Skylab,9-HDA,15,5,905,906,1,
Skylab,9-HDA,15,5,914,914,0,bee bumps in to paper - probs dosen't count
Skylab,9-HDA,15,5,916,916,0,
Skylab,9-HDA,15,5,977,979,2,
Skylab,9-HDA,15,5,1052,1052,0,bee bumps in to paper - probs dosen't count
Skylab,9-HDA,15,5,1129,1132,3,
Skylab,9-HDA,15,5,1135,1138,3,
Skylab,9-HDA,15,5,1255,1260,5,21:06 is when the bee moves off the pAper it sits on top of it for a while after it stops sniffing
Skylab,9-HDA,15,5,1270,1275,5,
Skylab,9-HDA,15,5,1279,1280,1,
Skylab,9-HDA,15,5,1280,1282,2,
Skylab,9-HDA,15,5,1284,1284,0,
Skylab,9-HDA,15,5,1301,1305,4,
Skylab,9-HDA,15,5,1316,1319,3,
Skylab,9-HDA,15,5,1334,1337,3,
Skylab,9-HDA,15,5,1342,1345,3,bee walks over paper
Skylab,9-HDA,15,5,1360,1364,4,
Skylab,9-HDA,15,5,1373,1401,28,
Skylab,9-HDA,15,5,1380,1387,7,
Skylab,9-HDA,15,5,1402,1411,9,
Skylab,9-HDA,15,5,1413,1415,2,
Skylab,9-HDA,15,5,1424,1426,2,
Skylab,9-HDA,15,5,1429,1429,0,
Skylab,9-HDA,15,5,1430,1431,1,
Skylab,9-HDA,15,5,1442,1443,1,
Skylab,9-HDA,15,5,1445,1454,9,
Skylab,9-HDA,15,5,1453,1453,0,
Skylab,9-HDA,15,5,1454,1458,4,
Skylab,9-HDA,15,5,1465,1466,1,
Skylab,9-HDA,15,5,1482,1482,0,
Skylab,9-HDA,15,5,1491,1491,0,
Skylab,9-HDA,15,5,1517,1518,1,
Skylab,9-HDA,15,5,1520,1521,1,
Skylab,9-HDA,15,5,1524,1524,0,
Skylab,9-HDA,15,5,1548,1548,0,
Skylab,9-HDA,15,5,1554,1554,0,
Skylab,9-HDA,15,5,1559,1559,0,
Skylab,9-HDA,15,5,1561,1561,0,
Skylab,9-HDA,15,5,1639,1639,0,
Skylab,9-HDA,15,5,1660,1660,0,
Skylab,9-HDA,15,5,1708,1708,0,
Skylab,9-HDA,15,5,1711,1711,0,
Skylab,9-HDA,15,5,1719,1720,1,
Skylab,9-HDA,15,5,1739,1739,0,
Skylab,9-HDA,15,5,1752,1753,1,
Skylab,9-HDA,15,5,1794,1796,2,
Skylab,9-HDA,15,5,1798,1798,0,
Skylab,9-HDA,16,12,9,12,3,
Skylab,9-HDA,16,12,32,33,1,
Skylab,9-HDA,16,12,39,39,0,
Skylab,9-HDA,16,12,89,91,2,
Skylab,9-HDA,16,12,109,109,0,
Skylab,9-HDA,16,12,109,110,1,
Skylab,9-HDA,16,12,382,382,0,
Skylab,9-HDA,16,12,433,435,2,
Skylab,9-HDA,16,12,480,480,0,
Skylab,9-HDA,16,12,523,524,1,
Skylab,9-HDA,16,12,579,587,8,
Skylab,9-HDA,16,12,601,612,11,
Skylab,9-HDA,16,12,611,613,2,
Skylab,9-HDA,16,12,660,661,1,
Skylab,9-HDA,16,12,698,700,2,
Skylab,9-HDA,16,12,715,715,0,
Skylab,9-HDA,16,12,828,829,1,
Skylab,9-HDA,16,12,950,951,1,
Skylab,9-HDA,16,12,971,979,8,
Skylab,9-HDA,16,12,1010,1012,2,
Skylab,9-HDA,16,12,1120,1122,2,
Skylab,9-HDA,16,12,1130,1132,2,
Skylab,9-HDA,16,12,1228,1228,0,
Skylab,9-HDA,16,12,1436,1445,9,
Skylab,9-HDA,16,12,1446,1448,2,
Skylab,9-HDA,16,12,1454,1454,0,
Skylab,9-HDA,16,12,1490,1490,0,
Skylab,9-HDA,16,12,1528,1529,1,
Skylab,9-HDA,16,12,1656,1656,0,
Skylab,9-HDA,16,12,1759,1760,1,
Skylab,9-HDA,17,12,5,7,2,
Skylab,9-HDA,17,12,16,17,1,
Skylab,9-HDA,17,12,26,29,3,
Skylab,9-HDA,17,12,40,40,0,
Skylab,9-HDA,17,12,57,58,1,
Skylab,9-HDA,17,12,67,67,0,
Skylab,9-HDA,17,12,68,68,0,
Skylab,9-HDA,17,12,78,79,1,
Skylab,9-HDA,17,12,96,96,0,
Skylab,9-HDA,17,12,96,97,1,
Skylab,9-HDA,17,12,232,232,0,
Skylab,9-HDA,17,12,259,259,0,
Skylab,9-HDA,17,12,259,260,1,
Skylab,9-HDA,17,12,275,275,0,
Skylab,9-HDA,17,12,311,312,1,
Skylab,9-HDA,17,12,342,342,0,
Skylab,9-HDA,17,12,396,400,4,bee falls over - not sure if it counts - kinds think it does
Skylab,9-HDA,17,12,426,426,0,
Skylab,9-HDA,17,12,543,544,1,
Skylab,9-HDA,17,12,583,587,4,
Skylab,9-HDA,17,12,585,587,2,
Skylab,9-HDA,17,12,631,634,3,
Skylab,9-HDA,17,12,638,639,1,
Skylab,9-HDA,17,12,644,645,1,
Skylab,9-HDA,17,12,729,729,0,
Skylab,9-HDA,17,12,781,782,1,
Skylab,9-HDA,17,12,845,846,1,
Skylab,9-HDA,17,12,1019,1020,1,
Skylab,9-HDA,17,12,1198,1200,2,
Skylab,9-HDA,17,12,1205,1206,1,
Skylab,9-HDA,17,12,1212,1213,1,
Skylab,9-HDA,17,12,1215,1218,3,
Skylab,9-HDA,17,12,1234,1238,4,
Skylab,9-HDA,17,12,1255,1257,2,
Skylab,9-HDA,17,12,1334,1334,0,
Skylab,9-HDA,17,12,1337,1340,3,
Skylab,9-HDA,17,12,1341,1343,2,
Skylab,9-HDA,17,12,1353,1355,2,
Skylab,9-HDA,17,12,1360,1363,3,
Skylab,9-HDA,17,12,1386,1388,2,
Skylab,9-HDA,17,12,1390,1391,1,
Skylab,9-HDA,17,12,1525,1527,2,
Skylab,9-HDA,17,12,1546,1548,2,
Skylab,9-HDA,17,12,1553,1553,0,
Skylab,9-HDA,17,12,1564,1566,2,
Skylab,9-HDA,17,12,1607,1608,1,
Skylab,9-HDA,17,12,1644,1645,1,
Skylab,9-HDA,17,12,1729,1729,0,
Skylab,9-HDA,17,12,1747,1749,2,
Skylab,9-HDA,17,12,1764,1764,0,
Skylab,9-ODA,1,2,120,124,4,
Skylab,9-ODA,1,2,128,131,3,
Skylab,9-ODA,1,2,133,133,0,
Skylab,9-ODA,1,2,153,153,0,
Skylab,9-ODA,1,2,244,244,0,
Skylab,9-ODA,1,2,243,243,0,
Skylab,9-ODA,1,2,247,251,4,
Skylab,9-ODA,1,2,251,252,1,
Skylab,9-ODA,1,2,250,264,14,
Skylab,9-ODA,1,2,290,292,2,
Skylab,9-ODA,1,2,296,296,0,
Skylab,9-ODA,1,2,315,320,5,
Skylab,9-ODA,1,2,340,347,7,
Skylab,9-ODA,1,2,367,400,33,
Skylab,9-ODA,1,2,390,394,4,
Skylab,9-ODA,1,2,423,424,1,
Skylab,9-ODA,1,2,428,446,18,
Skylab,9-ODA,1,2,461,464,3,
Skylab,9-ODA,1,2,466,467,1,
Skylab,9-ODA,1,2,475,481,6,
Skylab,9-ODA,1,2,490,490,0,
Skylab,9-ODA,1,2,501,502,1,
Skylab,9-ODA,1,2,514,515,1,
Skylab,9-ODA,1,2,533,535,2,
Skylab,9-ODA,1,2,551,555,4,
Skylab,9-ODA,1,2,558,558,0,
Skylab,9-ODA,1,2,568,570,2,
Skylab,9-ODA,1,2,589,590,1,
Skylab,9-ODA,1,2,611,612,1,
Skylab,9-ODA,1,2,660,663,3,
Skylab,9-ODA,1,2,660,665,5,
Skylab,9-ODA,1,2,672,675,3,
Skylab,9-ODA,1,2,704,709,5,
Skylab,9-ODA,1,2,714,715,1,
Skylab,9-ODA,1,2,685,685,0,
Skylab,9-ODA,1,2,752,752,0,
Skylab,9-ODA,1,2,756,757,1,
Skylab,9-ODA,1,2,759,761,2,
Skylab,9-ODA,1,2,772,773,1,
Skylab,9-ODA,1,2,777,783,6,
Skylab,9-ODA,1,2,784,784,0,
Skylab,9-ODA,1,2,849,873,24,
Skylab,9-ODA,1,2,863,863,0,
Skylab,9-ODA,1,2,875,876,1,
Skylab,9-ODA,1,2,886,889,3,
Skylab,9-ODA,1,2,890,895,5,
Skylab,9-ODA,1,2,914,917,3,
Skylab,9-ODA,1,2,938,938,0,
Skylab,9-ODA,1,2,961,963,2,
Skylab,9-ODA,1,2,972,975,3,
Skylab,9-ODA,1,2,982,985,3,
Skylab,9-ODA,1,2,995,995,0,
Skylab,9-ODA,1,2,1034,1036,2,
Skylab,9-ODA,1,2,1047,1051,4,
Skylab,9-ODA,1,2,1082,1113,31,
Skylab,9-ODA,1,2,1130,1130,0,
Skylab,9-ODA,1,2,1138,1138,0,
Skylab,9-ODA,1,2,1150,1152,2,
Skylab,9-ODA,1,2,1156,1156,0,
Skylab,9-ODA,1,2,1171,1171,0,
Skylab,9-ODA,1,2,1176,1204,28,
Skylab,9-ODA,1,2,1178,1179,1,
Skylab,9-ODA,1,2,1216,1216,0,
Skylab,9-ODA,1,2,1259,1318,59,
Skylab,9-ODA,1,2,1325,1325,0,
Skylab,9-ODA,1,2,1335,1344,9,
Skylab,9-ODA,1,2,1354,1360,6,
Skylab,9-ODA,1,2,1368,1369,1,
Skylab,9-ODA,1,2,1389,1395,6,
Skylab,9-ODA,1,2,1400,1406,6,
Skylab,9-ODA,1,2,1435,1436,1,
Skylab,9-ODA,1,2,1443,1551,108,
Skylab,9-ODA,1,2,1569,1571,2,
Skylab,9-ODA,1,2,1562,1571,9,
Skylab,9-ODA,1,2,1581,1583,2,
Skylab,9-ODA,1,2,1603,1605,2,
Skylab,9-ODA,1,2,1609,1609,0,
Skylab,9-ODA,1,2,1591,1632,41,
Skylab,9-ODA,1,2,1625,1625,0,
Skylab,9-ODA,1,2,1628,1628,0,
Skylab,9-ODA,1,2,1634,1635,1,
Skylab,9-ODA,1,2,1640,1654,14,
Skylab,9-ODA,1,2,1649,1649,0,
Skylab,9-ODA,1,2,1651,1654,3,
Skylab,9-ODA,1,2,1694,1695,1,
Skylab,9-ODA,1,2,1705,1705,0,
Skylab,9-ODA,1,2,1714,1715,1,
Skylab,9-ODA,1,2,1734,1735,1,
Skylab,9-ODA,1,2,1755,1755,0,
Skylab,9-ODA,1,2,1760,1761,1,
Skylab,9-ODA,1,2,1762,1762,0,
Skylab,9-ODA,1,2,1767,1768,1,
Skylab,9-ODA,1,2,1769,1772,3,
Skylab,9-ODA,1,2,1779,1781,2,
Skylab,9-ODA,1,2,1791,1791,0,
Skylab,9-ODA,2,2,37,38,1,
Skylab,9-ODA,2,2,72,72,0,
Skylab,9-ODA,2,2,77,77,0,
Skylab,9-ODA,2,2,86,105,19,
Skylab,9-ODA,2,2,132,132,0,
Skylab,9-ODA,2,2,158,158,0,
Skylab,9-ODA,2,2,196,197,1,
Skylab,9-ODA,2,2,269,274,5,
Skylab,9-ODA,2,2,277,278,1,
Skylab,9-ODA,2,2,287,287,0,
Skylab,9-ODA,2,2,304,304,0,
Skylab,9-ODA,2,2,348,350,2,
Skylab,9-ODA,2,2,366,367,1,
Skylab,9-ODA,2,2,416,416,0,
Skylab,9-ODA,2,2,439,439,0,
Skylab,9-ODA,2,2,472,473,1,
Skylab,9-ODA,2,2,500,500,0,
Skylab,9-ODA,2,2,509,513,4,
Skylab,9-ODA,2,2,541,541,0,
Skylab,9-ODA,2,2,565,566,1,
Skylab,9-ODA,2,2,595,595,0,
Skylab,9-ODA,2,2,632,634,2,
Skylab,9-ODA,2,2,685,685,0,
Skylab,9-ODA,2,2,760,760,0,
Skylab,9-ODA,2,2,772,772,0,
Skylab,9-ODA,2,2,877,895,18,
Skylab,9-ODA,2,2,886,887,1,
Skylab,9-ODA,2,2,900,900,0,
Skylab,9-ODA,2,2,913,915,2,
Skylab,9-ODA,2,2,1096,1096,0,
Skylab,9-ODA,2,2,1096,1098,2,
Skylab,9-ODA,2,2,1099,1100,1,
Skylab,9-ODA,2,2,1129,1129,0,
Skylab,9-ODA,2,2,1149,1149,0,
Skylab,9-ODA,2,2,1151,1151,0,
Skylab,9-ODA,2,2,1158,1158,0,
Skylab,9-ODA,2,2,1164,1169,5,
Skylab,9-ODA,2,2,1193,1199,6,
Skylab,9-ODA,2,2,1201,1207,6,
Skylab,9-ODA,2,2,1203,1207,4,
Skylab,9-ODA,2,2,1211,1216,5,
Skylab,9-ODA,2,2,1216,1220,4,
Skylab,9-ODA,2,2,1243,1246,3,
Skylab,9-ODA,2,2,1249,1249,0,
Skylab,9-ODA,2,2,1252,1253,1,
Skylab,9-ODA,2,2,1303,1304,1,
Skylab,9-ODA,2,2,1308,1310,2,
Skylab,9-ODA,2,2,1317,1318,1,
Skylab,9-ODA,2,2,1340,1342,2,
Skylab,9-ODA,2,2,1344,1344,0,
Skylab,9-ODA,2,2,1374,1375,1,
Skylab,9-ODA,2,2,1397,1401,4,
Skylab,9-ODA,2,2,1345,1347,2,
Skylab,9-ODA,2,2,1417,1417,0,
Skylab,9-ODA,2,2,1428,1428,0,
Skylab,9-ODA,2,2,1429,1430,1,
Skylab,9-ODA,2,2,1473,1474,1,
Skylab,9-ODA,2,2,1486,1486,0,
Skylab,9-ODA,2,2,1522,1523,1,
Skylab,9-ODA,2,2,1541,1546,5,
Skylab,9-ODA,2,2,1548,1549,1,
Skylab,9-ODA,2,2,1571,1578,7,
Skylab,9-ODA,2,2,1577,1578,1,
Skylab,9-ODA,2,2,1580,1587,7,
Skylab,9-ODA,2,2,1541,1562,21,
Skylab,9-ODA,2,2,1551,1567,16,
Skylab,9-ODA,2,2,1592,1593,1,bee walks over paper
Skylab,9-ODA,2,2,1738,1738,0,
Skylab,9-ODA,2,2,1751,1751,0,
Skylab,9-ODA,2,2,1752,1752,0,bee walks over paper
Skylab,9-ODA,2,2,1778,1780,2,
Skylab,9-ODA,2,2,1786,1790,4,29:27 paper gets pulled over to the side of the tray
Skylab,9-ODA,3,5,10,11,1,
Skylab,9-ODA,3,5,54,54,0,
Skylab,9-ODA,3,5,108,109,1,
Skylab,9-ODA,3,5,117,120,3,
Skylab,9-ODA,3,5,132,133,1,
Skylab,9-ODA,3,5,133,133,0,
Skylab,9-ODA,3,5,217,217,0,
Skylab,9-ODA,3,5,234,234,0,
Skylab,9-ODA,3,5,248,248,0,
Skylab,9-ODA,3,5,250,250,0,
Skylab,9-ODA,3,5,301,302,1,
Skylab,9-ODA,3,5,381,381,0,
Skylab,9-ODA,3,5,389,390,1,
Skylab,9-ODA,3,5,408,408,0,
Skylab,9-ODA,3,5,411,413,2,
Skylab,9-ODA,3,5,413,413,0,
Skylab,9-ODA,3,5,457,480,23,
Skylab,9-ODA,3,5,491,492,1,
Skylab,9-ODA,3,5,497,501,4,
Skylab,9-ODA,3,5,503,503,0,
Skylab,9-ODA,3,5,494,516,22,
Skylab,9-ODA,3,5,509,513,4,
Skylab,9-ODA,3,5,536,537,1,
Skylab,9-ODA,3,5,538,540,2,
Skylab,9-ODA,3,5,622,622,0,
Skylab,9-ODA,3,5,761,761,0,
Skylab,9-ODA,3,5,796,796,0,
Skylab,9-ODA,3,5,801,801,0,
Skylab,9-ODA,3,5,821,830,9,
Skylab,9-ODA,3,5,834,922,88,
Skylab,9-ODA,3,5,835,837,2,
Skylab,9-ODA,3,5,925,1011,86,
Skylab,9-ODA,3,5,1016,1038,22,
Skylab,9-ODA,3,5,1043,1048,5,
Skylab,9-ODA,3,5,1054,1055,1,
Skylab,9-ODA,3,5,1057,1069,12,
Skylab,9-ODA,3,5,1067,1067,0,
Skylab,9-ODA,3,5,1096,1098,2,
Skylab,9-ODA,3,5,1114,1114,0,
Skylab,9-ODA,3,5,1142,1143,1,
Skylab,9-ODA,3,5,1152,1152,0,
Skylab,9-ODA,3,5,1217,1217,0,
Skylab,9-ODA,3,5,1282,1282,0,
Skylab,9-ODA,3,5,1314,1315,1,
Skylab,9-ODA,3,5,1320,1320,0,
Skylab,9-ODA,3,5,1376,1380,4,
Skylab,9-ODA,3,5,1386,1388,2,
Skylab,9-ODA,3,5,1424,1424,0,
Skylab,9-ODA,3,5,1502,1502,0,
Skylab,9-ODA,3,5,1517,1518,1,
Skylab,9-ODA,3,5,1531,1531,0,
Skylab,9-ODA,3,5,1536,1537,1,
Skylab,9-ODA,3,5,1553,1553,0,
Skylab,9-ODA,3,5,1561,1563,2,
Skylab,9-ODA,3,5,1576,1578,2,
Skylab,9-ODA,3,5,1656,1656,0,
Skylab,9-ODA,3,5,1665,1665,0,
Skylab,9-ODA,3,5,1708,1708,0,
Skylab,9-ODA,3,5,1715,1723,8,
Skylab,9-ODA,3,5,1749,1751,2,
Skylab,9-ODA,10,2,14,15,1,
Skylab,9-ODA,10,2,42,44,2,
Skylab,9-ODA,10,2,97,99,2,
Skylab,9-ODA,10,2,138,138,0,
Skylab,9-ODA,10,2,157,157,0,
Skylab,9-ODA,10,2,201,202,1,
Skylab,9-ODA,10,2,247,247,0,
Skylab,9-ODA,10,2,338,338,0,
Skylab,9-ODA,10,2,368,369,1,
Skylab,9-ODA,10,2,407,407,0,
Skylab,9-ODA,10,2,576,576,0,
Skylab,9-ODA,10,2,599,599,0,
Skylab,9-ODA,10,2,673,673,0,
Skylab,9-ODA,10,2,676,677,1,
Skylab,9-ODA,10,2,736,736,0,
Skylab,9-ODA,10,2,754,754,0,
Skylab,9-ODA,10,2,767,767,0,
Skylab,9-ODA,10,2,812,812,0,
Skylab,9-ODA,10,2,831,831,0,
Skylab,9-ODA,10,2,843,846,3,
Skylab,9-ODA,10,2,848,849,1,
Skylab,9-ODA,10,2,877,877,0,
Skylab,9-ODA,10,2,931,931,0,
Skylab,9-ODA,10,2,1062,1062,0,
Skylab,9-ODA,10,2,1073,1073,0,
Skylab,9-ODA,10,2,1098,1098,0,
Skylab,9-ODA,10,2,1108,1108,0,
Skylab,9-ODA,10,2,1128,1129,1,
Skylab,9-ODA,10,2,1163,1163,0,maybe seems interrested in paper - not quite touching
Skylab,9-ODA,10,2,1191,1191,0,
Skylab,9-ODA,10,2,1222,1222,0,
Skylab,9-ODA,10,2,1282,1282,0,
Skylab,9-ODA,10,2,1317,1317,0,
Skylab,9-ODA,10,2,1362,1362,0,
Skylab,9-ODA,10,2,1395,1396,1,
Skylab,9-ODA,10,2,1409,1414,5,
Skylab,9-ODA,10,2,1416,1418,2,
Skylab,9-ODA,10,2,1421,1439,18,
Skylab,9-ODA,10,2,1444,1447,3,
Skylab,9-ODA,10,2,1452,1457,5,
Skylab,9-ODA,10,2,1459,1461,2,
Skylab,9-ODA,10,2,1469,1472,3,
Skylab,9-ODA,10,2,1487,1488,1,
Skylab,9-ODA,10,2,1491,1494,3,
Skylab,9-ODA,10,2,1523,1527,4,
Skylab,9-ODA,10,2,1524,1526,2,
Skylab,9-ODA,10,2,1527,1527,0,
Skylab,9-ODA,10,2,1538,1538,0,
Skylab,9-ODA,10,2,1570,1570,0,
Skylab,9-ODA,10,2,1575,1575,0,
Skylab,9-ODA,10,2,1624,1624,0,
Skylab,9-ODA,10,2,1693,1694,1,
Skylab,9-ODA,10,2,1755,1756,1,
Skylab,9-ODA,10,2,1766,1767,1,
Skylab,9-ODA,10,2,1773,1773,0,
Skylab,9-ODA,12,11,12,12,0,
Skylab,9-ODA,12,11,41,41,0,
Skylab,9-ODA,12,11,238,240,2,
Skylab,9-ODA,12,11,416,418,2,
Skylab,9-ODA,12,11,444,446,2,
Skylab,9-ODA,12,11,446,446,0,
Skylab,9-ODA,12,11,507,509,2,
Skylab,9-ODA,12,11,549,551,2,
Skylab,9-ODA,12,11,600,600,0,
Skylab,9-ODA,12,11,616,618,2,
Skylab,9-ODA,12,11,781,782,1,
Skylab,9-ODA,12,11,836,841,5,
Skylab,9-ODA,12,11,882,883,1,
Skylab,9-ODA,12,11,896,896,0,
Skylab,9-ODA,12,11,940,942,2,
Skylab,9-ODA,12,11,950,951,1,
Skylab,9-ODA,12,11,970,976,6,
Skylab,9-ODA,12,11,1012,1016,4,bee pauses in front of paper facing it a short distance from it
Skylab,9-ODA,12,11,1046,1046,0,
Skylab,9-ODA,12,11,1085,1085,0,
Skylab,9-ODA,12,11,1106,1107,1,
Skylab,9-ODA,12,11,1182,1183,1,
Skylab,9-ODA,12,11,1224,1225,1,
Skylab,9-ODA,12,11,1230,1230,0,
Skylab,9-ODA,12,11,1268,1268,0,
Skylab,9-ODA,12,11,1285,1286,1,
Skylab,9-ODA,12,11,1375,1375,0,
Skylab,9-ODA,12,11,1402,1402,0,
Skylab,9-ODA,12,11,1428,1428,0,
Skylab,9-ODA,12,11,1428,1428,0,
Skylab,9-ODA,12,11,1486,1486,0,
Skylab,9-ODA,12,11,1538,1538,0,
Skylab,9-ODA,12,11,1547,1563,16,
Skylab,9-ODA,12,11,1615,1615,0,maybe
Skylab,9-ODA,12,11,1633,1634,1,bee moves paper in to it's side - maybe hard to get to for bees!
Skylab,9-ODA,13,5,21,22,1,
Skylab,9-ODA,13,5,91,95,4,
Skylab,9-ODA,13,5,114,116,2,maybe
Skylab,9-ODA,13,5,187,188,1,
Skylab,9-ODA,13,5,237,238,1,maybe
Skylab,9-ODA,13,5,239,241,2,
Skylab,9-ODA,13,5,260,260,0,bee sniffs as it walks by maybe
Skylab,9-ODA,13,5,392,393,1,
Skylab,9-ODA,13,5,417,418,1,
Skylab,9-ODA,13,5,628,628,0,
Skylab,9-ODA,13,5,629,633,4,maybe sniffs from afar
Skylab,9-ODA,13,5,773,773,0,
Skylab,9-ODA,13,5,987,994,7,
Skylab,9-ODA,13,5,1131,1131,0,maybe
Skylab,9-ODA,13,5,1184,1184,0,
Skylab,9-ODA,13,5,1334,1334,0,
Skylab,9-ODA,13,5,1347,1347,0,touches very fast as it walks past
Skylab,9-ODA,13,5,1367,1367,0,
Skylab,9-ODA,13,5,1409,1411,2,
Skylab,9-ODA,13,5,1467,1467,0,
Skylab,9-ODA,13,5,1499,1505,6,
Skylab,9-ODA,13,5,1512,1512,0,
Skylab,9-ODA,13,5,1554,1554,0,
Skylab,9-ODA,13,5,1562,1563,1,"not actually touching, sniff from afar"
Skylab,9-ODA,13,5,1565,1567,2,
Skylab,9-ODA,13,5,1582,1590,8,
Skylab,9-ODA,13,5,1600,1604,4,
Skylab,9-ODA,13,5,1626,1626,0,
Skylab,9-ODA,13,5,1662,1679,17,"bee sort of sniffing from afar, not sure"
Skylab,9-ODA,13,5,1639,1650,11,
Skylab,9-ODA,13,5,1778,1780,2,
Skylab,9-ODA,13,5,1782,1782,0,
Skylab,9-ODA,15,10,1,2,1,
Skylab,9-ODA,15,10,9,9,0,
Skylab,9-ODA,15,10,21,23,2,
Skylab,9-ODA,15,10,33,33,0,not sure very fast touch as bee turns around
Skylab,9-ODA,15,10,101,102,1,
Skylab,9-ODA,15,10,117,118,1,
Skylab,9-ODA,15,10,185,185,0,
Skylab,9-ODA,15,10,207,207,0,
Skylab,9-ODA,15,10,211,211,0,
Skylab,9-ODA,15,10,218,219,1,
Skylab,9-ODA,15,10,292,292,0,bee sideways touches
Skylab,9-ODA,15,10,352,353,1,
Skylab,9-ODA,15,10,414,416,2,
Skylab,9-ODA,15,10,422,422,0,bee sideways touches
Skylab,9-ODA,15,10,442,442,0,
Skylab,9-ODA,15,10,478,478,0,
Skylab,9-ODA,15,10,522,524,2,
Skylab,9-ODA,15,10,539,539,0,
Skylab,9-ODA,15,10,549,551,2,
Skylab,9-ODA,15,10,619,628,9,
Skylab,9-ODA,15,10,634,635,1,
Skylab,9-ODA,15,10,661,662,1,
Skylab,9-ODA,15,10,672,676,4,
Skylab,9-ODA,15,10,679,680,1,bee walks over paper
Skylab,9-ODA,15,10,713,715,2,
Skylab,9-ODA,15,10,745,745,0,
Skylab,9-ODA,15,10,852,852,0,
Skylab,9-ODA,15,10,870,871,1,
Skylab,9-ODA,15,10,989,991,2,
Skylab,9-ODA,15,10,1028,1028,0,
Skylab,9-ODA,15,10,1033,1034,1,
Skylab,9-ODA,15,10,1144,1146,2,
Skylab,9-ODA,15,10,1171,1171,0,bee bumps paper
Skylab,9-ODA,15,10,1180,1180,0,
Skylab,9-ODA,15,10,1219,1221,2,
Skylab,9-ODA,15,10,1224,1225,1,
Skylab,9-ODA,15,10,1249,1250,1,
Skylab,9-ODA,15,10,1257,1263,6,
Skylab,9-ODA,15,10,1337,1337,0,
Skylab,9-ODA,15,10,1440,1440,0,
Skylab,9-ODA,15,10,1478,1478,0,
Skylab,9-ODA,15,10,1494,1495,1,
Skylab,9-ODA,15,10,1513,1513,0,
Skylab,9-ODA,15,10,1688,1692,4,
Skylab,9-ODA,15,10,1711,1712,1,
Skylab,9-ODA,15,10,1711,1800,89,bee a little distance from paper facing it
Skylab,9-ODA,15,10,1734,1734,0,
Skylab,9-ODA,15,10,1763,1764,1,
Skylab,9-ODA,16,10,6,9,3,
Skylab,9-ODA,16,10,63,64,1,
Skylab,9-ODA,16,10,131,134,3,
Skylab,9-ODA,16,10,158,160,2,
Skylab,9-ODA,16,10,171,173,2,
Skylab,9-ODA,16,10,391,393,2,
Skylab,9-ODA,16,10,401,403,2,
Skylab,9-ODA,16,10,445,447,2,
Skylab,9-ODA,16,10,549,550,1,
Skylab,9-ODA,16,10,610,611,1,
Skylab,9-ODA,16,10,672,672,0,
Skylab,9-ODA,16,10,739,740,1,
Skylab,9-ODA,16,10,763,763,0,
Skylab,9-ODA,16,10,942,942,0,
Skylab,9-ODA,16,10,1e3,1007,7,
Skylab,9-ODA,16,10,1031,1032,1,
Skylab,9-ODA,16,10,1168,1171,3,
Skylab,9-ODA,16,10,1340,1342,2,
Skylab,9-ODA,16,10,1375,1375,0,
Skylab,9-ODA,16,10,1418,1418,0,
Skylab,9-ODA,16,10,1523,1530,7,
Skylab,9-ODA,16,10,1574,1576,2,
Skylab,9-ODA,16,10,1586,1587,1,
Skylab,9-ODA,16,10,1604,1605,1,
Skylab,9-ODA,16,10,1723,1723,0,
Skylab,9-ODA,16,10,1755,1757,2,
Skylab,9-ODA,17,6,54,54,0,
Skylab,9-ODA,17,6,146,147,1,
Skylab,9-ODA,17,6,169,170,1,
Skylab,9-ODA,17,6,287,287,0,
Skylab,9-ODA,17,6,315,324,9,
Skylab,9-ODA,17,6,354,355,1,
Skylab,9-ODA,17,6,416,419,3,
Skylab,9-ODA,17,6,574,576,2,
Skylab,9-ODA,17,6,577,578,1,
Skylab,9-ODA,17,6,597,598,1,
Skylab,9-ODA,17,6,633,635,2,
Skylab,9-ODA,17,6,645,646,1,
Skylab,9-ODA,17,6,792,792,0,
Skylab,9-ODA,17,6,837,837,0,
Skylab,9-ODA,17,6,862,867,5,
Skylab,9-ODA,17,6,863,865,2,
Skylab,9-ODA,17,6,891,891,0,
Skylab,9-ODA,17,6,896,900,4,
Skylab,9-ODA,17,6,905,905,0,
Skylab,9-ODA,17,6,967,967,0,
Skylab,9-ODA,17,6,1081,1081,0,
Skylab,9-ODA,17,6,1087,1088,1,
Skylab,9-ODA,17,6,1125,1243,118,bee pushed in to facing the paper - sits pretty much still - does weird leg things
Skylab,9-ODA,17,6,1262,1263,1,
Skylab,9-ODA,17,6,1275,1278,3,
Skylab,9-ODA,17,6,1333,1333,0,
Skylab,9-ODA,17,6,1365,1366,1,
Skylab,9-ODA,17,6,1453,1455,2,
Skylab,9-ODA,17,6,1480,1480,0,
Skylab,9-ODA,17,6,1491,1491,0,
Skylab,9-ODA,17,6,1519,1520,1,bee sort of bumps in to paper
Skylab,9-ODA,17,6,1543,1545,2,
Skylab,9-ODA,17,6,1662,1673,11,
Skylab,9-ODA,17,6,1681,1683,2,
Skylab,9-ODA,17,6,1711,1712,1,
Skylab,HOB and HVA,1,4,0,27,27,
Skylab,HOB and HVA,1,4,3,8,5,
Skylab,HOB and HVA,1,4,13,13,0,
Skylab,HOB and HVA,1,4,31,33,2,
Skylab,HOB and HVA,1,4,37,40,3,
Skylab,HOB and HVA,1,4,67,69,2,
Skylab,HOB and HVA,1,4,67,72,5,
Skylab,HOB and HVA,1,4,75,77,2,
Skylab,HOB and HVA,1,4,78,81,3,
Skylab,HOB and HVA,1,4,86,87,1,
Skylab,HOB and HVA,1,4,89,91,2,
Skylab,HOB and HVA,1,4,101,101,0,
Skylab,HOB and HVA,1,4,106,116,10,
Skylab,HOB and HVA,1,4,133,139,6,
Skylab,HOB and HVA,1,4,140,140,0,
Skylab,HOB and HVA,1,4,159,159,0,
Skylab,HOB and HVA,1,4,163,169,6,
Skylab,HOB and HVA,1,4,171,175,4,
Skylab,HOB and HVA,1,4,174,174,0,
Skylab,HOB and HVA,1,4,181,181,0,
Skylab,HOB and HVA,1,4,191,193,2,
Skylab,HOB and HVA,1,4,213,213,0,
Skylab,HOB and HVA,1,4,215,218,3,
Skylab,HOB and HVA,1,4,478,478,0,
Skylab,HOB and HVA,1,4,488,488,0,
Skylab,HOB and HVA,1,4,566,566,0,
Skylab,HOB and HVA,1,4,584,584,0,
Skylab,HOB and HVA,1,4,602,605,3,
Skylab,HOB and HVA,1,4,633,633,0,
Skylab,HOB and HVA,1,4,702,702,0,
Skylab,HOB and HVA,1,4,803,804,1,
Skylab,HOB and HVA,1,4,923,923,0,
Skylab,HOB and HVA,1,4,925,925,0,
Skylab,HOB and HVA,1,4,951,952,1,
Skylab,HOB and HVA,1,4,950,963,13,
Skylab,HOB and HVA,1,4,1010,1017,7,
Skylab,HOB and HVA,1,4,1012,1012,0,
Skylab,HOB and HVA,1,4,1062,1066,4,
Skylab,HOB and HVA,1,4,1069,1071,2,
Skylab,HOB and HVA,1,4,1142,1142,0,
Skylab,HOB and HVA,1,4,1370,1370,0,
Skylab,HOB and HVA,1,4,1425,1425,0,
Skylab,HOB and HVA,1,4,1460,1461,1,
Skylab,HOB and HVA,1,4,1463,1463,0,
Skylab,HOB and HVA,1,4,1507,1508,1,
Skylab,HOB and HVA,1,4,1533,1533,0,
Skylab,HOB and HVA,1,4,1547,1547,0,
Skylab,HOB and HVA,1,4,1580,1582,2,
Skylab,HOB and HVA,1,4,1586,1587,1,
Skylab,HOB and HVA,1,4,1610,1632,22,
Skylab,HOB and HVA,1,4,1644,1645,1,
Skylab,HOB and HVA,1,4,1687,1687,0,
Skylab,HOB and HVA,1,4,1720,1722,2,
Skylab,HOB and HVA,1,4,1761,1773,12,
Skylab,HOB and HVA,2,4,79,79,0,
Skylab,HOB and HVA,2,4,263,268,5,
Skylab,HOB and HVA,2,4,365,365,0,
Skylab,HOB and HVA,2,4,601,602,1,
Skylab,HOB and HVA,2,4,648,649,1,
Skylab,HOB and HVA,2,4,806,806,0,
Skylab,HOB and HVA,2,4,820,820,0,
Skylab,HOB and HVA,2,4,833,834,1,
Skylab,HOB and HVA,2,4,853,853,0,
Skylab,HOB and HVA,2,4,866,866,0,
Skylab,HOB and HVA,2,4,899,900,1,
Skylab,HOB and HVA,2,4,955,955,0,
Skylab,HOB and HVA,2,4,983,983,0,
Skylab,HOB and HVA,2,4,1081,1081,0,
Skylab,HOB and HVA,2,4,1109,1109,0,
Skylab,HOB and HVA,2,4,1128,1128,0,
Skylab,HOB and HVA,2,4,1152,1152,0,
Skylab,HOB and HVA,2,4,1206,1206,0,
Skylab,HOB and HVA,2,4,1266,1266,0,
Skylab,HOB and HVA,2,4,1319,1319,0,
Skylab,HOB and HVA,2,4,1326,1329,3,
Skylab,HOB and HVA,2,4,1326,1327,1,
Skylab,HOB and HVA,2,4,1342,1344,2,
Skylab,HOB and HVA,2,4,1518,1519,1,
Skylab,HOB and HVA,2,4,1523,1524,1,
Skylab,HOB and HVA,10,4,14,15,1,
Skylab,HOB and HVA,10,4,20,20,0,
Skylab,HOB and HVA,10,4,41,47,6,
Skylab,HOB and HVA,10,4,61,71,10,
Skylab,HOB and HVA,10,4,78,81,3,
Skylab,HOB and HVA,10,4,78,83,5,
Skylab,HOB and HVA,10,4,167,167,0,
Skylab,HOB and HVA,10,4,247,248,1,
Skylab,HOB and HVA,10,4,252,281,29,
Skylab,HOB and HVA,10,4,260,304,44,
Skylab,HOB and HVA,10,4,264,268,4,
Skylab,HOB and HVA,10,4,288,290,2,
Skylab,HOB and HVA,10,4,306,308,2,
Skylab,HOB and HVA,10,4,321,334,13,
Skylab,HOB and HVA,10,4,340,341,1,
Skylab,HOB and HVA,10,4,343,345,2,
Skylab,HOB and HVA,10,4,349,353,4,
Skylab,HOB and HVA,10,4,369,376,7,
Skylab,HOB and HVA,10,4,397,397,0,
Skylab,HOB and HVA,10,4,397,669,272,
Skylab,HOB and HVA,10,4,441,441,0,
Skylab,HOB and HVA,10,4,466,472,6,
Skylab,HOB and HVA,10,4,484,623,139,
Skylab,HOB and HVA,10,4,509,512,3,
Skylab,HOB and HVA,10,4,568,569,1,
Skylab,HOB and HVA,10,4,677,679,2,
Skylab,HOB and HVA,10,4,684,684,0,
Skylab,HOB and HVA,10,4,685,685,0,
Skylab,HOB and HVA,10,4,683,698,15,
Skylab,HOB and HVA,10,4,698,701,3,
Skylab,HOB and HVA,10,4,717,719,2,
Skylab,HOB and HVA,10,4,730,750,20,
Skylab,HOB and HVA,10,4,733,735,2,
Skylab,HOB and HVA,10,4,757,759,2,
Skylab,HOB and HVA,10,4,781,782,1,
Skylab,HOB and HVA,10,4,788,789,1,
Skylab,HOB and HVA,10,4,791,791,0,
Skylab,HOB and HVA,10,4,798,798,0,
Skylab,HOB and HVA,10,4,844,845,1,
Skylab,HOB and HVA,10,4,847,847,0,
Skylab,HOB and HVA,10,4,873,874,1,
Skylab,HOB and HVA,10,4,908,917,9,
Skylab,HOB and HVA,10,4,924,951,27,
Skylab,HOB and HVA,10,4,957,957,0,
Skylab,HOB and HVA,10,4,981,1017,36,maybe - not touching but seems interrested
Skylab,HOB and HVA,10,4,1046,1050,4,
Skylab,HOB and HVA,10,4,1056,1075,19,
Skylab,HOB and HVA,10,4,1063,1065,2,
Skylab,HOB and HVA,10,4,1074,1075,1,
Skylab,HOB and HVA,10,4,1085,1129,44,
Skylab,HOB and HVA,10,4,1094,1096,2,
Skylab,HOB and HVA,10,4,1129,1130,1,
Skylab,HOB and HVA,10,4,1137,1147,10,
Skylab,HOB and HVA,10,4,1157,1157,0,
Skylab,HOB and HVA,10,4,1179,1179,0,
Skylab,HOB and HVA,10,4,1186,1186,0,
Skylab,HOB and HVA,10,4,1214,1214,0,
Skylab,HOB and HVA,10,4,1222,1486,264,
Skylab,HOB and HVA,10,4,1295,1297,2,
Skylab,HOB and HVA,10,4,1305,1305,0,
Skylab,HOB and HVA,10,4,1335,1343,8,
Skylab,HOB and HVA,10,4,1355,1359,4,
Skylab,HOB and HVA,10,4,1375,1376,1,
Skylab,HOB and HVA,10,4,1380,1384,4,
Skylab,HOB and HVA,10,4,1435,1436,1,
Skylab,HOB and HVA,10,4,1508,1513,5,
Skylab,HOB and HVA,10,4,1521,1524,3,
Skylab,HOB and HVA,10,4,1532,1537,5,
Skylab,HOB and HVA,10,4,1537,1697,160,
Skylab,HOB and HVA,10,4,1559,1561,2,
Skylab,HOB and HVA,10,4,1575,1578,3,
Skylab,HOB and HVA,10,4,1578,1579,1,
Skylab,HOB and HVA,10,4,1579,1582,3,
Skylab,HOB and HVA,10,4,1598,1599,1,
Skylab,HOB and HVA,10,4,1604,1610,6,
Skylab,HOB and HVA,10,4,1700,1700,0,
Skylab,HOB and HVA,10,4,1718,1721,3,
Skylab,HOB and HVA,10,4,1725,1729,4,
Skylab,HOB and HVA,10,4,1726,1728,2,
Skylab,HOB and HVA,10,4,1731,1732,1,
Skylab,HOB and HVA,10,4,1738,1740,2,
Skylab,HOB and HVA,10,4,1754,1757,3,bee sort of sniffs from afar
Skylab,HOB and HVA,10,4,1762,1763,1,
Skylab,HOB and HVA,13,2,1,2,1,
Skylab,HOB and HVA,13,2,316,316,0,"turns around near paper, not sure if it counts (actually think it dosen't)"
Skylab,HOB and HVA,13,2,386,388,2,
Skylab,HOB and HVA,13,2,389,390,1,
Skylab,HOB and HVA,13,2,396,398,2,
Skylab,HOB and HVA,13,2,429,431,2,bee sniffs from afar
Skylab,HOB and HVA,13,2,457,460,3,
Skylab,HOB and HVA,13,2,513,513,0,
Skylab,HOB and HVA,13,2,528,528,0,maybe - not super sure not actually touching
Skylab,HOB and HVA,13,2,832,832,0,
Skylab,HOB and HVA,13,2,836,836,0,
Skylab,HOB and HVA,13,2,954,954,0,maybe - not super sure not actually touching
Skylab,HOB and HVA,13,2,956,957,1,
Skylab,HOB and HVA,13,2,954,956,2,
Skylab,HOB and HVA,13,2,1047,1047,0,
Skylab,HOB and HVA,13,2,1061,1062,1,
Skylab,HOB and HVA,13,2,1162,1167,5,
Skylab,HOB and HVA,13,2,1185,1185,0,
Skylab,HOB and HVA,13,2,1279,1279,0,
Skylab,HOB and HVA,13,2,1321,1321,0,
Skylab,HOB and HVA,13,2,1443,1443,0,
Skylab,HOB and HVA,13,2,1447,1448,1,
Skylab,HOB and HVA,13,2,1464,1465,1,
Skylab,HOB and HVA,13,2,1483,1483,0,
Skylab,HOB and HVA,13,2,1518,1596,78,bee sort of sits motionless facing paper very close to it
Skylab,HOB and HVA,13,2,1566,1568,2,
Skylab,HOB and HVA,13,2,1584,1585,1,bee sideways touches paper
Skylab,HOB and HVA,13,2,1589,1590,1,
Skylab,HOB and HVA,13,2,1711,1713,2,
Skylab,HOB and HVA,13,2,1799,1800,1,
Skylab,HOB and HVA,15,7,64,66,2,
Skylab,HOB and HVA,15,7,166,168,2,
Skylab,HOB and HVA,15,7,267,271,4,
Skylab,HOB and HVA,15,7,288,289,1,
Skylab,HOB and HVA,15,7,294,295,1,
Skylab,HOB and HVA,15,7,385,385,0,
Skylab,HOB and HVA,15,7,465,465,0,not super sure it sniffs from afar
Skylab,HOB and HVA,15,7,508,509,1,
Skylab,HOB and HVA,15,7,530,530,0,
Skylab,HOB and HVA,15,7,564,564,0,
Skylab,HOB and HVA,15,7,611,611,0,
Skylab,HOB and HVA,15,7,680,683,3,
Skylab,HOB and HVA,15,7,743,745,2,
Skylab,HOB and HVA,15,7,965,965,0,bee bumps in to paper
Skylab,HOB and HVA,15,7,976,979,3,
Skylab,HOB and HVA,15,7,985,985,0,
Skylab,HOB and HVA,15,7,1022,1022,0,
Skylab,HOB and HVA,15,7,1028,1028,0,
Skylab,HOB and HVA,15,7,1051,1052,1,
Skylab,HOB and HVA,15,7,1078,1078,0,
Skylab,HOB and HVA,15,7,1092,1093,1,
Skylab,HOB and HVA,15,7,1110,1110,0,
Skylab,HOB and HVA,15,7,1137,1139,2,
Skylab,HOB and HVA,15,7,1168,1170,2,
Skylab,HOB and HVA,15,7,1210,1210,0,
Skylab,HOB and HVA,15,7,622,624,2,
Skylab,HOB and HVA,15,7,1231,1233,2,
Skylab,HOB and HVA,15,7,1240,1246,6,
Skylab,HOB and HVA,15,7,1263,1263,0,
Skylab,HOB and HVA,15,7,1287,1287,0,
Skylab,HOB and HVA,15,7,1303,1310,7,
Skylab,HOB and HVA,15,7,1311,1312,1,
Skylab,HOB and HVA,15,7,1325,1327,2,
Skylab,HOB and HVA,15,7,1330,1330,0,
Skylab,HOB and HVA,15,7,1401,1402,1,
Skylab,HOB and HVA,15,7,1401,1402,1,
Skylab,HOB and HVA,15,7,1429,1432,3,
Skylab,HOB and HVA,15,7,1467,1468,1,
Skylab,HOB and HVA,15,7,1470,1470,0,
Skylab,HOB and HVA,15,7,1518,1518,0,
Skylab,HOB and HVA,15,7,1588,1589,1,
Skylab,HOB and HVA,15,7,1603,1605,2,
Skylab,HOB and HVA,15,7,1684,1684,0,
Skylab,HOB and HVA,15,7,1693,1698,5,bee faces paper from afar - honestly not too sure why i'm recording this - think it dosen't count
Skylab,HOB and HVA,16,11,44,46,2,
Skylab,HOB and HVA,16,11,63,65,2,
Skylab,HOB and HVA,16,11,170,170,0,
Skylab,HOB and HVA,16,11,170,172,2,
Skylab,HOB and HVA,16,11,287,289,2,
Skylab,HOB and HVA,16,11,419,420,1,
Skylab,HOB and HVA,16,11,479,482,3,bee sort of sniffs from afar
Skylab,HOB and HVA,16,11,496,498,2,bee sort of sniffs from afar
Skylab,HOB and HVA,16,11,624,626,2,
Skylab,HOB and HVA,16,11,713,713,0,
Skylab,HOB and HVA,16,11,794,794,0,
Skylab,HOB and HVA,16,11,800,804,4,
Skylab,HOB and HVA,16,11,835,835,0,
Skylab,HOB and HVA,16,11,857,859,2,
Skylab,HOB and HVA,16,11,1193,1194,1,
Skylab,HOB and HVA,16,11,1196,1197,1,
Skylab,HOB and HVA,16,11,1443,1443,0,
Skylab,HOB and HVA,16,11,1539,1540,1,
Skylab,HOB and HVA,16,11,1617,1617,0,
Skylab,HOB and HVA,16,11,1782,1782,0,
Skylab,HOB and HVA,17,11,77,77,0,
Skylab,HOB and HVA,17,11,91,92,1,
Skylab,HOB and HVA,17,11,123,125,2,
Skylab,HOB and HVA,17,11,140,140,0,
Skylab,HOB and HVA,17,11,168,168,0,
Skylab,HOB and HVA,17,11,328,328,0,
Skylab,HOB and HVA,17,11,407,409,2,
Skylab,HOB and HVA,17,11,464,464,0,
Skylab,HOB and HVA,17,11,540,540,0,
Skylab,HOB and HVA,17,11,631,631,0,bee touches as it walks by. not sure if it counts
Skylab,HOB and HVA,17,11,639,1839,1200,bee touches as it walks by. not sure if it counts
Skylab,HOB and HVA,17,11,641,641,0,
Skylab,HOB and HVA,17,11,684,684,0,
Skylab,HOB and HVA,17,11,703,704,1,
Skylab,HOB and HVA,17,11,735,737,2,
Skylab,HOB and HVA,17,11,735,739,4,
Skylab,HOB and HVA,17,11,779,779,0,
Skylab,HOB and HVA,17,11,791,791,0,
Skylab,HOB and HVA,17,11,797,799,2,
Skylab,HOB and HVA,17,11,804,805,1,
Skylab,HOB and HVA,17,11,874,878,4,
Skylab,HOB and HVA,17,11,945,945,0,
Skylab,HOB and HVA,17,11,948,949,1,
Skylab,HOB and HVA,17,11,1020,1023,3,
Skylab,HOB and HVA,17,11,1038,1038,0,
Skylab,HOB and HVA,17,11,1110,1111,1,maybe - a little far from the paper
Skylab,HOB and HVA,17,11,1151,1152,1,
Skylab,HOB and HVA,17,11,1255,1255,0,not sure - could just be bee bumping in to paper
Skylab,HOB and HVA,17,11,1322,1324,2,
Skylab,HOB and HVA,17,11,1343,1346,3,
Skylab,HOB and HVA,17,11,1385,1385,0,
Skylab,HOB and HVA,17,11,1401,1401,0,
Skylab,HOB and HVA,17,11,1424,1427,3,bee motionless facing paper quite close but not touching
Skylab,HOB and HVA,17,11,1447,1447,0,maybe an accidental bump
Skylab,HOB and HVA,17,11,1518,1518,0,
Skylab,HOB and HVA,17,11,1544,1544,0,not quite sure
Skylab,HOB and HVA,17,11,1639,1639,0,
Skylab,HOB and HVA,17,11,1651,1656,5,
Skylab,HOB and HVA,17,11,1659,1667,8,bee walks over part of paper
Skylab,HOB and HVA,17,11,1676,1678,2,
Skylab,HOB and HVA,17,11,1748,1749,1,
Skylab,9-HDA and HOB,1,6,75,76,1,
Skylab,9-HDA and HOB,1,6,89,89,0,
Skylab,9-HDA and HOB,1,6,93,94,1,
Skylab,9-HDA and HOB,1,6,111,113,2,
Skylab,9-HDA and HOB,1,6,113,114,1,
Skylab,9-HDA and HOB,1,6,134,134,0,
Skylab,9-HDA and HOB,1,6,174,174,0,
Skylab,9-HDA and HOB,1,6,170,170,0,
Skylab,9-HDA and HOB,1,6,192,193,1,
Skylab,9-HDA and HOB,1,6,210,210,0,
Skylab,9-HDA and HOB,1,6,216,216,0,
Skylab,9-HDA and HOB,1,6,248,250,2,
Skylab,9-HDA and HOB,1,6,252,256,4,
Skylab,9-HDA and HOB,1,6,284,284,0,
Skylab,9-HDA and HOB,1,6,305,306,1,
Skylab,9-HDA and HOB,1,6,337,337,0,
Skylab,9-HDA and HOB,1,6,442,442,0,
Skylab,9-HDA and HOB,1,6,476,476,0,
Skylab,9-HDA and HOB,1,6,503,503,0,
Skylab,9-HDA and HOB,1,6,517,517,0,
Skylab,9-HDA and HOB,1,6,533,533,0,
Skylab,9-HDA and HOB,1,6,565,565,0,
Skylab,9-HDA and HOB,1,6,584,585,1,
Skylab,9-HDA and HOB,1,6,608,609,1,
Skylab,9-HDA and HOB,1,6,638,639,1,
Skylab,9-HDA and HOB,1,6,639,642,3,
Skylab,9-HDA and HOB,1,6,664,668,4,
Skylab,9-HDA and HOB,1,6,792,792,0,
Skylab,9-HDA and HOB,1,6,795,795,0,
Skylab,9-HDA and HOB,1,6,817,817,0,
Skylab,9-HDA and HOB,1,6,865,865,0,
Skylab,9-HDA and HOB,1,6,876,876,0,
Skylab,9-HDA and HOB,1,6,908,908,0,
Skylab,9-HDA and HOB,1,6,917,917,0,
Skylab,9-HDA and HOB,1,6,973,981,8,
Skylab,9-HDA and HOB,1,6,994,1001,7,
Skylab,9-HDA and HOB,1,6,1056,1056,0,
Skylab,9-HDA and HOB,1,6,1120,1120,0,
Skylab,9-HDA and HOB,1,6,1124,1125,1,
Skylab,9-HDA and HOB,1,6,1152,1153,1,
Skylab,9-HDA and HOB,1,6,1232,1232,0,
Skylab,9-HDA and HOB,1,6,1271,1271,0,
Skylab,9-HDA and HOB,1,6,1363,1366,3,
Skylab,9-HDA and HOB,1,6,1390,1390,0,
Skylab,9-HDA and HOB,1,6,1399,1404,5,
Skylab,9-HDA and HOB,1,6,1424,1428,4,
Skylab,9-HDA and HOB,1,6,1468,1468,0,
Skylab,9-HDA and HOB,1,6,1499,1503,4,
Skylab,9-HDA and HOB,1,6,1516,1517,1,
Skylab,9-HDA and HOB,1,6,1575,1576,1,
Skylab,9-HDA and HOB,1,6,1675,1678,3,
Skylab,9-HDA and HOB,1,6,1708,1712,4,
Skylab,9-HDA and HOB,1,6,1716,1720,4,
Skylab,9-HDA and HOB,1,6,1743,1743,0,
Skylab,9-HDA and HOB,2,6,6,7,1,
Skylab,9-HDA and HOB,2,6,49,56,7,
Skylab,9-HDA and HOB,2,6,137,137,0,
Skylab,9-HDA and HOB,2,6,177,177,0,
Skylab,9-HDA and HOB,2,6,275,276,1,bee sniffs not quite touching
Skylab,9-HDA and HOB,2,6,282,283,1,
Skylab,9-HDA and HOB,2,6,322,324,2,
Skylab,9-HDA and HOB,2,6,405,408,3,
Skylab,9-HDA and HOB,2,6,441,441,0,
Skylab,9-HDA and HOB,2,6,673,675,2,
Skylab,9-HDA and HOB,2,6,673,676,3,
Skylab,9-HDA and HOB,2,6,697,697,0,
Skylab,9-HDA and HOB,2,6,711,711,0,
Skylab,9-HDA and HOB,2,6,719,719,0,
Skylab,9-HDA and HOB,2,6,771,774,3,
Skylab,9-HDA and HOB,2,6,791,791,0,
Skylab,9-HDA and HOB,2,6,793,794,1,
Skylab,9-HDA and HOB,2,6,801,801,0,
Skylab,9-HDA and HOB,2,6,814,814,0,
Skylab,9-HDA and HOB,2,6,907,907,0,
Skylab,9-HDA and HOB,2,6,950,951,1,
Skylab,9-HDA and HOB,2,6,956,956,0,
Skylab,9-HDA and HOB,2,6,1030,1030,0,
Skylab,9-HDA and HOB,2,6,1048,1048,0,
Skylab,9-HDA and HOB,2,6,1083,1083,0,
Skylab,9-HDA and HOB,2,6,1153,1153,0,
Skylab,9-HDA and HOB,2,6,1164,1164,0,
Skylab,9-HDA and HOB,2,6,1280,1294,14,
Skylab,9-HDA and HOB,2,6,1324,1325,1,
Skylab,9-HDA and HOB,2,6,1332,1337,5,bee crawling on top of paper
Skylab,9-HDA and HOB,2,6,1342,1344,2,bee crawling on top of paper
Skylab,9-HDA and HOB,2,6,1356,1359,3,
Skylab,9-HDA and HOB,2,6,1356,1359,3,
Skylab,9-HDA and HOB,2,6,1361,1367,6,
Skylab,9-HDA and HOB,2,6,1372,1373,1,
Skylab,9-HDA and HOB,2,6,1386,1387,1,bee crawling on top of paper
Skylab,9-HDA and HOB,2,6,1416,1490,74,
Skylab,9-HDA and HOB,2,6,1419,1420,1,
Skylab,9-HDA and HOB,2,6,1420,1421,1,
Skylab,9-HDA and HOB,2,6,1440,1441,1,
Skylab,9-HDA and HOB,2,6,1469,1474,5,
Skylab,9-HDA and HOB,2,6,1477,1480,3,
Skylab,9-HDA and HOB,2,6,1492,1494,2,
Skylab,9-HDA and HOB,2,6,1495,1497,2,
Skylab,9-HDA and HOB,2,6,1523,1528,5,
Skylab,9-HDA and HOB,2,6,1544,1545,1,bee crawling on top of paper
Skylab,9-HDA and HOB,2,6,1545,1546,1,
Skylab,9-HDA and HOB,2,6,1587,1588,1,
Skylab,9-HDA and HOB,2,6,1615,1621,6,bee seems to be paying attwntion to othr bee but it is still on paper
Skylab,9-HDA and HOB,2,6,1629,1642,13,
Skylab,9-HDA and HOB,2,6,1742,1744,2,
Skylab,9-HDA and HOB,2,6,1743,1746,3,
Skylab,9-HDA and HOB,2,6,1750,1753,3,
Skylab,9-HDA and HOB,2,6,1758,1760,2,
Skylab,9-HDA and HOB,2,6,1774,1778,4,
Skylab,9-HDA and HOB,3,8,3,4,1,
Skylab,9-HDA and HOB,3,8,75,79,4,
Skylab,9-HDA and HOB,3,8,119,125,6,
Skylab,9-HDA and HOB,3,8,168,168,0,
Skylab,9-HDA and HOB,3,8,232,233,1,
Skylab,9-HDA and HOB,3,8,269,269,0,
Skylab,9-HDA and HOB,3,8,337,337,0,
Skylab,9-HDA and HOB,3,8,444,444,0,
Skylab,9-HDA and HOB,3,8,493,494,1,
Skylab,9-HDA and HOB,3,8,509,514,5,
Skylab,9-HDA and HOB,3,8,525,530,5,
Skylab,9-HDA and HOB,3,8,534,538,4,
Skylab,9-HDA and HOB,3,8,560,562,2,
Skylab,9-HDA and HOB,3,8,571,586,15,
Skylab,9-HDA and HOB,3,8,602,603,1,
Skylab,9-HDA and HOB,3,8,612,613,1,
Skylab,9-HDA and HOB,3,8,639,640,1,
Skylab,9-HDA and HOB,3,8,716,718,2,
Skylab,9-HDA and HOB,3,8,733,733,0,
Skylab,9-HDA and HOB,3,8,736,736,0,
Skylab,9-HDA and HOB,3,8,836,837,1,
Skylab,9-HDA and HOB,3,8,918,918,0,
Skylab,9-HDA and HOB,3,8,973,973,0,
Skylab,9-HDA and HOB,3,8,989,989,0,
Skylab,9-HDA and HOB,3,8,1003,1003,0,
Skylab,9-HDA and HOB,3,8,1023,1023,0,
Skylab,9-HDA and HOB,3,8,1023,1024,1,
Skylab,9-HDA and HOB,3,8,1051,1053,2,
Skylab,9-HDA and HOB,3,8,1076,1077,1,
Skylab,9-HDA and HOB,3,8,1094,1096,2,
Skylab,9-HDA and HOB,3,8,1166,1166,0,
Skylab,9-HDA and HOB,3,8,1211,1211,0,
Skylab,9-HDA and HOB,3,8,1264,1264,0,
Skylab,9-HDA and HOB,3,8,1301,1301,0,
Skylab,9-HDA and HOB,3,8,1309,1311,2,
Skylab,9-HDA and HOB,3,8,1330,1338,8,
Skylab,9-HDA and HOB,3,8,1342,1349,7,
Skylab,9-HDA and HOB,3,8,1357,1382,25,
Skylab,9-HDA and HOB,3,8,1397,1404,7,
Skylab,9-HDA and HOB,3,8,1425,1426,1,
Skylab,9-HDA and HOB,3,8,1445,1456,11,
Skylab,9-HDA and HOB,3,8,1477,1478,1,
Skylab,9-HDA and HOB,3,8,1502,1502,0,
Skylab,9-HDA and HOB,3,8,1535,1535,0,
Skylab,9-HDA and HOB,3,8,1563,1565,2,
Skylab,9-HDA and HOB,3,8,1617,1619,2,
Skylab,9-HDA and HOB,3,8,1631,1633,2,
Skylab,9-HDA and HOB,3,8,1660,1662,2,
Skylab,9-HDA and HOB,3,8,1662,1662,0,
Skylab,9-HDA and HOB,3,8,1671,1671,0,
Skylab,9-HDA and HOB,3,8,1706,1706,0,
Skylab,9-HDA and HOB,3,8,1772,1773,1,
Skylab,9-HDA and HOB,3,8,1789,1789,0,
Skylab,9-HDA and HOB,3,8,1789,1789,0,
Skylab,9-HDA and HOB,3,8,1797,1797,0,
Skylab,9-HDA and HOB,10,6,17,25,8,
Skylab,9-HDA and HOB,10,6,51,51,0,
Skylab,9-HDA and HOB,10,6,78,97,19,
Skylab,9-HDA and HOB,10,6,85,87,2,
Skylab,9-HDA and HOB,10,6,127,130,3,
Skylab,9-HDA and HOB,10,6,152,152,0,sniff from afar
Skylab,9-HDA and HOB,10,6,177,181,4,
Skylab,9-HDA and HOB,10,6,185,186,1,
Skylab,9-HDA and HOB,10,6,192,192,0,
Skylab,9-HDA and HOB,10,6,234,234,0,
Skylab,9-HDA and HOB,10,6,240,241,1,
Skylab,9-HDA and HOB,10,6,249,262,13,
Skylab,9-HDA and HOB,10,6,281,281,0,
Skylab,9-HDA and HOB,10,6,288,289,1,
Skylab,9-HDA and HOB,10,6,305,305,0,
Skylab,9-HDA and HOB,10,6,361,365,4,
Skylab,9-HDA and HOB,10,6,384,405,21,
Skylab,9-HDA and HOB,10,6,423,424,1,
Skylab,9-HDA and HOB,10,6,457,463,6,
Skylab,9-HDA and HOB,10,6,462,480,18,
Skylab,9-HDA and HOB,10,6,483,489,6,
Skylab,9-HDA and HOB,10,6,538,540,2,
Skylab,9-HDA and HOB,10,6,564,566,2,
Skylab,9-HDA and HOB,10,6,601,601,0,
Skylab,9-HDA and HOB,10,6,604,604,0,
Skylab,9-HDA and HOB,10,6,619,628,9,
Skylab,9-HDA and HOB,10,6,642,650,8,
Skylab,9-HDA and HOB,10,6,644,644,0,
Skylab,9-HDA and HOB,10,6,673,677,4,
Skylab,9-HDA and HOB,10,6,680,683,3,
Skylab,9-HDA and HOB,10,6,701,702,1,
Skylab,9-HDA and HOB,10,6,716,716,0,
Skylab,9-HDA and HOB,10,6,726,726,0,
Skylab,9-HDA and HOB,10,6,830,832,2,
Skylab,9-HDA and HOB,10,6,934,935,1,
Skylab,9-HDA and HOB,10,6,949,952,3,
Skylab,9-HDA and HOB,10,6,969,980,11,
Skylab,9-HDA and HOB,10,6,992,994,2,
Skylab,9-HDA and HOB,10,6,1012,1012,0,
Skylab,9-HDA and HOB,10,6,953,1040,87,
Skylab,9-HDA and HOB,10,6,1028,1040,12,
Skylab,9-HDA and HOB,10,6,1034,1037,3,
Skylab,9-HDA and HOB,10,6,1042,1049,7,
Skylab,9-HDA and HOB,10,6,1076,1082,6,
Skylab,9-HDA and HOB,10,6,1107,1112,5,
Skylab,9-HDA and HOB,10,6,1149,1150,1,
Skylab,9-HDA and HOB,10,6,1152,1153,1,
Skylab,9-HDA and HOB,10,6,1163,1172,9,
Skylab,9-HDA and HOB,10,6,1164,1179,15,
Skylab,9-HDA and HOB,10,6,1166,1169,3,
Skylab,9-HDA and HOB,10,6,1181,1183,2,
Skylab,9-HDA and HOB,10,6,1245,1257,12,
Skylab,9-HDA and HOB,10,6,1245,1261,16,
Skylab,9-HDA and HOB,10,6,1272,1273,1,
Skylab,9-HDA and HOB,10,6,1276,1280,4,
Skylab,9-HDA and HOB,10,6,1283,1284,1,
Skylab,9-HDA and HOB,10,6,1286,1296,10,
Skylab,9-HDA and HOB,10,6,1301,1317,16,
Skylab,9-HDA and HOB,10,6,1308,1319,11,
Skylab,9-HDA and HOB,10,6,1318,1323,5,
Skylab,9-HDA and HOB,10,6,1346,1348,2,
Skylab,9-HDA and HOB,10,6,1349,1351,2,
Skylab,9-HDA and HOB,10,6,1391,1391,0,
Skylab,9-HDA and HOB,10,6,1393,1395,2,
Skylab,9-HDA and HOB,10,6,1396,1400,4,
Skylab,9-HDA and HOB,10,6,1400,1400,0,
Skylab,9-HDA and HOB,10,6,1405,1408,3,
Skylab,9-HDA and HOB,10,6,1411,1482,71,
Skylab,9-HDA and HOB,10,6,1418,1419,1,
Skylab,9-HDA and HOB,10,6,1480,1482,2,
Skylab,9-HDA and HOB,10,6,1424,1424,0,
Skylab,9-HDA and HOB,10,6,1426,1487,61,
Skylab,9-HDA and HOB,10,6,1447,1451,4,
Skylab,9-HDA and HOB,10,6,1464,1464,0,
Skylab,9-HDA and HOB,10,6,1487,1487,0,
Skylab,9-HDA and HOB,10,6,1489,1491,2,
Skylab,9-HDA and HOB,10,6,1497,1497,0,
Skylab,9-HDA and HOB,10,6,1516,1517,1,
Skylab,9-HDA and HOB,10,6,1518,1518,0,
Skylab,9-HDA and HOB,10,6,1534,1534,0,
Skylab,9-HDA and HOB,10,6,1543,1543,0,
Skylab,9-HDA and HOB,10,6,1626,1629,3,
Skylab,9-HDA and HOB,10,6,1683,1683,0,
Skylab,9-HDA and HOB,10,6,1710,1710,0,
Skylab,9-HDA and HOB,10,6,1722,1723,1,
Skylab,9-HDA and HOB,10,6,1729,1731,2,
Skylab,9-HDA and HOB,10,6,1740,1740,0,
Skylab,9-HDA and HOB,10,6,1745,1748,3,
Skylab,9-HDA and HOB,10,6,1760,1760,0,
Skylab,9-HDA and HOB,10,6,1765,1767,2,
Skylab,9-HDA and HOB,10,6,1768,1773,5,
Skylab,9-HDA and HOB,10,6,1773,1773,0,
Skylab,9-HDA and HOB,10,6,1784,1796,12,
Skylab,9-HDA and HOB,10,6,1790,1792,2,
Skylab,9-HDA and HOB,13,10,0,2,2,
Skylab,9-HDA and HOB,13,10,30,30,0,
Skylab,9-HDA and HOB,13,10,53,57,4,
Skylab,9-HDA and HOB,13,10,70,72,2,
Skylab,9-HDA and HOB,13,10,92,94,2,
Skylab,9-HDA and HOB,13,10,176,176,0,
Skylab,9-HDA and HOB,13,10,207,208,1,
Skylab,9-HDA and HOB,13,10,328,328,0,
Skylab,9-HDA and HOB,13,10,382,384,2,
Skylab,9-HDA and HOB,13,10,453,454,1,
Skylab,9-HDA and HOB,13,10,566,566,0,"bee touches very fast, not sure if it counts really"
Skylab,9-HDA and HOB,13,10,607,609,2,
Skylab,9-HDA and HOB,13,10,629,629,0,
Skylab,9-HDA and HOB,13,10,741,741,0,"bee touches very fast, not sure if it counts really"
Skylab,9-HDA and HOB,13,10,851,854,3,
Skylab,9-HDA and HOB,13,10,874,885,11,
Skylab,9-HDA and HOB,13,10,876,876,0,
Skylab,9-HDA and HOB,13,10,887,889,2,
Skylab,9-HDA and HOB,13,10,962,963,1,
Skylab,9-HDA and HOB,13,10,978,978,0,
Skylab,9-HDA and HOB,13,10,982,985,3,
Skylab,9-HDA and HOB,13,10,993,997,4,
Skylab,9-HDA and HOB,13,10,999,1e3,1,
Skylab,9-HDA and HOB,13,10,1009,1009,0,
Skylab,9-HDA and HOB,13,10,1052,1055,3,
Skylab,9-HDA and HOB,13,10,1088,1088,0,
Skylab,9-HDA and HOB,13,10,1129,1129,0,
Skylab,9-HDA and HOB,13,10,1157,1157,0,
Skylab,9-HDA and HOB,13,10,1206,1206,0,
Skylab,9-HDA and HOB,13,10,1293,1293,0,
Skylab,9-HDA and HOB,13,10,1376,1376,0,
Skylab,9-HDA and HOB,13,10,1400,1410,10,
Skylab,9-HDA and HOB,13,10,1533,1533,0,
Skylab,9-HDA and HOB,13,10,1539,1539,0,
Skylab,9-HDA and HOB,13,10,1566,1566,0,
Skylab,9-HDA and HOB,13,10,1606,1607,1,
Skylab,9-HDA and HOB,13,10,1556,1617,61,
Skylab,9-HDA and HOB,13,10,1698,1705,7,
Skylab,9-HDA and HOB,13,10,1710,1714,4,
Skylab,9-HDA and HOB,13,10,1718,1730,12,
Skylab,9-HDA and HOB,13,10,1737,1737,0,
Skylab,9-HDA and HOB,13,10,1745,1787,42,
Skylab,9-HDA and HOB,15,6,30,30,0,
Skylab,9-HDA and HOB,15,6,78,79,1,
Skylab,9-HDA and HOB,15,6,113,113,0,
Skylab,9-HDA and HOB,15,6,133,134,1,
Skylab,9-HDA and HOB,15,6,192,192,0,
Skylab,9-HDA and HOB,15,6,196,198,2,
Skylab,9-HDA and HOB,15,6,233,234,1,
Skylab,9-HDA and HOB,15,6,244,244,0,
Skylab,9-HDA and HOB,15,6,254,256,2,
Skylab,9-HDA and HOB,15,6,286,289,3,4:53 it sits on the paper and does nothing for a bit
Skylab,9-HDA and HOB,15,6,294,295,1,
Skylab,9-HDA and HOB,15,6,302,306,4,
Skylab,9-HDA and HOB,15,6,310,312,2,
Skylab,9-HDA and HOB,15,6,329,329,0,
Skylab,9-HDA and HOB,15,6,373,375,2,
Skylab,9-HDA and HOB,15,6,393,393,0,
Skylab,9-HDA and HOB,15,6,408,408,0,
Skylab,9-HDA and HOB,15,6,455,455,0,
Skylab,9-HDA and HOB,15,6,561,565,4,
Skylab,9-HDA and HOB,15,6,613,615,2,
Skylab,9-HDA and HOB,15,6,660,660,0,
Skylab,9-HDA and HOB,15,6,890,890,0,
Skylab,9-HDA and HOB,15,6,992,994,2,
Skylab,9-HDA and HOB,15,6,1070,1073,3,
Skylab,9-HDA and HOB,15,6,1079,1080,1,
Skylab,9-HDA and HOB,15,6,1092,1092,0,maybe - fast touch as it walks past
Skylab,9-HDA and HOB,15,6,1182,1185,3,19:50 bee sits on top of paper until
Skylab,9-HDA and HOB,15,6,1199,1202,3,
Skylab,9-HDA and HOB,15,6,1225,1232,7,
Skylab,9-HDA and HOB,15,6,1324,1326,2,
Skylab,9-HDA and HOB,15,6,1423,1424,1,
Skylab,9-HDA and HOB,15,6,1433,1441,8,
Skylab,9-HDA and HOB,15,6,1467,1473,6,
Skylab,9-HDA and HOB,15,6,1697,1700,3,
Skylab,9-HDA and HOB,15,6,1707,1709,2,
Skylab,9-HDA and HOB,15,6,1749,1750,1,
Skylab,9-HDA and HOB,16,4,48,48,0,
Skylab,9-HDA and HOB,16,4,237,240,3,
Skylab,9-HDA and HOB,16,4,239,240,1,
Skylab,9-HDA and HOB,16,4,279,279,0,
Skylab,9-HDA and HOB,16,4,280,280,0,
Skylab,9-HDA and HOB,16,4,372,372,0,
Skylab,9-HDA and HOB,17,3,21,21,0,
Skylab,9-HDA and HOB,17,3,26,26,0,
Skylab,9-HDA and HOB,17,3,37,37,0,
Skylab,9-HDA and HOB,17,3,47,47,0,
Skylab,9-HDA and HOB,17,3,60,60,0,
Skylab,9-HDA and HOB,17,3,101,103,2,
Skylab,9-HDA and HOB,17,3,164,164,0,
Skylab,9-HDA and HOB,17,3,200,202,2,
Skylab,9-HDA and HOB,17,3,284,285,1,
Skylab,9-HDA and HOB,17,3,286,290,4,
Skylab,9-HDA and HOB,17,3,317,318,1,
Skylab,9-HDA and HOB,17,3,360,364,4,
Skylab,9-HDA and HOB,17,3,404,404,0,
Skylab,9-HDA and HOB,17,3,415,415,0,
Skylab,9-HDA and HOB,17,3,427,427,0,
Skylab,9-HDA and HOB,17,3,444,447,3,
Skylab,9-HDA and HOB,17,3,473,473,0,
Skylab,9-HDA and HOB,17,3,566,566,0,
Skylab,9-HDA and HOB,17,3,599,599,0,
Skylab,9-HDA and HOB,17,3,611,611,0,
Skylab,9-HDA and HOB,17,3,690,690,0,
Skylab,9-HDA and HOB,17,3,775,786,11,
Skylab,9-HDA and HOB,17,3,788,788,0,
Skylab,9-HDA and HOB,17,3,801,809,8,
Skylab,9-HDA and HOB,17,3,822,822,0,
Skylab,9-HDA and HOB,17,3,893,894,1,
Skylab,9-HDA and HOB,17,3,899,921,22,"bee sort of faces the paper, mostly motionless"
Skylab,9-HDA and HOB,17,3,931,933,2,
Skylab,9-HDA and HOB,17,3,948,949,1,
Skylab,9-HDA and HOB,17,3,954,955,1,
Skylab,9-HDA and HOB,17,3,966,967,1,
Skylab,9-HDA and HOB,17,3,980,984,4,
Skylab,9-HDA and HOB,17,3,986,986,0,
Skylab,9-HDA and HOB,17,3,1021,1021,0,not too sure
Skylab,9-HDA and HOB,17,3,1049,1051,2,
Skylab,9-HDA and HOB,17,3,1122,1137,15,
Skylab,9-HDA and HOB,17,3,1146,1194,48,
Skylab,9-HDA and HOB,17,3,1217,1218,1,
Skylab,9-HDA and HOB,17,3,1244,1246,2,
Skylab,9-HDA and HOB,17,3,1256,1265,9,
Skylab,9-HDA and HOB,17,3,1275,1282,7,
Skylab,9-HDA and HOB,17,3,1362,1362,0,
Skylab,9-HDA and HOB,17,3,1402,1403,1,
Skylab,9-HDA and HOB,17,3,1434,1435,1,
Skylab,9-HDA and HOB,17,3,1451,1451,0,
Skylab,9-HDA and HOB,17,3,1497,1498,1,
Skylab,9-HDA and HOB,17,3,1581,1583,2,
Skylab,9-HDA and HOB,17,3,1589,1589,0,
Skylab,9-HDA and HOB,17,3,1603,1605,2,
Skylab,9-HDA and HOB,17,3,1695,1698,3,
Skylab,9-HDA and HOB,17,3,1723,1723,0,
Skylab,9-HDA and HOB,17,3,1726,1727,1,
Skylab,9-HDA and HOB,17,3,1742,1745,3,
Skylab,9-HDA and HOB,17,3,1791,1792,1,
Skylab,9-HDA and HOB,17,3,1794,1796,2,
Skylab,9-HDA and HVA,1,5,1,1,0,
Skylab,9-HDA and HVA,1,5,56,59,3,
Skylab,9-HDA and HVA,1,5,92,93,1,
Skylab,9-HDA and HVA,1,5,102,102,0,
Skylab,9-HDA and HVA,1,5,182,182,0,
Skylab,9-HDA and HVA,1,5,210,210,0,
Skylab,9-HDA and HVA,1,5,268,271,3,
Skylab,9-HDA and HVA,1,5,284,285,1,
Skylab,9-HDA and HVA,1,5,344,344,0,
Skylab,9-HDA and HVA,1,5,416,416,0,
Skylab,9-HDA and HVA,1,5,513,513,0,
Skylab,9-HDA and HVA,1,5,650,661,11,
Skylab,9-HDA and HVA,1,5,655,655,0,
Skylab,9-HDA and HVA,1,5,665,687,22,
Skylab,9-HDA and HVA,1,5,776,777,1,
Skylab,9-HDA and HVA,1,5,803,804,1,
Skylab,9-HDA and HVA,1,5,842,843,1,
Skylab,9-HDA and HVA,1,5,977,978,1,
Skylab,9-HDA and HVA,1,5,1080,1081,1,
Skylab,9-HDA and HVA,1,5,1104,1104,0,
Skylab,9-HDA and HVA,1,5,1123,1125,2,
Skylab,9-HDA and HVA,1,5,1379,1384,5,
Skylab,9-HDA and HVA,1,5,1399,1399,0,
Skylab,9-HDA and HVA,1,5,1433,1433,0,
Skylab,9-HDA and HVA,1,5,1436,1438,2,
Skylab,9-HDA and HVA,1,5,1444,1444,0,
Skylab,9-HDA and HVA,1,5,1454,1455,1,
Skylab,9-HDA and HVA,1,5,1458,1459,1,
Skylab,9-HDA and HVA,1,5,1518,1520,2,
Skylab,9-HDA and HVA,1,5,1528,1562,34,
Skylab,9-HDA and HVA,1,5,1547,1549,2,
Skylab,9-HDA and HVA,1,5,1557,1557,0,
Skylab,9-HDA and HVA,1,5,1559,1559,0,
Skylab,9-HDA and HVA,1,5,1571,1578,7,
Skylab,9-HDA and HVA,1,5,1588,1593,5,
Skylab,9-HDA and HVA,1,5,1601,1604,3,
Skylab,9-HDA and HVA,1,5,1627,1629,2,
Skylab,9-HDA and HVA,1,5,1671,1672,1,
Skylab,9-HDA and HVA,1,5,1678,1678,0,
Skylab,9-HDA and HVA,1,5,1682,1683,1,
Skylab,9-HDA and HVA,1,5,1688,1689,1,
Skylab,9-HDA and HVA,1,5,1698,1698,0,
Skylab,9-HDA and HVA,1,5,1711,1717,6,
Skylab,9-HDA and HVA,1,5,1754,1757,3,
Skylab,9-HDA and HVA,1,5,1800,1800,0,
Skylab,9-HDA and HVA,2,5,9,9,0,
Skylab,9-HDA and HVA,2,5,214,214,0,
Skylab,9-HDA and HVA,2,5,429,432,3,
Skylab,9-HDA and HVA,2,5,547,548,1,
Skylab,9-HDA and HVA,2,5,724,724,0,
Skylab,9-HDA and HVA,2,5,726,728,2,
Skylab,9-HDA and HVA,2,5,822,826,4,
Skylab,9-HDA and HVA,2,5,842,847,5,
Skylab,9-HDA and HVA,2,5,957,958,1,
Skylab,9-HDA and HVA,2,5,1032,1036,4,
Skylab,9-HDA and HVA,2,5,1105,1108,3,
Skylab,9-HDA and HVA,2,5,1115,1117,2,
Skylab,9-HDA and HVA,2,5,1142,1142,0,
Skylab,9-HDA and HVA,2,5,1152,1153,1,
Skylab,9-HDA and HVA,2,5,1159,1161,2,
Skylab,9-HDA and HVA,2,5,1179,1179,0,
Skylab,9-HDA and HVA,2,5,1233,1238,5,
Skylab,9-HDA and HVA,2,5,1271,1273,2,
Skylab,9-HDA and HVA,2,5,1319,1319,0,
Skylab,9-HDA and HVA,2,5,1337,1337,0,
Skylab,9-HDA and HVA,2,5,1349,1351,2,
Skylab,9-HDA and HVA,2,5,1455,1457,2,
Skylab,9-HDA and HVA,2,5,1502,1512,10,
Skylab,9-HDA and HVA,2,5,1513,1516,3,
Skylab,9-HDA and HVA,2,5,1538,1541,3,
Skylab,9-HDA and HVA,2,5,1728,1742,14,
Skylab,9-HDA and HVA,3,1,46,48,2,
Skylab,9-HDA and HVA,3,1,94,95,1,
Skylab,9-HDA and HVA,3,1,102,102,0,
Skylab,9-HDA and HVA,3,1,111,111,0,
Skylab,9-HDA and HVA,3,1,116,120,4,
Skylab,9-HDA and HVA,3,1,126,127,1,
Skylab,9-HDA and HVA,3,1,170,171,1,
Skylab,9-HDA and HVA,3,1,195,198,3,
Skylab,9-HDA and HVA,3,1,206,221,15,
Skylab,9-HDA and HVA,3,1,226,227,1,
Skylab,9-HDA and HVA,3,1,228,230,2,
Skylab,9-HDA and HVA,3,1,236,240,4,
Skylab,9-HDA and HVA,3,1,247,250,3,
Skylab,9-HDA and HVA,3,1,251,255,4,
Skylab,9-HDA and HVA,3,1,281,281,0,
Skylab,9-HDA and HVA,3,1,328,328,0,
Skylab,9-HDA and HVA,3,1,330,330,0,
Skylab,9-HDA and HVA,3,1,363,364,1,
Skylab,9-HDA and HVA,3,1,407,407,0,
Skylab,9-HDA and HVA,3,1,464,464,0,
Skylab,9-HDA and HVA,3,1,522,522,0,
Skylab,9-HDA and HVA,3,1,611,611,0,
Skylab,9-HDA and HVA,3,1,677,679,2,
Skylab,9-HDA and HVA,3,1,775,775,0,
Skylab,9-HDA and HVA,3,1,863,864,1,
Skylab,9-HDA and HVA,3,1,874,875,1,
Skylab,9-HDA and HVA,3,1,875,876,1,
Skylab,9-HDA and HVA,3,1,913,913,0,
Skylab,9-HDA and HVA,3,1,942,942,0,
Skylab,9-HDA and HVA,3,1,1027,1028,1,
Skylab,9-HDA and HVA,3,1,1069,1070,1,
Skylab,9-HDA and HVA,3,1,1071,1088,17,
Skylab,9-HDA and HVA,3,1,1075,1075,0,
Skylab,9-HDA and HVA,3,1,1142,1142,0,
Skylab,9-HDA and HVA,3,1,1174,1174,0,
Skylab,9-HDA and HVA,3,1,1212,1212,0,
Skylab,9-HDA and HVA,3,1,1263,1265,2,
Skylab,9-HDA and HVA,3,1,1276,1277,1,
Skylab,9-HDA and HVA,3,1,1345,1346,1,
Skylab,9-HDA and HVA,3,1,1358,1358,0,
Skylab,9-HDA and HVA,3,1,1426,1428,2,
Skylab,9-HDA and HVA,3,1,1446,1446,0,
Skylab,9-HDA and HVA,3,1,1449,1450,1,
Skylab,9-HDA and HVA,3,1,1505,1646,141,
Skylab,9-HDA and HVA,3,1,1525,1527,2,
Skylab,9-HDA and HVA,3,1,1619,1621,2,
Skylab,9-HDA and HVA,3,1,1657,1697,40,
Skylab,9-HDA and HVA,3,1,1663,1665,2,
Skylab,9-HDA and HVA,3,1,1737,1742,5,
Skylab,9-HDA and HVA,10,5,9,10,1,
Skylab,9-HDA and HVA,10,5,66,66,0,
Skylab,9-HDA and HVA,10,5,80,82,2,
Skylab,9-HDA and HVA,10,5,82,83,1,
Skylab,9-HDA and HVA,10,5,108,108,0,
Skylab,9-HDA and HVA,10,5,125,126,1,
Skylab,9-HDA and HVA,10,5,151,151,0,
Skylab,9-HDA and HVA,10,5,235,235,0,
Skylab,9-HDA and HVA,10,5,253,253,0,
Skylab,9-HDA and HVA,10,5,291,293,2,
Skylab,9-HDA and HVA,10,5,525,526,1,
Skylab,9-HDA and HVA,10,5,616,650,34,
Skylab,9-HDA and HVA,10,5,656,668,12,
Skylab,9-HDA and HVA,10,5,676,680,4,
Skylab,9-HDA and HVA,10,5,683,685,2,
Skylab,9-HDA and HVA,10,5,749,749,0,
Skylab,9-HDA and HVA,10,5,757,761,4,
Skylab,9-HDA and HVA,10,5,797,797,0,
Skylab,9-HDA and HVA,10,5,846,848,2,
Skylab,9-HDA and HVA,10,5,896,899,3,
Skylab,9-HDA and HVA,10,5,953,955,2,maybe - not quite touching but seems interrested
Skylab,9-HDA and HVA,10,5,982,985,3,
Skylab,9-HDA and HVA,10,5,1018,1019,1,
Skylab,9-HDA and HVA,10,5,1027,1027,0,
Skylab,9-HDA and HVA,10,5,1034,1045,11,not touching seems sort of interrested
Skylab,9-HDA and HVA,10,5,1155,1156,1,
Skylab,9-HDA and HVA,10,5,1207,1208,1,
Skylab,9-HDA and HVA,10,5,1240,1241,1,
Skylab,9-HDA and HVA,10,5,1533,1536,3,
Skylab,9-HDA and HVA,10,5,1650,1650,0,sort of
Skylab,9-HDA and HVA,10,5,1674,1674,0,
Skylab,9-HDA and HVA,10,5,1698,1698,0,
Skylab,9-HDA and HVA,10,5,1714,1714,0,
Skylab,9-HDA and HVA,10,5,1787,1787,0,
Skylab,9-HDA and HVA,12,8,8,13,5,
Skylab,9-HDA and HVA,12,8,0,27,27,bee sitting still facing the paper very close to it
Skylab,9-HDA and HVA,12,8,21,21,0,
Skylab,9-HDA and HVA,12,8,32,118,86,"bee sits mostly still facing the paper, it then moves so it's almost parallel to paper, still slightly angled towards it."
Skylab,9-HDA and HVA,12,8,55,58,3,
Skylab,9-HDA and HVA,12,8,92,98,6,
Skylab,9-HDA and HVA,12,8,104,104,0,
Skylab,9-HDA and HVA,12,8,116,123,7,
Skylab,9-HDA and HVA,12,8,121,133,12,
Skylab,9-HDA and HVA,12,8,229,229,0,
Skylab,9-HDA and HVA,12,8,134,350,216,"bee sitting mostly still very close to paper, it still sniffs towards the end of the time it is sitting near paper. (5:40 - 5:45)"
Skylab,9-HDA and HVA,12,8,230,334,104,"5:33 to 5:34, actively sniffing paper. Otherwise it is sitting close to paper, not quite facing it."
Skylab,9-HDA and HVA,12,8,347,351,4,
Skylab,9-HDA and HVA,12,8,358,363,5,
Skylab,9-HDA and HVA,12,8,371,371,0,maybe accidental bump
Skylab,9-HDA and HVA,12,8,389,428,39,"bee sitting mostly still, slowly walsk up to paper, seems to be sniffing from afar first."
Skylab,9-HDA and HVA,12,8,436,436,0,
Skylab,9-HDA and HVA,12,8,438,438,0,
Skylab,9-HDA and HVA,12,8,444,446,2,
Skylab,9-HDA and HVA,12,8,542,542,0,
Skylab,9-HDA and HVA,12,8,817,817,0,
Skylab,9-HDA and HVA,12,8,819,819,0,
Skylab,9-HDA and HVA,12,8,855,855,0,
Skylab,9-HDA and HVA,12,8,937,939,2,
Skylab,9-HDA and HVA,12,8,945,946,1,
Skylab,9-HDA and HVA,12,8,963,963,0,maybe accidental bump
Skylab,9-HDA and HVA,12,8,984,984,0,
Skylab,9-HDA and HVA,12,8,987,1596,609,
Skylab,9-HDA and HVA,12,8,1141,1143,2,"not super sure, sideways touch"
Skylab,9-HDA and HVA,12,8,1186,1188,2,
Skylab,9-HDA and HVA,12,8,1240,1241,1,
Skylab,9-HDA and HVA,12,8,1259,1261,2,
Skylab,9-HDA and HVA,12,8,1356,1356,0,
Skylab,9-HDA and HVA,12,8,1364,1364,0,
Skylab,9-HDA and HVA,12,8,1371,1371,0,
Skylab,9-HDA and HVA,12,8,1390,1390,0,maybe - not quite touching
Skylab,9-HDA and HVA,12,8,1451,1452,1,
Skylab,9-HDA and HVA,12,8,1492,1493,1,
Skylab,9-HDA and HVA,12,8,1507,1513,6,
Skylab,9-HDA and HVA,12,8,1547,1547,0,
Skylab,9-HDA and HVA,12,8,1559,1561,2,
Skylab,9-HDA and HVA,12,8,1567,1567,0,
Skylab,9-HDA and HVA,12,8,1654,1655,1,
Skylab,9-HDA and HVA,12,8,1762,1764,2,
Skylab,9-HDA and HVA,12,8,1779,1780,1,
Skylab,9-HDA and HVA,13,6,8,9,1,
Skylab,9-HDA and HVA,13,6,42,44,2,
Skylab,9-HDA and HVA,13,6,93,94,1,
Skylab,9-HDA and HVA,13,6,110,111,1,
Skylab,9-HDA and HVA,13,6,161,163,2,
Skylab,9-HDA and HVA,13,6,284,285,1,
Skylab,9-HDA and HVA,13,6,313,314,1,
Skylab,9-HDA and HVA,13,6,342,343,1,
Skylab,9-HDA and HVA,13,6,362,362,0,
Skylab,9-HDA and HVA,13,6,373,375,2,
Skylab,9-HDA and HVA,13,6,407,409,2,
Skylab,9-HDA and HVA,13,6,416,421,5,
Skylab,9-HDA and HVA,13,6,428,431,3,
Skylab,9-HDA and HVA,13,6,434,435,1,
Skylab,9-HDA and HVA,13,6,436,436,0,
Skylab,9-HDA and HVA,13,6,441,444,3,
Skylab,9-HDA and HVA,13,6,471,471,0,
Skylab,9-HDA and HVA,13,6,477,480,3,
Skylab,9-HDA and HVA,13,6,524,525,1,
Skylab,9-HDA and HVA,13,6,600,600,0,
Skylab,9-HDA and HVA,13,6,692,692,0,
Skylab,9-HDA and HVA,13,6,833,842,9,
Skylab,9-HDA and HVA,13,6,993,995,2,
Skylab,9-HDA and HVA,13,6,1021,1022,1,
Skylab,9-HDA and HVA,13,6,1036,1036,0,
Skylab,9-HDA and HVA,13,6,1038,1039,1,
Skylab,9-HDA and HVA,13,6,1141,1142,1,
Skylab,9-HDA and HVA,13,6,1153,1153,0,
Skylab,9-HDA and HVA,13,6,1181,1186,5,"bee facing paper seems kind of interrested maybe does not count, not that close to the paper"
Skylab,9-HDA and HVA,13,6,1377,1377,0,
Skylab,9-HDA and HVA,13,6,1380,1380,0,
Skylab,9-HDA and HVA,13,6,1381,1384,3,
Skylab,9-HDA and HVA,13,6,1387,1389,2,
Skylab,9-HDA and HVA,13,6,1429,1429,0,
Skylab,9-HDA and HVA,13,6,1451,1454,3,
Skylab,9-HDA and HVA,13,6,1448,1451,3,
Skylab,9-HDA and HVA,13,6,1460,1461,1,
Skylab,9-HDA and HVA,13,6,1475,1478,3,
Skylab,9-HDA and HVA,13,6,1488,1488,0,
Skylab,9-HDA and HVA,13,6,1510,1513,3,
Skylab,9-HDA and HVA,13,6,1524,1524,0,
Skylab,9-HDA and HVA,13,6,1591,1755,164,27:33 bee gets pushed closer to the paper at this point and remains still was facing paper still before this. Now pratiacally touching the paper but still.
Skylab,9-HDA and HVA,13,6,1736,1739,3,
Skylab,9-HDA and HVA,13,6,1782,1783,1,
Skylab,9-HDA and HVA,15,11,162,164,2,
Skylab,9-HDA and HVA,15,11,170,174,4,
Skylab,9-HDA and HVA,15,11,172,172,0,
Skylab,9-HDA and HVA,15,11,174,175,1,
Skylab,9-HDA and HVA,15,11,182,182,0,bee bumps in to paper sort of
Skylab,9-HDA and HVA,15,11,366,367,1,
Skylab,9-HDA and HVA,15,11,443,443,0,
Skylab,9-HDA and HVA,15,11,480,483,3,
Skylab,9-HDA and HVA,15,11,669,669,0,"kinda don't think it counts, bee bumps in to paper - probs an accident"
Skylab,9-HDA and HVA,15,11,786,788,2,
Skylab,9-HDA and HVA,15,11,802,802,0,
Skylab,9-HDA and HVA,15,11,817,818,1,
Skylab,9-HDA and HVA,15,11,827,827,0,
Skylab,9-HDA and HVA,15,11,852,852,0,be ver very quickly touches as it walks past maybe
Skylab,9-HDA and HVA,15,11,876,879,3,
Skylab,9-HDA and HVA,15,11,901,904,3,
Skylab,9-HDA and HVA,15,11,1041,1043,2,
Skylab,9-HDA and HVA,15,11,1207,1210,3,
Skylab,9-HDA and HVA,15,11,1298,1298,0,
Skylab,9-HDA and HVA,15,11,1306,1307,1,
Skylab,9-HDA and HVA,15,11,1409,1409,0,
Skylab,9-HDA and HVA,15,11,1557,1558,1,
Skylab,9-HDA and HVA,15,11,1591,1591,0,
Skylab,9-HDA and HVA,15,11,1593,1594,1,
Skylab,9-HDA and HVA,16,3,29,29,0,
Skylab,9-HDA and HVA,16,3,34,34,0,
Skylab,9-HDA and HVA,16,3,97,99,2,
Skylab,9-HDA and HVA,16,3,114,114,0,
Skylab,9-HDA and HVA,16,3,179,180,1,
Skylab,9-HDA and HVA,16,3,260,262,2,
Skylab,9-HDA and HVA,16,3,300,300,0,
Skylab,9-HDA and HVA,16,3,315,315,0,
Skylab,9-HDA and HVA,16,3,361,362,1,
Skylab,9-HDA and HVA,16,3,458,459,1,
Skylab,9-HDA and HVA,16,3,474,475,1,
Skylab,9-HDA and HVA,16,3,481,487,6,
Skylab,9-HDA and HVA,16,3,488,488,0,
Skylab,9-HDA and HVA,16,3,513,513,0,
Skylab,9-HDA and HVA,16,3,634,634,0,
Skylab,9-HDA and HVA,16,3,651,651,0,"not too sure, seems to touch as it walks past super breifly"
Skylab,9-HDA and HVA,16,3,722,723,1,
Skylab,9-HDA and HVA,16,3,724,724,0,
Skylab,9-HDA and HVA,16,3,895,901,6,
Skylab,9-HDA and HVA,16,3,921,921,0,
Skylab,9-HDA and HVA,16,3,1060,1069,9,
Skylab,9-HDA and HVA,16,3,1083,1084,1,
Skylab,9-HDA and HVA,16,3,1165,1165,0,
Skylab,9-HDA and HVA,16,3,1234,1241,7,
Skylab,9-HDA and HVA,16,3,1331,1334,3,
Skylab,9-HDA and HVA,16,3,1500,1510,10,
Skylab,9-HDA and HVA,16,3,1516,1516,0,
Skylab,9-HDA and HVA,16,3,1561,1561,0,"not too sure, seems to touch as it walks past super breifly"
Skylab,9-HDA and HVA,16,3,1719,1721,2,
Skylab,9-HDA and HVA,16,3,572,572,0,
Skylab,9-HDA and HVA,17,5,1,1,0,looks like bee sort of bumps in to papert as its turning around
Skylab,9-HDA and HVA,17,5,32,32,0,
Skylab,9-HDA and HVA,17,5,58,58,0,
Skylab,9-HDA and HVA,17,5,178,180,2,
Skylab,9-HDA and HVA,17,5,198,199,1,bee sort of bumps in to paper
Skylab,9-HDA and HVA,17,5,201,203,2,
Skylab,9-HDA and HVA,17,5,202,203,1,
Skylab,9-HDA and HVA,17,5,281,281,0,not too sure bee seems to bend towards apper as it walks past
Skylab,9-HDA and HVA,17,5,413,437,24,
Skylab,9-HDA and HVA,17,5,439,440,1,
Skylab,9-HDA and HVA,17,5,444,446,2,
Skylab,9-HDA and HVA,17,5,445,445,0,bee sort of touches as it walks by
Skylab,9-HDA and HVA,17,5,449,450,1,
Skylab,9-HDA and HVA,17,5,457,457,0,
Skylab,9-HDA and HVA,17,5,478,479,1,
Skylab,9-HDA and HVA,17,5,486,487,1,
Skylab,9-HDA and HVA,17,5,503,503,0,bee sort of bumps in to paper
Skylab,9-HDA and HVA,17,5,542,543,1,
Skylab,9-HDA and HVA,17,5,587,588,1,
Skylab,9-HDA and HVA,17,5,620,621,1,
Skylab,9-HDA and HVA,17,5,666,667,1,
Skylab,9-HDA and HVA,17,5,671,672,1,
Skylab,9-HDA and HVA,17,5,703,705,2,
Skylab,9-HDA and HVA,17,5,709,712,3,"brushes around the edge of paper until 11:57, not sure if this touch counts."
Skylab,9-HDA and HVA,17,5,721,731,10,
Skylab,9-HDA and HVA,17,5,735,736,1,
Skylab,9-HDA and HVA,17,5,767,767,0,
Skylab,9-HDA and HVA,17,5,821,823,2,
Skylab,9-HDA and HVA,17,5,825,826,1,
Skylab,9-HDA and HVA,17,5,853,854,1,bee sort of bumps in to paper as its turning around
Skylab,9-HDA and HVA,17,5,883,884,1,
Skylab,9-HDA and HVA,17,5,895,895,0,bee bumps in tp paper as it walks past
Skylab,9-HDA and HVA,17,5,1008,1011,3,bee walks over paper - seems to sort of stop and sniff it at the start
Skylab,9-HDA and HVA,17,5,1117,1117,0,not too sure bee seems to bend towards apper as it walks past
Skylab,9-HDA and HVA,17,5,1132,1133,1,
Skylab,9-HDA and HVA,17,5,1149,1150,1,
Skylab,9-HDA and HVA,17,5,1306,1313,7,
Skylab,9-HDA and HVA,17,5,1321,1326,5,
Skylab,9-HDA and HVA,17,5,1394,1394,0,
Skylab,9-HDA and HVA,17,5,1492,1554,62,
Skylab,9-HDA and HVA,17,5,1586,1586,0,
Skylab,9-HDA and HVA,17,5,1679,1679,0,
Skylab,9-HDA and HVA,17,5,1768,1771,3,
Skylab,9-HDA and HVA,17,5,1780,1781,1,
Skylab,9-ODA and HOB,1,8,18,18,0,
Skylab,9-ODA and HOB,1,8,47,47,0,
Skylab,9-ODA and HOB,1,8,50,52,2,
Skylab,9-ODA and HOB,1,8,61,61,0,
Skylab,9-ODA and HOB,1,8,93,95,2,
Skylab,9-ODA and HOB,1,8,141,141,0,
Skylab,9-ODA and HOB,1,8,156,158,2,
Skylab,9-ODA and HOB,1,8,178,178,0,
Skylab,9-ODA and HOB,1,8,181,182,1,
Skylab,9-ODA and HOB,1,8,219,219,0,
Skylab,9-ODA and HOB,1,8,286,288,2,
Skylab,9-ODA and HOB,1,8,297,298,1,
Skylab,9-ODA and HOB,1,8,315,317,2,
Skylab,9-ODA and HOB,1,8,328,329,1,
Skylab,9-ODA and HOB,1,8,347,350,3,
Skylab,9-ODA and HOB,1,8,425,426,1,
Skylab,9-ODA and HOB,1,8,441,442,1,
Skylab,9-ODA and HOB,1,8,455,458,3,
Skylab,9-ODA and HOB,1,8,463,463,0,
Skylab,9-ODA and HOB,1,8,526,526,0,
Skylab,9-ODA and HOB,1,8,529,529,0,
Skylab,9-ODA and HOB,1,8,533,533,0,
Skylab,9-ODA and HOB,1,8,536,536,0,
Skylab,9-ODA and HOB,1,8,563,563,0,
Skylab,9-ODA and HOB,1,8,596,596,0,
Skylab,9-ODA and HOB,1,8,707,707,0,
Skylab,9-ODA and HOB,1,8,801,801,0,
Skylab,9-ODA and HOB,1,8,880,880,0,
Skylab,9-ODA and HOB,1,8,901,902,1,
Skylab,9-ODA and HOB,1,8,943,943,0,
Skylab,9-ODA and HOB,1,8,976,977,1,
Skylab,9-ODA and HOB,1,8,1082,1082,0,
Skylab,9-ODA and HOB,1,8,1085,1086,1,
Skylab,9-ODA and HOB,1,8,1139,1139,0,
Skylab,9-ODA and HOB,1,8,1158,1160,2,
Skylab,9-ODA and HOB,1,8,1160,1160,0,
Skylab,9-ODA and HOB,1,8,1175,1175,0,
Skylab,9-ODA and HOB,1,8,1279,1281,2,
Skylab,9-ODA and HOB,1,8,1327,1327,0,
Skylab,9-ODA and HOB,1,8,1375,1375,0,
Skylab,9-ODA and HOB,1,8,1545,1545,0,
Skylab,9-ODA and HOB,1,8,1558,1560,2,
Skylab,9-ODA and HOB,1,8,1572,1573,1,
Skylab,9-ODA and HOB,1,8,1596,1596,0,
Skylab,9-ODA and HOB,1,8,1653,1653,0,
Skylab,9-ODA and HOB,1,8,1666,1666,0,
Skylab,9-ODA and HOB,1,8,1759,1759,0,
Skylab,9-ODA and HOB,1,8,1767,1768,1,
Skylab,9-ODA and HOB,1,8,1790,1792,2,
Skylab,9-ODA and HOB,2,8,136,138,2,
Skylab,9-ODA and HOB,2,8,137,138,1,
Skylab,9-ODA and HOB,2,8,152,153,1,
Skylab,9-ODA and HOB,2,8,193,196,3,
Skylab,9-ODA and HOB,2,8,224,224,0,
Skylab,9-ODA and HOB,2,8,247,247,0,
Skylab,9-ODA and HOB,2,8,255,257,2,
Skylab,9-ODA and HOB,2,8,262,265,3,
Skylab,9-ODA and HOB,2,8,266,267,1,
Skylab,9-ODA and HOB,2,8,272,273,1,
Skylab,9-ODA and HOB,2,8,284,287,3,
Skylab,9-ODA and HOB,2,8,320,322,2,
Skylab,9-ODA and HOB,2,8,356,356,0,
Skylab,9-ODA and HOB,2,8,368,369,1,
Skylab,9-ODA and HOB,2,8,369,372,3,
Skylab,9-ODA and HOB,2,8,381,382,1,
Skylab,9-ODA and HOB,2,8,391,391,0,
Skylab,9-ODA and HOB,2,8,434,439,5,bee sniffs from afar
Skylab,9-ODA and HOB,2,8,440,443,3,
Skylab,9-ODA and HOB,2,8,446,1496,1050,bee mostly still facing the paper from a distance
Skylab,9-ODA and HOB,2,8,488,489,1,
Skylab,9-ODA and HOB,2,8,633,634,1,
Skylab,9-ODA and HOB,2,8,743,744,1,
Skylab,9-ODA and HOB,2,8,754,754,0,
Skylab,9-ODA and HOB,2,8,793,793,0,
Skylab,9-ODA and HOB,2,8,808,808,0,
Skylab,9-ODA and HOB,2,8,860,861,1,
Skylab,9-ODA and HOB,2,8,876,877,1,
Skylab,9-ODA and HOB,2,8,889,889,0,
Skylab,9-ODA and HOB,2,8,916,916,0,
Skylab,9-ODA and HOB,2,8,947,950,3,
Skylab,9-ODA and HOB,2,8,965,967,2,
Skylab,9-ODA and HOB,2,8,987,987,0,
Skylab,9-ODA and HOB,2,8,994,994,0,
Skylab,9-ODA and HOB,2,8,1001,1001,0,
Skylab,9-ODA and HOB,2,8,1013,1013,0,
Skylab,9-ODA and HOB,2,8,1025,1025,0,
Skylab,9-ODA and HOB,2,8,1308,1310,2,
Skylab,9-ODA and HOB,2,8,1409,1409,0,
Skylab,9-ODA and HOB,2,8,1435,1437,2,
Skylab,9-ODA and HOB,2,8,1479,1479,0,
Skylab,9-ODA and HOB,2,8,1625,1627,2,
Skylab,9-ODA and HOB,2,8,1757,1760,3,
Skylab,9-ODA and HOB,2,8,1638,1748,110,bee mostly still facing the paper from a distance
Skylab,9-ODA and HOB,2,8,1791,1791,0,
Skylab,9-ODA and HOB,2,8,1795,1796,1,
Skylab,9-ODA and HOB,2,8,1794,1800,6,
Skylab,9-ODA and HOB,2,8,771,772,1,
Skylab,9-ODA and HOB,2,8,917,918,1,
Skylab,9-ODA and HOB,10,8,3,4,1,
Skylab,9-ODA and HOB,10,8,7,8,1,
Skylab,9-ODA and HOB,10,8,10,11,1,
Skylab,9-ODA and HOB,10,8,21,29,8,
Skylab,9-ODA and HOB,10,8,51,61,10,
Skylab,9-ODA and HOB,10,8,68,75,7,
Skylab,9-ODA and HOB,10,8,87,89,2,
Skylab,9-ODA and HOB,10,8,95,104,9,
Skylab,9-ODA and HOB,10,8,129,130,1,
Skylab,9-ODA and HOB,10,8,160,162,2,
Skylab,9-ODA and HOB,10,8,215,215,0,
Skylab,9-ODA and HOB,10,8,225,225,0,
Skylab,9-ODA and HOB,10,8,235,241,6,
Skylab,9-ODA and HOB,10,8,259,259,0,
Skylab,9-ODA and HOB,10,8,274,276,2,
Skylab,9-ODA and HOB,10,8,279,280,1,
Skylab,9-ODA and HOB,10,8,322,328,6,
Skylab,9-ODA and HOB,10,8,338,338,0,
Skylab,9-ODA and HOB,10,8,370,370,0,
Skylab,9-ODA and HOB,10,8,381,382,1,
Skylab,9-ODA and HOB,10,8,388,388,0,
Skylab,9-ODA and HOB,10,8,399,401,2,
Skylab,9-ODA and HOB,10,8,415,416,1,
Skylab,9-ODA and HOB,10,8,419,419,0,
Skylab,9-ODA and HOB,10,8,438,438,0,
Skylab,9-ODA and HOB,10,8,418,446,28,
Skylab,9-ODA and HOB,10,8,445,445,0,
Skylab,9-ODA and HOB,10,8,451,455,4,
Skylab,9-ODA and HOB,10,8,480,480,0,
Skylab,9-ODA and HOB,10,8,494,499,5,
Skylab,9-ODA and HOB,10,8,508,509,1,
Skylab,9-ODA and HOB,10,8,512,514,2,
Skylab,9-ODA and HOB,10,8,519,522,3,
Skylab,9-ODA and HOB,10,8,524,526,2,
Skylab,9-ODA and HOB,10,8,544,545,1,
Skylab,9-ODA and HOB,10,8,553,555,2,
Skylab,9-ODA and HOB,10,8,570,570,0,
Skylab,9-ODA and HOB,10,8,573,573,0,
Skylab,9-ODA and HOB,10,8,578,578,0,
Skylab,9-ODA and HOB,10,8,579,581,2,
Skylab,9-ODA and HOB,10,8,589,607,18,
Skylab,9-ODA and HOB,10,8,646,646,0,
Skylab,9-ODA and HOB,10,8,734,734,0,
Skylab,9-ODA and HOB,10,8,740,748,8,
Skylab,9-ODA and HOB,10,8,746,769,23,
Skylab,9-ODA and HOB,10,8,768,770,2,
Skylab,9-ODA and HOB,10,8,795,799,4,
Skylab,9-ODA and HOB,10,8,806,811,5,
Skylab,9-ODA and HOB,10,8,806,808,2,
Skylab,9-ODA and HOB,10,8,812,813,1,
Skylab,9-ODA and HOB,10,8,874,879,5,
Skylab,9-ODA and HOB,10,8,888,889,1,
Skylab,9-ODA and HOB,10,8,897,915,18,
Skylab,9-ODA and HOB,10,8,903,904,1,
Skylab,9-ODA and HOB,10,8,920,921,1,
Skylab,9-ODA and HOB,10,8,927,933,6,
Skylab,9-ODA and HOB,10,8,935,949,14,
Skylab,9-ODA and HOB,10,8,963,965,2,
Skylab,9-ODA and HOB,10,8,964,971,7,
Skylab,9-ODA and HOB,10,8,973,976,3,
Skylab,9-ODA and HOB,10,8,1013,1014,1,
Skylab,9-ODA and HOB,10,8,1025,1032,7,
Skylab,9-ODA and HOB,10,8,1030,1032,2,
Skylab,9-ODA and HOB,10,8,1037,1068,31,
Skylab,9-ODA and HOB,10,8,1070,1079,9,
Skylab,9-ODA and HOB,10,8,1106,1107,1,
Skylab,9-ODA and HOB,10,8,1110,1111,1,
Skylab,9-ODA and HOB,10,8,539,1140,601,
Skylab,9-ODA and HOB,10,8,1164,1166,2,
Skylab,9-ODA and HOB,10,8,1218,1218,0,
Skylab,9-ODA and HOB,10,8,1230,1232,2,
Skylab,9-ODA and HOB,10,8,1234,1236,2,
Skylab,9-ODA and HOB,10,8,1239,1243,4,
Skylab,9-ODA and HOB,10,8,1242,1243,1,
Skylab,9-ODA and HOB,10,8,1255,1257,2,
Skylab,9-ODA and HOB,10,8,1258,1259,1,
Skylab,9-ODA and HOB,10,8,1267,1277,10,
Skylab,9-ODA and HOB,10,8,1291,1293,2,
Skylab,9-ODA and HOB,10,8,1300,1301,1,
Skylab,9-ODA and HOB,10,8,1325,1336,11,
Skylab,9-ODA and HOB,10,8,1366,1367,1,
Skylab,9-ODA and HOB,10,8,1375,1376,1,
Skylab,9-ODA and HOB,10,8,1378,1381,3,
Skylab,9-ODA and HOB,10,8,1410,1411,1,
Skylab,9-ODA and HOB,10,8,1440,1446,6,bee not touching but seems interested
Skylab,9-ODA and HOB,10,8,1462,1462,0,
Skylab,9-ODA and HOB,10,8,1470,1477,7,not touching - bee very close to paper just standing still
Skylab,9-ODA and HOB,10,8,1507,1511,4,
Skylab,9-ODA and HOB,10,8,1530,1531,1,
Skylab,9-ODA and HOB,10,8,1545,1574,29,
Skylab,9-ODA and HOB,10,8,1564,1569,5,
Skylab,9-ODA and HOB,10,8,1586,1587,1,
Skylab,9-ODA and HOB,10,8,1590,1590,0,
Skylab,9-ODA and HOB,10,8,1591,1592,1,
Skylab,9-ODA and HOB,10,8,1596,1597,1,
Skylab,9-ODA and HOB,10,8,1647,1647,0,
Skylab,9-ODA and HOB,10,8,1670,1678,8,
Skylab,9-ODA and HOB,10,8,1683,1683,0,
Skylab,9-ODA and HOB,10,8,1705,1706,1,
Skylab,9-ODA and HOB,10,8,1711,1713,2,
Skylab,9-ODA and HOB,10,8,1715,1715,0,
Skylab,9-ODA and HOB,10,8,1741,1742,1,
Skylab,9-ODA and HOB,10,8,1754,1757,3,
Skylab,9-ODA and HOB,12,5,42,43,1,
Skylab,9-ODA and HOB,12,5,47,50,3,
Skylab,9-ODA and HOB,12,5,150,152,2,
Skylab,9-ODA and HOB,12,5,234,234,0,
Skylab,9-ODA and HOB,12,5,285,286,1,
Skylab,9-ODA and HOB,12,5,288,288,0,
Skylab,9-ODA and HOB,12,5,329,329,0,
Skylab,9-ODA and HOB,12,5,338,338,0,
Skylab,9-ODA and HOB,12,5,353,353,0,
Skylab,9-ODA and HOB,12,5,404,404,0,
Skylab,9-ODA and HOB,12,5,427,427,0,
Skylab,9-ODA and HOB,12,5,467,468,1,
Skylab,9-ODA and HOB,12,5,479,479,0,
Skylab,9-ODA and HOB,12,5,494,497,3,bee sniff from afar
Skylab,9-ODA and HOB,12,5,501,503,2,
Skylab,9-ODA and HOB,12,5,512,512,0,
Skylab,9-ODA and HOB,12,5,562,563,1,
Skylab,9-ODA and HOB,12,5,611,612,1,
Skylab,9-ODA and HOB,12,5,661,662,1,
Skylab,9-ODA and HOB,12,5,759,760,1,
Skylab,9-ODA and HOB,12,5,807,807,0,
Skylab,9-ODA and HOB,12,5,813,814,1,
Skylab,9-ODA and HOB,12,5,817,818,1,
Skylab,9-ODA and HOB,12,5,835,836,1,
Skylab,9-ODA and HOB,12,5,917,917,0,
Skylab,9-ODA and HOB,12,5,919,920,1,
Skylab,9-ODA and HOB,12,5,959,968,9,
Skylab,9-ODA and HOB,12,5,969,974,5,
Skylab,9-ODA and HOB,12,5,984,992,8,
Skylab,9-ODA and HOB,12,5,1e3,1001,1,
Skylab,9-ODA and HOB,12,5,1003,1008,5,
Skylab,9-ODA and HOB,12,5,1015,1017,2,
Skylab,9-ODA and HOB,12,5,1022,1025,3,
Skylab,9-ODA and HOB,12,5,1035,1035,0,
Skylab,9-ODA and HOB,12,5,1047,1048,1,
Skylab,9-ODA and HOB,12,5,1065,1066,1,
Skylab,9-ODA and HOB,12,5,1285,1286,1,
Skylab,9-ODA and HOB,12,5,1340,1345,5,
Skylab,9-ODA and HOB,12,5,1369,1369,0,
Skylab,9-ODA and HOB,12,5,1558,1559,1,
Skylab,9-ODA and HOB,12,5,1670,1671,1,
Skylab,9-ODA and HOB,12,5,1680,1680,0,
Skylab,9-ODA and HOB,13,7,21,24,3,
Skylab,9-ODA and HOB,13,7,29,30,1,
Skylab,9-ODA and HOB,13,7,55,55,0,
Skylab,9-ODA and HOB,13,7,174,176,2,
Skylab,9-ODA and HOB,13,7,293,297,4,
Skylab,9-ODA and HOB,13,7,326,326,0,
Skylab,9-ODA and HOB,13,7,431,431,0,
Skylab,9-ODA and HOB,13,7,522,526,4,
Skylab,9-ODA and HOB,13,7,608,608,0,
Skylab,9-ODA and HOB,13,7,616,617,1,bee gets sort of pushed in to paper
Skylab,9-ODA and HOB,13,7,655,660,5,"one of the bee recorded being still next to the paper has a sniff here at his time! If we decide to count the ""being still"" period delete this entry or this touch will be counted twice. it's the 1:43 to 8:50 bee"
Skylab,9-ODA and HOB,13,7,742,742,0,
Skylab,9-ODA and HOB,13,7,782,783,1,
Skylab,9-ODA and HOB,13,7,893,893,0,"bee walks in to paper, maybe an accident"
Skylab,9-ODA and HOB,13,7,919,946,27,
Skylab,9-ODA and HOB,13,7,983,999,16,
Skylab,9-ODA and HOB,13,7,1010,1010,0,
Skylab,9-ODA and HOB,13,7,1021,1023,2,
Skylab,9-ODA and HOB,13,7,1030,1031,1,
Skylab,9-ODA and HOB,13,7,1043,1043,0,
Skylab,9-ODA and HOB,13,7,1111,1112,1,bee being weird nexrt to paper it bumped in to
Skylab,9-ODA and HOB,13,7,1184,1188,4,
Skylab,9-ODA and HOB,13,7,1213,1213,0,
Skylab,9-ODA and HOB,13,7,1350,1352,2,bee bumps in to paper sort of
Skylab,9-ODA and HOB,13,7,1409,1416,7,
Skylab,9-ODA and HOB,13,7,1566,1567,1,
Skylab,9-ODA and HOB,13,7,1528,1597,69,"bee snifffs a little distance from the paper, I think it's legit"
Skylab,9-ODA and HOB,13,7,1609,1624,15,
Skylab,9-ODA and HOB,13,7,1640,1643,3,
Skylab,9-ODA and HOB,13,7,1660,1784,124,"bee mostly still, b=gets pushed further from paper at 29:44 stays until the end (30:00)"
Skylab,9-ODA and HOB,13,7,1664,1668,4,
Skylab,9-ODA and HOB,13,7,1679,1686,7,
Skylab,9-ODA and HOB,13,7,1687,1689,2,
Skylab,9-ODA and HOB,13,7,1718,1722,4,
Skylab,9-ODA and HOB,13,7,0,637,637,"bee sitting a little distance from paper facing it, gets pushed to the side at 10:37"
Skylab,9-ODA and HOB,13,7,103,530,427,"bee sitting a little distance from paper facing it, gets pushed to the side at 8:50"
Skylab,9-ODA and HOB,15,1,66,71,5,
Skylab,9-ODA and HOB,15,1,133,133,0,
Skylab,9-ODA and HOB,15,1,255,260,5,
Skylab,9-ODA and HOB,15,1,272,280,8,
Skylab,9-ODA and HOB,15,1,326,326,0,
Skylab,9-ODA and HOB,15,1,328,328,0,
Skylab,9-ODA and HOB,15,1,379,383,4,
Skylab,9-ODA and HOB,15,1,457,459,2,
Skylab,9-ODA and HOB,15,1,591,593,2,
Skylab,9-ODA and HOB,15,1,598,598,0,
Skylab,9-ODA and HOB,15,1,753,754,1,
Skylab,9-ODA and HOB,15,1,790,797,7,
Skylab,9-ODA and HOB,15,1,838,843,5,
Skylab,9-ODA and HOB,15,1,875,876,1,
Skylab,9-ODA and HOB,15,1,900,901,1,
Skylab,9-ODA and HOB,15,1,945,949,4,
Skylab,9-ODA and HOB,15,1,951,951,0,
Skylab,9-ODA and HOB,15,1,1098,1100,2,"bee seems interrested, not touching"
Skylab,9-ODA and HOB,15,1,1152,1153,1,
Skylab,9-ODA and HOB,15,1,1189,1191,2,
Skylab,9-ODA and HOB,15,1,1317,1318,1,
Skylab,9-ODA and HOB,15,1,1332,1334,2,
Skylab,9-ODA and HOB,15,1,1335,1341,6,
Skylab,9-ODA and HOB,15,1,1338,1346,8,
Skylab,9-ODA and HOB,15,1,1349,1350,1,
Skylab,9-ODA and HOB,15,1,1429,1430,1,
Skylab,9-ODA and HOB,15,1,1529,1529,0,
Skylab,9-ODA and HOB,15,1,1548,1548,0,
Skylab,9-ODA and HOB,15,1,1688,1688,0,
Skylab,9-ODA and HOB,15,1,1691,1691,0,
Skylab,9-ODA and HOB,15,1,1712,1716,4,
Skylab,9-ODA and HOB,15,1,1766,1767,1,
Skylab,9-ODA and HOB,16,6,19,23,4,
Skylab,9-ODA and HOB,16,6,52,53,1,
Skylab,9-ODA and HOB,16,6,62,63,1,
Skylab,9-ODA and HOB,16,6,78,78,0,
Skylab,9-ODA and HOB,16,6,109,148,39,
Skylab,9-ODA and HOB,16,6,112,113,1,
Skylab,9-ODA and HOB,16,6,169,170,1,
Skylab,9-ODA and HOB,16,6,182,184,2,
Skylab,9-ODA and HOB,16,6,204,206,2,
Skylab,9-ODA and HOB,16,6,227,228,1,
Skylab,9-ODA and HOB,16,6,260,269,9,bee sniffs from afar
Skylab,9-ODA and HOB,16,6,278,283,5,
Skylab,9-ODA and HOB,16,6,285,288,3,
Skylab,9-ODA and HOB,16,6,297,298,1,
Skylab,9-ODA and HOB,16,6,300,311,11,
Skylab,9-ODA and HOB,16,6,343,349,6,
Skylab,9-ODA and HOB,16,6,352,353,1,
Skylab,9-ODA and HOB,16,6,358,373,15,
Skylab,9-ODA and HOB,16,6,387,390,3,
Skylab,9-ODA and HOB,16,6,395,397,2,bee sideways touches the paper
Skylab,9-ODA and HOB,16,6,410,412,2,
Skylab,9-ODA and HOB,16,6,425,433,8,
Skylab,9-ODA and HOB,16,6,445,447,2,not super sure sort of dips towards paper
Skylab,9-ODA and HOB,16,6,404,405,1,
Skylab,9-ODA and HOB,16,6,475,481,6,
Skylab,9-ODA and HOB,16,6,558,562,4,
Skylab,9-ODA and HOB,16,6,599,603,4,
Skylab,9-ODA and HOB,16,6,721,724,3,
Skylab,9-ODA and HOB,16,6,764,768,4,
Skylab,9-ODA and HOB,16,6,777,778,1,
Skylab,9-ODA and HOB,16,6,867,868,1,
Skylab,9-ODA and HOB,16,6,892,892,0,
Skylab,9-ODA and HOB,16,6,899,899,0,bee sideways touches the paper
Skylab,9-ODA and HOB,16,6,967,971,4,
Skylab,9-ODA and HOB,16,6,993,995,2,
Skylab,9-ODA and HOB,16,6,1022,1026,4,
Skylab,9-ODA and HOB,16,6,1095,1097,2,
Skylab,9-ODA and HOB,16,6,1117,1117,0,
Skylab,9-ODA and HOB,16,6,1124,1124,0,
Skylab,9-ODA and HOB,16,6,1168,1169,1,
Skylab,9-ODA and HOB,16,6,1346,1349,3,
Skylab,9-ODA and HOB,16,6,1351,1357,6,
Skylab,9-ODA and HOB,16,6,1370,1372,2,
Skylab,9-ODA and HOB,16,6,1485,1563,78,
Skylab,9-ODA and HOB,16,6,1472,1476,4,
Skylab,9-ODA and HOB,16,6,1491,1499,8,
Skylab,9-ODA and HOB,16,6,1556,1559,3,
Skylab,9-ODA and HOB,16,6,1568,1569,1,
Skylab,9-ODA and HOB,16,6,1577,1580,3,
Skylab,9-ODA and HOB,16,6,1586,1586,0,
Skylab,9-ODA and HOB,16,6,1610,1610,0,
Skylab,9-ODA and HOB,16,6,1631,1631,0,
Skylab,9-ODA and HOB,16,6,1638,1639,1,
Skylab,9-ODA and HOB,16,6,1663,1665,2,
Skylab,9-ODA and HOB,17,2,8,12,4,
Skylab,9-ODA and HOB,17,2,28,31,3,
Skylab,9-ODA and HOB,17,2,34,34,0,
Skylab,9-ODA and HOB,17,2,47,47,0,
Skylab,9-ODA and HOB,17,2,61,65,4,
Skylab,9-ODA and HOB,17,2,66,66,0,
Skylab,9-ODA and HOB,17,2,67,68,1,
Skylab,9-ODA and HOB,17,2,84,84,0,
Skylab,9-ODA and HOB,17,2,130,131,1,
Skylab,9-ODA and HOB,17,2,142,142,0,
Skylab,9-ODA and HOB,17,2,152,154,2,
Skylab,9-ODA and HOB,17,2,217,218,1,
Skylab,9-ODA and HOB,17,2,325,326,1,
Skylab,9-ODA and HOB,17,2,396,396,0,
Skylab,9-ODA and HOB,17,2,411,413,2,
Skylab,9-ODA and HOB,17,2,425,425,0,
Skylab,9-ODA and HOB,17,2,505,505,0,
Skylab,9-ODA and HOB,17,2,534,535,1,
Skylab,9-ODA and HOB,17,2,790,791,1,
Skylab,9-ODA and HOB,17,2,847,847,0,
Skylab,9-ODA and HOB,17,2,925,925,0,
Skylab,9-ODA and HOB,17,2,934,934,0,
Skylab,9-ODA and HOB,17,2,1027,1027,0,
Skylab,9-ODA and HOB,17,2,1179,1179,0,
Skylab,9-ODA and HOB,17,2,1195,1196,1,
Skylab,9-ODA and HOB,17,2,1206,1207,1,
Skylab,9-ODA and HOB,17,2,1228,1232,4,
Skylab,9-ODA and HOB,17,2,1252,1253,1,
Skylab,9-ODA and HOB,17,2,1259,1267,8,
Skylab,9-ODA and HOB,17,2,1269,1276,7,
Skylab,9-ODA and HOB,17,2,1328,1328,0,
Skylab,9-ODA and HOB,17,2,1339,1339,0,
Skylab,9-ODA and HOB,17,2,1426,1434,8,
Skylab,9-ODA and HOB,17,2,1446,1446,0,
Skylab,9-ODA and HOB,17,2,1499,1499,0,
Skylab,9-ODA and HOB,17,2,1500,1500,0,
Skylab,9-ODA and HOB,17,2,1720,1723,3,
Skylab,9-ODA and HOB,17,2,1739,1741,2,
Skylab,9-ODA and HOB,17,2,1754,1755,1,
Skylab,9-ODA and HOB,17,2,1768,1768,0,
Skylab,9-ODA and HVA,1,7,0,80,80,
Skylab,9-ODA and HVA,1,7,6,7,1,
Skylab,9-ODA and HVA,1,7,24,25,1,
Skylab,9-ODA and HVA,1,7,38,39,1,
Skylab,9-ODA and HVA,1,7,44,44,0,
Skylab,9-ODA and HVA,1,7,49,50,1,
Skylab,9-ODA and HVA,1,7,57,59,2,
Skylab,9-ODA and HVA,1,7,59,59,0,
Skylab,9-ODA and HVA,1,7,62,64,2,
Skylab,9-ODA and HVA,1,7,70,70,0,
Skylab,9-ODA and HVA,1,7,73,73,0,
Skylab,9-ODA and HVA,1,7,87,94,7,
Skylab,9-ODA and HVA,1,7,96,105,9,
Skylab,9-ODA and HVA,1,7,122,122,0,
Skylab,9-ODA and HVA,1,7,130,133,3,
Skylab,9-ODA and HVA,1,7,139,139,0,
Skylab,9-ODA and HVA,1,7,140,141,1,
Skylab,9-ODA and HVA,1,7,145,146,1,
Skylab,9-ODA and HVA,1,7,151,153,2,
Skylab,9-ODA and HVA,1,7,156,157,1,
Skylab,9-ODA and HVA,1,7,156,160,4,
Skylab,9-ODA and HVA,1,7,162,162,0,
Skylab,9-ODA and HVA,1,7,165,166,1,
Skylab,9-ODA and HVA,1,7,167,167,0,
Skylab,9-ODA and HVA,1,7,201,202,1,
Skylab,9-ODA and HVA,1,7,205,206,1,
Skylab,9-ODA and HVA,1,7,230,232,2,
Skylab,9-ODA and HVA,1,7,241,242,1,
Skylab,9-ODA and HVA,1,7,244,246,2,
Skylab,9-ODA and HVA,1,7,249,249,0,
Skylab,9-ODA and HVA,1,7,268,270,2,
Skylab,9-ODA and HVA,1,7,281,288,7,
Skylab,9-ODA and HVA,1,7,332,332,0,
Skylab,9-ODA and HVA,1,7,348,348,0,
Skylab,9-ODA and HVA,1,7,362,362,0,
Skylab,9-ODA and HVA,1,7,372,372,0,
Skylab,9-ODA and HVA,1,7,401,402,1,
Skylab,9-ODA and HVA,1,7,438,439,1,
Skylab,9-ODA and HVA,1,7,454,454,0,
Skylab,9-ODA and HVA,1,7,465,469,4,
Skylab,9-ODA and HVA,1,7,504,504,0,
Skylab,9-ODA and HVA,1,7,514,515,1,
Skylab,9-ODA and HVA,1,7,522,522,0,
Skylab,9-ODA and HVA,1,7,568,569,1,
Skylab,9-ODA and HVA,1,7,617,617,0,
Skylab,9-ODA and HVA,1,7,646,646,0,
Skylab,9-ODA and HVA,1,7,660,660,0,
Skylab,9-ODA and HVA,1,7,671,673,2,
Skylab,9-ODA and HVA,1,7,682,691,9,
Skylab,9-ODA and HVA,1,7,694,696,2,
Skylab,9-ODA and HVA,1,7,697,702,5,
Skylab,9-ODA and HVA,1,7,704,704,0,
Skylab,9-ODA and HVA,1,7,707,708,1,
Skylab,9-ODA and HVA,1,7,714,716,2,
Skylab,9-ODA and HVA,1,7,723,726,3,
Skylab,9-ODA and HVA,1,7,727,732,5,
Skylab,9-ODA and HVA,1,7,733,736,3,
Skylab,9-ODA and HVA,1,7,738,740,2,
Skylab,9-ODA and HVA,1,7,742,742,0,
Skylab,9-ODA and HVA,1,7,745,745,0,
Skylab,9-ODA and HVA,1,7,758,758,0,
Skylab,9-ODA and HVA,1,7,780,780,0,
Skylab,9-ODA and HVA,1,7,802,803,1,
Skylab,9-ODA and HVA,1,7,806,806,0,
Skylab,9-ODA and HVA,1,7,825,825,0,
Skylab,9-ODA and HVA,1,7,843,845,2,
Skylab,9-ODA and HVA,1,7,852,852,0,
Skylab,9-ODA and HVA,1,7,877,877,0,
Skylab,9-ODA and HVA,1,7,882,882,0,
Skylab,9-ODA and HVA,1,7,899,901,2,
Skylab,9-ODA and HVA,1,7,915,929,14,
Skylab,9-ODA and HVA,1,7,933,933,0,
Skylab,9-ODA and HVA,1,7,936,936,0,
Skylab,9-ODA and HVA,1,7,996,996,0,
Skylab,9-ODA and HVA,1,7,1002,1002,0,
Skylab,9-ODA and HVA,1,7,1011,1011,0,
Skylab,9-ODA and HVA,1,7,1027,1029,2,
Skylab,9-ODA and HVA,1,7,1047,1047,0,
Skylab,9-ODA and HVA,1,7,1068,1070,2,
Skylab,9-ODA and HVA,1,7,1072,1081,9,
Skylab,9-ODA and HVA,1,7,1081,1081,0,
Skylab,9-ODA and HVA,1,7,1090,1092,2,
Skylab,9-ODA and HVA,1,7,1104,1104,0,
Skylab,9-ODA and HVA,1,7,1141,1142,1,
Skylab,9-ODA and HVA,1,7,1167,1171,4,
Skylab,9-ODA and HVA,1,7,1187,1189,2,
Skylab,9-ODA and HVA,1,7,1196,1260,64,
Skylab,9-ODA and HVA,1,7,1211,1220,9,
Skylab,9-ODA and HVA,1,7,1213,1213,0,
Skylab,9-ODA and HVA,1,7,1215,1216,1,
Skylab,9-ODA and HVA,1,7,1222,1225,3,
Skylab,9-ODA and HVA,1,7,1241,1242,1,
Skylab,9-ODA and HVA,1,7,1278,1286,8,
Skylab,9-ODA and HVA,1,7,1306,1307,1,
Skylab,9-ODA and HVA,1,7,1341,1342,1,
Skylab,9-ODA and HVA,1,7,1350,1351,1,
Skylab,9-ODA and HVA,1,7,1357,1357,0,
Skylab,9-ODA and HVA,1,7,1382,1382,0,
Skylab,9-ODA and HVA,1,7,1392,1393,1,
Skylab,9-ODA and HVA,1,7,1398,1398,0,
Skylab,9-ODA and HVA,1,7,1408,1409,1,
Skylab,9-ODA and HVA,1,7,1431,1433,2,
Skylab,9-ODA and HVA,1,7,1439,1441,2,
Skylab,9-ODA and HVA,1,7,1443,1444,1,
Skylab,9-ODA and HVA,1,7,1447,1456,9,
Skylab,9-ODA and HVA,1,7,1471,1471,0,
Skylab,9-ODA and HVA,1,7,1507,1507,0,
Skylab,9-ODA and HVA,1,7,1536,1537,1,
Skylab,9-ODA and HVA,1,7,1545,1546,1,
Skylab,9-ODA and HVA,1,7,1561,1563,2,
Skylab,9-ODA and HVA,1,7,1564,1564,0,
Skylab,9-ODA and HVA,1,7,1567,1567,0,
Skylab,9-ODA and HVA,1,7,1578,1578,0,
Skylab,9-ODA and HVA,1,7,1607,1610,3,
Skylab,9-ODA and HVA,1,7,1632,1634,2,
Skylab,9-ODA and HVA,1,7,1657,1658,1,
Skylab,9-ODA and HVA,1,7,1667,1669,2,
Skylab,9-ODA and HVA,1,7,1672,1672,0,
Skylab,9-ODA and HVA,1,7,1680,1681,1,
Skylab,9-ODA and HVA,1,7,1685,1685,0,
Skylab,9-ODA and HVA,1,7,1703,1704,1,
Skylab,9-ODA and HVA,1,7,1769,1783,14,
Skylab,9-ODA and HVA,1,7,1773,1773,0,
Skylab,9-ODA and HVA,1,7,1792,1796,4,
Skylab,9-ODA and HVA,2,7,5,6,1,
Skylab,9-ODA and HVA,2,7,16,21,5,
Skylab,9-ODA and HVA,2,7,30,31,1,
Skylab,9-ODA and HVA,2,7,69,72,3,
Skylab,9-ODA and HVA,2,7,96,97,1,
Skylab,9-ODA and HVA,2,7,118,133,15,
Skylab,9-ODA and HVA,2,7,136,141,5,
Skylab,9-ODA and HVA,2,7,143,143,0,
Skylab,9-ODA and HVA,2,7,154,156,2,bee sniffs from a distance i think
Skylab,9-ODA and HVA,2,7,178,182,4,
Skylab,9-ODA and HVA,2,7,197,197,0,
Skylab,9-ODA and HVA,2,7,230,233,3,
Skylab,9-ODA and HVA,2,7,270,270,0,
Skylab,9-ODA and HVA,2,7,282,283,1,
Skylab,9-ODA and HVA,2,7,335,335,0,
Skylab,9-ODA and HVA,2,7,354,356,2,
Skylab,9-ODA and HVA,2,7,216,219,3,
Skylab,9-ODA and HVA,2,7,437,437,0,
Skylab,9-ODA and HVA,2,7,440,443,3,
Skylab,9-ODA and HVA,2,7,492,493,1,
Skylab,9-ODA and HVA,2,7,527,527,0,
Skylab,9-ODA and HVA,2,7,551,552,1,
Skylab,9-ODA and HVA,2,7,282,286,4,
Skylab,9-ODA and HVA,2,7,622,624,2,
Skylab,9-ODA and HVA,2,7,895,898,3,bee sort of sniffing from afar
Skylab,9-ODA and HVA,2,7,918,919,1,
Skylab,9-ODA and HVA,2,7,939,944,5,
Skylab,9-ODA and HVA,2,7,1013,1013,0,
Skylab,9-ODA and HVA,2,7,1081,1082,1,
Skylab,9-ODA and HVA,2,7,1168,1170,2,
Skylab,9-ODA and HVA,2,7,1179,1179,0,
Skylab,9-ODA and HVA,2,7,1255,1255,0,
Skylab,9-ODA and HVA,2,7,1340,1340,0,
Skylab,9-ODA and HVA,2,7,1401,1408,7,
Skylab,9-ODA and HVA,2,7,1409,1410,1,
Skylab,9-ODA and HVA,2,7,1412,1412,0,
Skylab,9-ODA and HVA,2,7,1421,1424,3,
Skylab,9-ODA and HVA,2,7,1566,1566,0,
Skylab,9-ODA and HVA,2,7,1587,1588,1,
Skylab,9-ODA and HVA,2,7,1695,1697,2,
Skylab,9-ODA and HVA,2,7,1697,1759,62,
Skylab,9-ODA and HVA,3,7,0,65,65,
Skylab,9-ODA and HVA,3,7,13,14,1,
Skylab,9-ODA and HVA,3,7,20,20,0,
Skylab,9-ODA and HVA,3,7,25,26,1,
Skylab,9-ODA and HVA,3,7,70,70,0,
Skylab,9-ODA and HVA,3,7,81,82,1,
Skylab,9-ODA and HVA,3,7,154,155,1,
Skylab,9-ODA and HVA,3,7,195,195,0,
Skylab,9-ODA and HVA,3,7,214,215,1,
Skylab,9-ODA and HVA,3,7,303,307,4,
Skylab,9-ODA and HVA,3,7,319,319,0,
Skylab,9-ODA and HVA,3,7,329,330,1,
Skylab,9-ODA and HVA,3,7,342,342,0,
Skylab,9-ODA and HVA,3,7,358,360,2,
Skylab,9-ODA and HVA,3,7,383,383,0,
Skylab,9-ODA and HVA,3,7,420,423,3,
Skylab,9-ODA and HVA,3,7,428,429,1,
Skylab,9-ODA and HVA,3,7,431,437,6,
Skylab,9-ODA and HVA,3,7,465,465,0,
Skylab,9-ODA and HVA,3,7,492,492,0,
Skylab,9-ODA and HVA,3,7,518,519,1,
Skylab,9-ODA and HVA,3,7,619,619,0,
Skylab,9-ODA and HVA,3,7,630,632,2,
Skylab,9-ODA and HVA,3,7,682,683,1,
Skylab,9-ODA and HVA,3,7,710,712,2,
Skylab,9-ODA and HVA,3,7,726,1027,301,
Skylab,9-ODA and HVA,3,7,781,782,1,
Skylab,9-ODA and HVA,3,7,884,885,1,
Skylab,9-ODA and HVA,3,7,902,902,0,
Skylab,9-ODA and HVA,3,7,920,920,0,
Skylab,9-ODA and HVA,3,7,1119,1119,0,
Skylab,9-ODA and HVA,3,7,1126,1155,29,
Skylab,9-ODA and HVA,3,7,1140,1141,1,
Skylab,9-ODA and HVA,3,7,1165,1166,1,
Skylab,9-ODA and HVA,3,7,1169,1171,2,
Skylab,9-ODA and HVA,3,7,1228,1229,1,
Skylab,9-ODA and HVA,3,7,1259,1259,0,
Skylab,9-ODA and HVA,3,7,1314,1315,1,
Skylab,9-ODA and HVA,3,7,1319,1319,0,
Skylab,9-ODA and HVA,3,7,1325,1326,1,
Skylab,9-ODA and HVA,3,7,1333,1335,2,
Skylab,9-ODA and HVA,3,7,1341,1354,13,
Skylab,9-ODA and HVA,3,7,1445,1526,81,
Skylab,9-ODA and HVA,3,7,1530,1530,0,
Skylab,9-ODA and HVA,3,7,1580,1580,0,
Skylab,9-ODA and HVA,3,7,1563,1612,49,
Skylab,9-ODA and HVA,3,7,1591,1591,0,
Skylab,9-ODA and HVA,3,7,1556,1597,41,bee sits still facing paper a little distance from it
Skylab,9-ODA and HVA,3,7,1608,1608,0,
Skylab,9-ODA and HVA,3,7,1612,1612,0,
Skylab,9-ODA and HVA,3,7,1628,1632,4,
Skylab,9-ODA and HVA,3,7,1637,1640,3,
Skylab,9-ODA and HVA,3,7,1640,1647,7,
Skylab,9-ODA and HVA,3,7,1658,1659,1,
Skylab,9-ODA and HVA,3,7,1661,1662,1,
Skylab,9-ODA and HVA,3,7,1665,1669,4,
Skylab,9-ODA and HVA,3,7,1712,1712,0,
Skylab,9-ODA and HVA,3,7,1722,1722,0,
Skylab,9-ODA and HVA,3,7,1732,1733,1,
Skylab,9-ODA and HVA,3,7,1748,1749,1,
Skylab,9-ODA and HVA,3,7,1764,1765,1,
Skylab,9-ODA and HVA,3,7,1764,1766,2,
Skylab,9-ODA and HVA,3,7,1768,1769,1,
Skylab,9-ODA and HVA,3,7,1788,1790,2,
Skylab,9-ODA and HVA,3,7,1792,1794,2,
Skylab,9-ODA and HVA,10,7,86,87,1,bee sort of sniff from afar
Skylab,9-ODA and HVA,10,7,120,121,1,
Skylab,9-ODA and HVA,10,7,132,133,1,
Skylab,9-ODA and HVA,10,7,150,150,0,
Skylab,9-ODA and HVA,10,7,151,159,8,
Skylab,9-ODA and HVA,10,7,168,168,0,
Skylab,9-ODA and HVA,10,7,199,212,13,
Skylab,9-ODA and HVA,10,7,236,237,1,
Skylab,9-ODA and HVA,10,7,274,274,0,
Skylab,9-ODA and HVA,10,7,308,311,3,
Skylab,9-ODA and HVA,10,7,321,324,3,
Skylab,9-ODA and HVA,10,7,351,353,2,
Skylab,9-ODA and HVA,10,7,383,387,4,
Skylab,9-ODA and HVA,10,7,390,392,2,
Skylab,9-ODA and HVA,10,7,449,451,2,
Skylab,9-ODA and HVA,10,7,462,470,8,
Skylab,9-ODA and HVA,10,7,474,478,4,
Skylab,9-ODA and HVA,10,7,603,608,5,
Skylab,9-ODA and HVA,10,7,608,610,2,
Skylab,9-ODA and HVA,10,7,682,689,7,
Skylab,9-ODA and HVA,10,7,682,682,0,
Skylab,9-ODA and HVA,10,7,696,698,2,
Skylab,9-ODA and HVA,10,7,699,700,1,
Skylab,9-ODA and HVA,10,7,732,732,0,
Skylab,9-ODA and HVA,10,7,807,807,0,
Skylab,9-ODA and HVA,10,7,867,867,0,
Skylab,9-ODA and HVA,10,7,919,919,0,
Skylab,9-ODA and HVA,10,7,974,991,17,
Skylab,9-ODA and HVA,10,7,981,981,0,
Skylab,9-ODA and HVA,10,7,1014,1017,3,
Skylab,9-ODA and HVA,10,7,1019,1020,1,
Skylab,9-ODA and HVA,10,7,1026,1028,2,
Skylab,9-ODA and HVA,10,7,1037,1038,1,
Skylab,9-ODA and HVA,10,7,1050,1052,2,
Skylab,9-ODA and HVA,10,7,1079,1084,5,
Skylab,9-ODA and HVA,10,7,1113,1116,3,
Skylab,9-ODA and HVA,10,7,1126,1143,17,
Skylab,9-ODA and HVA,10,7,1172,1173,1,
Skylab,9-ODA and HVA,10,7,1204,1204,0,
Skylab,9-ODA and HVA,10,7,1209,1210,1,
Skylab,9-ODA and HVA,10,7,1255,1255,0,
Skylab,9-ODA and HVA,10,7,1272,1272,0,
Skylab,9-ODA and HVA,10,7,1311,1312,1,
Skylab,9-ODA and HVA,10,7,1321,1328,7,
Skylab,9-ODA and HVA,10,7,1345,1348,3,
Skylab,9-ODA and HVA,10,7,1350,1350,0,
Skylab,9-ODA and HVA,10,7,1360,1361,1,
Skylab,9-ODA and HVA,10,7,1368,1368,0,
Skylab,9-ODA and HVA,10,7,1530,1552,22,
Skylab,9-ODA and HVA,10,7,1535,1596,61,
Skylab,9-ODA and HVA,10,7,1664,1664,0,
Skylab,9-ODA and HVA,10,7,1737,1742,5,
Skylab,9-ODA and HVA,10,7,1752,1752,0,
Skylab,9-ODA and HVA,12,6,87,92,5,
Skylab,9-ODA and HVA,12,6,97,98,1,
Skylab,9-ODA and HVA,12,6,125,125,0,
Skylab,9-ODA and HVA,12,6,126,127,1,
Skylab,9-ODA and HVA,12,6,132,132,0,
Skylab,9-ODA and HVA,12,6,145,148,3,
Skylab,9-ODA and HVA,12,6,381,382,1,
Skylab,9-ODA and HVA,12,6,477,477,0,
Skylab,9-ODA and HVA,12,6,479,479,0,
Skylab,9-ODA and HVA,12,6,481,484,3,
Skylab,9-ODA and HVA,12,6,560,560,0,
Skylab,9-ODA and HVA,12,6,749,749,0,
Skylab,9-ODA and HVA,12,6,755,755,0,
Skylab,9-ODA and HVA,12,6,760,762,2,
Skylab,9-ODA and HVA,12,6,849,849,0,
Skylab,9-ODA and HVA,12,6,855,855,0,
Skylab,9-ODA and HVA,12,6,857,858,1,
Skylab,9-ODA and HVA,12,6,892,894,2,
Skylab,9-ODA and HVA,12,6,900,900,0,
Skylab,9-ODA and HVA,12,6,980,981,1,
Skylab,9-ODA and HVA,12,6,1046,1046,0,
Skylab,9-ODA and HVA,12,6,1098,1105,7,
Skylab,9-ODA and HVA,12,6,1110,1110,0,
Skylab,9-ODA and HVA,12,6,1115,1118,3,
Skylab,9-ODA and HVA,12,6,1122,1123,1,bee crawls over paper
Skylab,9-ODA and HVA,12,6,1136,1139,3,
Skylab,9-ODA and HVA,12,6,1144,1144,0,
Skylab,9-ODA and HVA,12,6,1147,1147,0,
Skylab,9-ODA and HVA,12,6,1175,1175,0,sideways touch
Skylab,9-ODA and HVA,12,6,1236,1236,0,
Skylab,9-ODA and HVA,12,6,1270,1274,4,
Skylab,9-ODA and HVA,12,6,1278,1278,0,
Skylab,9-ODA and HVA,12,6,1306,1309,3,
Skylab,9-ODA and HVA,12,6,1338,1338,0,
Skylab,9-ODA and HVA,12,6,1344,1344,0,
Skylab,9-ODA and HVA,12,6,1363,1371,8,
Skylab,9-ODA and HVA,12,6,1399,1399,0,
Skylab,9-ODA and HVA,12,6,1455,1457,2,
Skylab,9-ODA and HVA,12,6,1458,1458,0,
Skylab,9-ODA and HVA,12,6,1633,1634,1,
Skylab,9-ODA and HVA,13,3,80,81,1,
Skylab,9-ODA and HVA,13,3,146,146,0,
Skylab,9-ODA and HVA,13,3,207,209,2,
Skylab,9-ODA and HVA,13,3,229,229,0,
Skylab,9-ODA and HVA,13,3,264,265,1,
Skylab,9-ODA and HVA,13,3,319,324,5,
Skylab,9-ODA and HVA,13,3,453,454,1,
Skylab,9-ODA and HVA,13,3,529,529,0,
Skylab,9-ODA and HVA,13,3,607,608,1,bee moves paper with its legs
Skylab,9-ODA and HVA,13,3,619,625,6,
Skylab,9-ODA and HVA,13,3,729,729,0,
Skylab,9-ODA and HVA,13,3,736,738,2,
Skylab,9-ODA and HVA,13,3,822,822,0,
Skylab,9-ODA and HVA,13,3,936,1100,164,bee sits still facing paper a short distance from it
Skylab,9-ODA and HVA,13,3,1033,1034,1,
Skylab,9-ODA and HVA,13,3,1089,1091,2,
Skylab,9-ODA and HVA,13,3,1113,1114,1,maybe not - faces paper from a distance
Skylab,9-ODA and HVA,13,3,1152,1153,1,
Skylab,9-ODA and HVA,13,3,1218,1220,2,"ramains facing paper until 20:25, seems not interrested though"
Skylab,9-ODA and HVA,13,3,1256,1269,13,
Skylab,9-ODA and HVA,13,3,1260,1262,2,
Skylab,9-ODA and HVA,13,3,1264,1266,2,
Skylab,9-ODA and HVA,13,3,1268,1268,0,
Skylab,9-ODA and HVA,13,3,1276,1278,2,
Skylab,9-ODA and HVA,13,3,1276,1278,2,
Skylab,9-ODA and HVA,13,3,1285,1287,2,
Skylab,9-ODA and HVA,13,3,1335,1335,0,
Skylab,9-ODA and HVA,13,3,1353,1354,1,
Skylab,9-ODA and HVA,13,3,1569,1570,1,maybe not - faces paper from a distance
Skylab,9-ODA and HVA,13,3,1587,1595,8,
Skylab,9-ODA and HVA,13,3,1595,1596,1,
Skylab,9-ODA and HVA,13,3,1629,1631,2,
Skylab,9-ODA and HVA,13,3,1648,1657,9,27:47 bee sits near mpaper for a bit longer than it sniffs anf it is actually mostly still
Skylab,9-ODA and HVA,13,3,1684,1685,1,
Skylab,9-ODA and HVA,13,3,1708,1709,1,
Skylab,9-ODA and HVA,13,3,1725,1725,0,
Skylab,9-ODA and HVA,13,3,1727,1728,1,
Skylab,9-ODA and HVA,13,3,1765,1767,2,
Skylab,9-ODA and HVA,15,8,5,10,5,
Skylab,9-ODA and HVA,15,8,12,13,1,
Skylab,9-ODA and HVA,15,8,31,33,2,
Skylab,9-ODA and HVA,15,8,104,104,0,
Skylab,9-ODA and HVA,15,8,119,119,0,
Skylab,9-ODA and HVA,15,8,124,125,1,
Skylab,9-ODA and HVA,15,8,153,160,7,
Skylab,9-ODA and HVA,15,8,182,183,1,
Skylab,9-ODA and HVA,15,8,203,204,1,
Skylab,9-ODA and HVA,15,8,207,207,0,
Skylab,9-ODA and HVA,15,8,207,212,5,
Skylab,9-ODA and HVA,15,8,220,223,3,
Skylab,9-ODA and HVA,15,8,328,329,1,
Skylab,9-ODA and HVA,15,8,357,360,3,
Skylab,9-ODA and HVA,15,8,372,372,0,
Skylab,9-ODA and HVA,15,8,385,393,8,
Skylab,9-ODA and HVA,15,8,390,396,6,
Skylab,9-ODA and HVA,15,8,451,456,5,
Skylab,9-ODA and HVA,15,8,462,463,1,
Skylab,9-ODA and HVA,15,8,477,478,1,
Skylab,9-ODA and HVA,15,8,516,528,12,
Skylab,9-ODA and HVA,15,8,533,552,19,
Skylab,9-ODA and HVA,15,8,556,564,8,
Skylab,9-ODA and HVA,15,8,576,577,1,
Skylab,9-ODA and HVA,15,8,618,623,5,
Skylab,9-ODA and HVA,15,8,641,646,5,
Skylab,9-ODA and HVA,15,8,644,647,3,
Skylab,9-ODA and HVA,15,8,674,674,0,
Skylab,9-ODA and HVA,15,8,685,687,2,
Skylab,9-ODA and HVA,15,8,722,729,7,
Skylab,9-ODA and HVA,15,8,731,732,1,
Skylab,9-ODA and HVA,15,8,737,748,11,
Skylab,9-ODA and HVA,15,8,751,765,14,
Skylab,9-ODA and HVA,15,8,768,774,6,
Skylab,9-ODA and HVA,15,8,774,776,2,
Skylab,9-ODA and HVA,15,8,772,772,0,not sure
Skylab,9-ODA and HVA,15,8,901,903,2,
Skylab,9-ODA and HVA,15,8,911,923,12,
Skylab,9-ODA and HVA,15,8,933,939,6,
Skylab,9-ODA and HVA,15,8,1014,1016,2,
Skylab,9-ODA and HVA,15,8,1054,1055,1,
Skylab,9-ODA and HVA,15,8,1060,1066,6,
Skylab,9-ODA and HVA,15,8,1067,1069,2,
Skylab,9-ODA and HVA,15,8,1079,1080,1,
Skylab,9-ODA and HVA,15,8,1127,1128,1,
Skylab,9-ODA and HVA,15,8,1130,1134,4,
Skylab,9-ODA and HVA,15,8,1161,1163,2,
Skylab,9-ODA and HVA,15,8,1169,1171,2,
Skylab,9-ODA and HVA,15,8,1265,1265,0,
Skylab,9-ODA and HVA,15,8,1266,1270,4,
Skylab,9-ODA and HVA,15,8,1289,1289,0,
Skylab,9-ODA and HVA,15,8,1296,1296,0,
Skylab,9-ODA and HVA,15,8,1304,1306,2,
Skylab,9-ODA and HVA,15,8,1309,1309,0,"not sure, bumps in to paper"
Skylab,9-ODA and HVA,15,8,1332,1335,3,
Skylab,9-ODA and HVA,15,8,1364,1366,2,
Skylab,9-ODA and HVA,15,8,1322,1324,2,
Skylab,9-ODA and HVA,15,8,1418,1418,0,
Skylab,9-ODA and HVA,15,8,1437,1440,3,
Skylab,9-ODA and HVA,15,8,1445,1448,3,
Skylab,9-ODA and HVA,15,8,1503,1505,2,
Skylab,9-ODA and HVA,15,8,1506,1507,1,
Skylab,9-ODA and HVA,15,8,1573,1586,13,
Skylab,9-ODA and HVA,15,8,1603,1603,0,
Skylab,9-ODA and HVA,15,8,1092,1093,1,
Skylab,9-ODA and HVA,15,8,1698,1701,3,
Skylab,9-ODA and HVA,15,8,1728,1778,50,
Skylab,9-ODA and HVA,15,8,1772,1772,0,
Skylab,9-ODA and HVA,16,5,0,1,1,
Skylab,9-ODA and HVA,16,5,20,21,1,
Skylab,9-ODA and HVA,16,5,42,43,1,
Skylab,9-ODA and HVA,16,5,97,98,1,
Skylab,9-ODA and HVA,16,5,115,116,1,
Skylab,9-ODA and HVA,16,5,158,162,4,
Skylab,9-ODA and HVA,16,5,195,196,1,
Skylab,9-ODA and HVA,16,5,211,213,2,
Skylab,9-ODA and HVA,16,5,219,224,5,
Skylab,9-ODA and HVA,16,5,350,353,3,
Skylab,9-ODA and HVA,16,5,246,249,3,
Skylab,9-ODA and HVA,16,5,251,254,3,
Skylab,9-ODA and HVA,16,5,255,275,20,"4:32 to 4:35 is actual contact with the paper, for the rest of the time period it is sniffing from afar"
Skylab,9-ODA and HVA,16,5,285,291,6,
Skylab,9-ODA and HVA,16,5,339,340,1,
Skylab,9-ODA and HVA,16,5,381,392,11,"6:29 to 6:32 is actual contact with the paper, the rest of the time period is the bee sniffing from afar"
Skylab,9-ODA and HVA,16,5,404,476,72,
Skylab,9-ODA and HVA,16,5,414,414,0,
Skylab,9-ODA and HVA,16,5,433,445,12,
Skylab,9-ODA and HVA,16,5,477,479,2,
Skylab,9-ODA and HVA,16,5,503,551,48,
Skylab,9-ODA and HVA,16,5,526,541,15,
Skylab,9-ODA and HVA,16,5,555,559,4,
Skylab,9-ODA and HVA,16,5,572,585,13,
Skylab,9-ODA and HVA,16,5,591,645,54,
Skylab,9-ODA and HVA,16,5,623,623,0,
Skylab,9-ODA and HVA,16,5,630,1232,602,
Skylab,9-ODA and HVA,16,5,651,659,8,
Skylab,9-ODA and HVA,16,5,682,692,10,
Skylab,9-ODA and HVA,16,5,682,702,20,
Skylab,9-ODA and HVA,16,5,696,698,2,
Skylab,9-ODA and HVA,16,5,748,749,1,
Skylab,9-ODA and HVA,16,5,840,854,14,
Skylab,9-ODA and HVA,16,5,857,955,98,
Skylab,9-ODA and HVA,16,5,910,963,53,
Skylab,9-ODA and HVA,16,5,963,990,27,
Skylab,9-ODA and HVA,16,5,963,993,30,
Skylab,9-ODA and HVA,16,5,1028,1043,15,
Skylab,9-ODA and HVA,16,5,1028,1080,52,
Skylab,9-ODA and HVA,16,5,1088,1097,9,
Skylab,9-ODA and HVA,16,5,1110,1112,2,
Skylab,9-ODA and HVA,16,5,1123,1125,2,
Skylab,9-ODA and HVA,16,5,1128,1141,13,
Skylab,9-ODA and HVA,16,5,1143,1151,8,
Skylab,9-ODA and HVA,16,5,1167,1173,6,
Skylab,9-ODA and HVA,16,5,1174,1273,99,
Skylab,9-ODA and HVA,16,5,1179,1182,3,
Skylab,9-ODA and HVA,16,5,1192,1198,6,
Skylab,9-ODA and HVA,16,5,1212,1219,7,
Skylab,9-ODA and HVA,16,5,1231,1256,25,
Skylab,9-ODA and HVA,16,5,1250,1250,0,
Skylab,9-ODA and HVA,16,5,1261,1263,2,
Skylab,9-ODA and HVA,16,5,1268,1271,3,
Skylab,9-ODA and HVA,16,5,1295,1300,5,sniffing from afar for most of this time
Skylab,9-ODA and HVA,16,5,1312,1342,30,
Skylab,9-ODA and HVA,16,5,1346,1350,4,
Skylab,9-ODA and HVA,16,5,1357,1454,97,
Skylab,9-ODA and HVA,16,5,1428,1432,4,
Skylab,9-ODA and HVA,16,5,1435,1436,1,
Skylab,9-ODA and HVA,16,5,1448,1461,13,
Skylab,9-ODA and HVA,16,5,1466,1467,1,
Skylab,9-ODA and HVA,16,5,1522,1526,4,
Skylab,9-ODA and HVA,16,5,1546,1600,54,
Skylab,9-ODA and HVA,16,5,1611,1612,1,
Skylab,9-ODA and HVA,16,5,1621,1621,0,
Skylab,9-ODA and HVA,17,1,12,13,1,
Skylab,9-ODA and HVA,17,1,30,30,0,
Skylab,9-ODA and HVA,17,1,37,37,0,
Skylab,9-ODA and HVA,17,1,58,58,0,
Skylab,9-ODA and HVA,17,1,81,83,2,
Skylab,9-ODA and HVA,17,1,101,101,0,
Skylab,9-ODA and HVA,17,1,106,107,1,
Skylab,9-ODA and HVA,17,1,124,124,0,
Skylab,9-ODA and HVA,17,1,162,162,0,
Skylab,9-ODA and HVA,17,1,215,215,0,
Skylab,9-ODA and HVA,17,1,272,273,1,
Skylab,9-ODA and HVA,17,1,309,310,1,
Skylab,9-ODA and HVA,17,1,390,392,2,
Skylab,9-ODA and HVA,17,1,434,434,0,
Skylab,9-ODA and HVA,17,1,443,443,0,
Skylab,9-ODA and HVA,17,1,465,467,2,
Skylab,9-ODA and HVA,17,1,470,470,0,
Skylab,9-ODA and HVA,17,1,474,474,0,
Skylab,9-ODA and HVA,17,1,478,479,1,
Skylab,9-ODA and HVA,17,1,510,511,1,
Skylab,9-ODA and HVA,17,1,575,578,3,
Skylab,9-ODA and HVA,17,1,579,581,2,
Skylab,9-ODA and HVA,17,1,621,621,0,
Skylab,9-ODA and HVA,17,1,626,630,4,
Skylab,9-ODA and HVA,17,1,655,658,3,
Skylab,9-ODA and HVA,17,1,664,664,0,
Skylab,9-ODA and HVA,17,1,690,691,1,
Skylab,9-ODA and HVA,17,1,705,708,3,
Skylab,9-ODA and HVA,17,1,759,761,2,
Skylab,9-ODA and HVA,17,1,764,765,1,
Skylab,9-ODA and HVA,17,1,783,784,1,
Skylab,9-ODA and HVA,17,1,792,793,1,
Skylab,9-ODA and HVA,17,1,818,819,1,
Skylab,9-ODA and HVA,17,1,826,827,1,
Skylab,9-ODA and HVA,17,1,850,850,0,
Skylab,9-ODA and HVA,17,1,896,899,3,
Skylab,9-ODA and HVA,17,1,934,934,0,
Skylab,9-ODA and HVA,17,1,938,938,0,not too sure
Skylab,9-ODA and HVA,17,1,941,941,0,
Skylab,9-ODA and HVA,17,1,949,950,1,
Skylab,9-ODA and HVA,17,1,971,971,0,
Skylab,9-ODA and HVA,17,1,1035,1035,0,
Skylab,9-ODA and HVA,17,1,1036,1036,0,
Skylab,9-ODA and HVA,17,1,1041,1042,1,not too sure
Skylab,9-ODA and HVA,17,1,1055,1055,0,
Skylab,9-ODA and HVA,17,1,1141,1143,2,
Skylab,9-ODA and HVA,17,1,1148,1151,3,
Skylab,9-ODA and HVA,17,1,1172,1172,0,
Skylab,9-ODA and HVA,17,1,1182,1183,1,
Skylab,9-ODA and HVA,17,1,1186,1187,1,
Skylab,9-ODA and HVA,17,1,1203,1205,2,
Skylab,9-ODA and HVA,17,1,1207,1210,3,
Skylab,9-ODA and HVA,17,1,1217,1217,0,not sure
Skylab,9-ODA and HVA,17,1,1228,1228,0,
Skylab,9-ODA and HVA,17,1,1241,1241,0,
Skylab,9-ODA and HVA,17,1,1249,1253,4,really not sure bee maybe sniffing from a distance
Skylab,9-ODA and HVA,17,1,1266,1271,5,
Skylab,9-ODA and HVA,17,1,1284,1287,3,
Skylab,9-ODA and HVA,17,1,1295,1298,3,
Skylab,9-ODA and HVA,17,1,1333,1333,0,
Skylab,9-ODA and HVA,17,1,1339,1339,0,
Skylab,9-ODA and HVA,17,1,1363,1365,2,
Skylab,9-ODA and HVA,17,1,1380,1381,1,
Skylab,9-ODA and HVA,17,1,1406,1410,4,
Skylab,9-ODA and HVA,17,1,1431,1431,0,
Skylab,9-ODA and HVA,17,1,1439,1440,1,
Skylab,9-ODA and HVA,17,1,1525,1527,2,
Skylab,9-ODA and HVA,17,1,1531,1531,0,
Skylab,9-ODA and HVA,17,1,1622,1623,1,
Skylab,9-ODA and HVA,17,1,1764,1766,2,
Skylab,9-ODA and HVA,17,1,1770,1775,5,
Skylab,9-ODA and HVA,17,1,1784,1785,1,
Skylab,9-ODA and 9-HDA,1,1,12,14,2,
Skylab,9-ODA and 9-HDA,1,1,56,58,2,
Skylab,9-ODA and 9-HDA,1,1,71,72,1,
Skylab,9-ODA and 9-HDA,1,1,79,79,0,
Skylab,9-ODA and 9-HDA,1,1,95,95,0,
Skylab,9-ODA and 9-HDA,1,1,98,101,3,
Skylab,9-ODA and 9-HDA,1,1,127,130,3,
Skylab,9-ODA and 9-HDA,1,1,139,140,1,
Skylab,9-ODA and 9-HDA,1,1,179,179,0,
Skylab,9-ODA and 9-HDA,1,1,202,202,0,
Skylab,9-ODA and 9-HDA,1,1,225,234,9,
Skylab,9-ODA and 9-HDA,1,1,228,229,1,
Skylab,9-ODA and 9-HDA,1,1,234,234,0,
Skylab,9-ODA and 9-HDA,1,1,237,243,6,
Skylab,9-ODA and 9-HDA,1,1,254,255,1,
Skylab,9-ODA and 9-HDA,1,1,274,275,1,
Skylab,9-ODA and 9-HDA,1,1,359,359,0,
Skylab,9-ODA and 9-HDA,1,1,441,442,1,
Skylab,9-ODA and 9-HDA,1,1,445,446,1,
Skylab,9-ODA and 9-HDA,1,1,512,514,2,
Skylab,9-ODA and 9-HDA,1,1,557,558,1,
Skylab,9-ODA and 9-HDA,1,1,563,564,1,bee sniffs from afar
Skylab,9-ODA and 9-HDA,1,1,566,569,3,
Skylab,9-ODA and 9-HDA,1,1,570,573,3,
Skylab,9-ODA and 9-HDA,1,1,577,577,0,
Skylab,9-ODA and 9-HDA,1,1,592,593,1,
Skylab,9-ODA and 9-HDA,1,1,611,612,1,
Skylab,9-ODA and 9-HDA,1,1,632,632,0,
Skylab,9-ODA and 9-HDA,1,1,651,651,0,
Skylab,9-ODA and 9-HDA,1,1,680,681,1,
Skylab,9-ODA and 9-HDA,1,1,699,699,0,
Skylab,9-ODA and 9-HDA,1,1,734,736,2,
Skylab,9-ODA and 9-HDA,1,1,802,803,1,
Skylab,9-ODA and 9-HDA,1,1,830,834,4,
Skylab,9-ODA and 9-HDA,1,1,837,837,0,
Skylab,9-ODA and 9-HDA,1,1,877,877,0,
Skylab,9-ODA and 9-HDA,1,1,1127,1127,0,
Skylab,9-ODA and 9-HDA,1,1,1154,1159,5,
Skylab,9-ODA and 9-HDA,1,1,1181,1183,2,
Skylab,9-ODA and 9-HDA,1,1,1205,1206,1,
Skylab,9-ODA and 9-HDA,1,1,1231,1231,0,
Skylab,9-ODA and 9-HDA,1,1,1233,1233,0,
Skylab,9-ODA and 9-HDA,1,1,1263,1265,2,
Skylab,9-ODA and 9-HDA,1,1,1322,1322,0,
Skylab,9-ODA and 9-HDA,1,1,1352,1353,1,
Skylab,9-ODA and 9-HDA,1,1,1427,1430,3,
Skylab,9-ODA and 9-HDA,1,1,1451,1454,3,
Skylab,9-ODA and 9-HDA,1,1,1478,1480,2,
Skylab,9-ODA and 9-HDA,1,1,1495,1496,1,
Skylab,9-ODA and 9-HDA,1,1,1519,1519,0,
Skylab,9-ODA and 9-HDA,1,1,1679,1680,1,
Skylab,9-ODA and 9-HDA,1,1,1700,1700,0,
Skylab,9-ODA and 9-HDA,1,1,1734,1736,2,
Skylab,9-ODA and 9-HDA,2,1,357,359,2,
Skylab,9-ODA and 9-HDA,2,1,385,391,6,
Skylab,9-ODA and 9-HDA,2,1,441,444,3,
Skylab,9-ODA and 9-HDA,2,1,477,478,1,
Skylab,9-ODA and 9-HDA,2,1,480,481,1,
Skylab,9-ODA and 9-HDA,2,1,499,499,0,
Skylab,9-ODA and 9-HDA,2,1,532,534,2,
Skylab,9-ODA and 9-HDA,2,1,539,539,0,
Skylab,9-ODA and 9-HDA,2,1,542,542,0,
Skylab,9-ODA and 9-HDA,2,1,581,582,1,
Skylab,9-ODA and 9-HDA,2,1,587,590,3,
Skylab,9-ODA and 9-HDA,2,1,608,608,0,
Skylab,9-ODA and 9-HDA,2,1,647,647,0,
Skylab,9-ODA and 9-HDA,2,1,649,650,1,
Skylab,9-ODA and 9-HDA,2,1,657,657,0,
Skylab,9-ODA and 9-HDA,2,1,660,667,7,
Skylab,9-ODA and 9-HDA,2,1,783,785,2,
Skylab,9-ODA and 9-HDA,2,1,920,935,15,bee sniffs at paper from afar
Skylab,9-ODA and 9-HDA,2,1,981,981,0,
Skylab,9-ODA and 9-HDA,2,1,996,999,3,
Skylab,9-ODA and 9-HDA,2,1,1025,1025,0,
Skylab,9-ODA and 9-HDA,2,1,1059,1059,0,
Skylab,9-ODA and 9-HDA,2,1,1090,1090,0,
Skylab,9-ODA and 9-HDA,2,1,1238,1240,2,
Skylab,9-ODA and 9-HDA,2,1,1249,1249,0,
Skylab,9-ODA and 9-HDA,2,1,1278,1278,0,
Skylab,9-ODA and 9-HDA,2,1,1320,1323,3,
Skylab,9-ODA and 9-HDA,2,1,1419,1487,68,
Skylab,9-ODA and 9-HDA,2,1,1554,1555,1,
Skylab,9-ODA and 9-HDA,2,1,1723,1747,24,
Skylab,9-ODA and 9-HDA,2,1,1728,1730,2,
Skylab,9-ODA and 9-HDA,2,1,1765,1768,3,
Skylab,9-ODA and 9-HDA,2,1,1780,1780,0,
Skylab,9-ODA and 9-HDA,3,6,157,159,2,
Skylab,9-ODA and 9-HDA,3,6,173,174,1,
Skylab,9-ODA and 9-HDA,3,6,179,179,0,
Skylab,9-ODA and 9-HDA,3,6,370,370,0,
Skylab,9-ODA and 9-HDA,3,6,379,379,0,
Skylab,9-ODA and 9-HDA,3,6,388,389,1,
Skylab,9-ODA and 9-HDA,3,6,509,511,2,
Skylab,9-ODA and 9-HDA,3,6,532,533,1,
Skylab,9-ODA and 9-HDA,3,6,544,544,0,
Skylab,9-ODA and 9-HDA,3,6,589,589,0,
Skylab,9-ODA and 9-HDA,3,6,637,643,6,
Skylab,9-ODA and 9-HDA,3,6,646,649,3,
Skylab,9-ODA and 9-HDA,3,6,714,717,3,
Skylab,9-ODA and 9-HDA,3,6,876,879,3,
Skylab,9-ODA and 9-HDA,3,6,904,905,1,
Skylab,9-ODA and 9-HDA,3,6,962,964,2,
Skylab,9-ODA and 9-HDA,3,6,1234,1234,0,
Skylab,9-ODA and 9-HDA,3,6,1280,1327,47,
Skylab,9-ODA and 9-HDA,3,6,1323,1342,19,
Skylab,9-ODA and 9-HDA,3,6,1344,1345,1,
Skylab,9-ODA and 9-HDA,3,6,1347,1352,5,
Skylab,9-ODA and 9-HDA,3,6,1361,1366,5,
Skylab,9-ODA and 9-HDA,3,6,1370,1372,2,
Skylab,9-ODA and 9-HDA,3,6,1323,1323,0,
Skylab,9-ODA and 9-HDA,3,6,1400,1401,1,
Skylab,9-ODA and 9-HDA,3,6,1439,1441,2,
Skylab,9-ODA and 9-HDA,3,6,1446,1450,4,
Skylab,9-ODA and 9-HDA,3,6,1459,1462,3,
Skylab,9-ODA and 9-HDA,3,6,1471,1472,1,
Skylab,9-ODA and 9-HDA,3,6,1476,1478,2,
Skylab,9-ODA and 9-HDA,3,6,1484,1485,1,
Skylab,9-ODA and 9-HDA,3,6,1498,1499,1,
Skylab,9-ODA and 9-HDA,3,6,1510,1512,2,
Skylab,9-ODA and 9-HDA,3,6,1524,1525,1,
Skylab,9-ODA and 9-HDA,3,6,1530,1530,0,
Skylab,9-ODA and 9-HDA,3,6,1549,1550,1,
Skylab,9-ODA and 9-HDA,3,6,1623,1626,3,
Skylab,9-ODA and 9-HDA,3,6,1667,1670,3,
Skylab,9-ODA and 9-HDA,3,6,1671,1671,0,
Skylab,9-ODA and 9-HDA,3,6,1704,1709,5,
Skylab,9-ODA and 9-HDA,3,6,1740,1743,3,
Skylab,9-ODA and 9-HDA,10,1,7,7,0,
Skylab,9-ODA and 9-HDA,10,1,90,91,1,
Skylab,9-ODA and 9-HDA,10,1,143,144,1,
Skylab,9-ODA and 9-HDA,10,1,296,296,0,
Skylab,9-ODA and 9-HDA,10,1,333,335,2,
Skylab,9-ODA and 9-HDA,10,1,454,454,0,
Skylab,9-ODA and 9-HDA,10,1,507,508,1,
Skylab,9-ODA and 9-HDA,10,1,534,534,0,accidental bump?
Skylab,9-ODA and 9-HDA,10,1,653,654,1,
Skylab,9-ODA and 9-HDA,10,1,832,832,0,
Skylab,9-ODA and 9-HDA,10,1,884,884,0,
Skylab,9-ODA and 9-HDA,10,1,941,941,0,
Skylab,9-ODA and 9-HDA,10,1,977,978,1,
Skylab,9-ODA and 9-HDA,10,1,1215,1215,0,
Skylab,9-ODA and 9-HDA,10,1,1223,1227,4,
Skylab,9-ODA and 9-HDA,10,1,1232,1233,1,
Skylab,9-ODA and 9-HDA,10,1,1237,1239,2,
Skylab,9-ODA and 9-HDA,10,1,1296,1296,0,
Skylab,9-ODA and 9-HDA,10,1,1362,1363,1,
Skylab,9-ODA and 9-HDA,10,1,1396,1396,0,
Skylab,9-ODA and 9-HDA,10,1,1504,1504,0,
Skylab,9-ODA and 9-HDA,10,1,1518,1533,15,bee seems to be paying attention to the paper - it is quite far away from it though
Skylab,9-ODA and 9-HDA,10,1,1559,1562,3,
Skylab,9-ODA and 9-HDA,10,1,1505,1566,61,
Skylab,9-ODA and 9-HDA,10,1,1636,1637,1,
Skylab,9-ODA and 9-HDA,10,1,1679,1681,2,
Skylab,9-ODA and 9-HDA,10,1,1721,1722,1,
Skylab,9-ODA and 9-HDA,10,1,1725,1725,0,
Skylab,9-ODA and 9-HDA,10,1,1748,1749,1,
Skylab,9-ODA and 9-HDA,10,1,1754,1754,0,
Skylab,9-ODA and 9-HDA,10,1,1773,1773,0,
Skylab,9-ODA and 9-HDA,10,1,1787,1787,0,
Skylab,9-ODA and 9-HDA,10,1,1788,1789,1,
Skylab,9-ODA and 9-HDA,12,12,20,24,4,
Skylab,9-ODA and 9-HDA,12,12,107,114,7,
Skylab,9-ODA and 9-HDA,12,12,144,145,1,
Skylab,9-ODA and 9-HDA,12,12,180,180,0,
Skylab,9-ODA and 9-HDA,12,12,237,239,2,bee not quite touching
Skylab,9-ODA and 9-HDA,12,12,249,249,0,
Skylab,9-ODA and 9-HDA,12,12,256,258,2,bee not quite touching not sure if it counts
Skylab,9-ODA and 9-HDA,12,12,268,268,0,
Skylab,9-ODA and 9-HDA,12,12,297,297,0,
Skylab,9-ODA and 9-HDA,12,12,307,308,1,
Skylab,9-ODA and 9-HDA,12,12,312,713,401,bee sits still near paper
Skylab,9-ODA and 9-HDA,12,12,494,494,0,
Skylab,9-ODA and 9-HDA,12,12,497,497,0,
Skylab,9-ODA and 9-HDA,12,12,698,708,10,
Skylab,9-ODA and 9-HDA,12,12,757,759,2,
Skylab,9-ODA and 9-HDA,12,12,771,771,0,
Skylab,9-ODA and 9-HDA,12,12,806,809,3,
Skylab,9-ODA and 9-HDA,12,12,840,841,1,
Skylab,9-ODA and 9-HDA,12,12,1166,1166,0,
Skylab,9-ODA and 9-HDA,12,12,1167,1214,47,
Skylab,9-ODA and 9-HDA,12,12,1172,1177,5,
Skylab,9-ODA and 9-HDA,12,12,1186,1186,0,
Skylab,9-ODA and 9-HDA,12,12,1221,1223,2,
Skylab,9-ODA and 9-HDA,12,12,1233,1834,601,
Skylab,9-ODA and 9-HDA,12,12,1263,1264,1,
Skylab,9-ODA and 9-HDA,12,12,1297,1297,0,
Skylab,9-ODA and 9-HDA,12,12,1322,1324,2,
Skylab,9-ODA and 9-HDA,12,12,1325,1327,2,
Skylab,9-ODA and 9-HDA,12,12,1448,1450,2,
Skylab,9-ODA and 9-HDA,12,12,1464,1464,0,
Skylab,9-ODA and 9-HDA,12,12,1472,1494,22,
Skylab,9-ODA and 9-HDA,12,12,1490,1490,0,
Skylab,9-ODA and 9-HDA,12,12,1509,1509,0,
Skylab,9-ODA and 9-HDA,12,12,1535,1535,0,"maybe, not really touching just interrested"
Skylab,9-ODA and 9-HDA,12,12,1588,1589,1,
Skylab,9-ODA and 9-HDA,12,12,1616,1619,3,"maybe, not really touching just interrested"
Skylab,9-ODA and 9-HDA,12,12,1616,1616,0,
Skylab,9-ODA and 9-HDA,12,12,1627,1630,3,"maybe, not really touching just interrested"
Skylab,9-ODA and 9-HDA,12,12,1632,1632,0,
Skylab,9-ODA and 9-HDA,12,12,1665,1666,1,
Skylab,9-ODA and 9-HDA,12,12,1726,1726,0,
Skylab,9-ODA and 9-HDA,12,12,1736,1736,0,
Skylab,9-ODA and 9-HDA,12,12,1777,1777,0,
Skylab,9-ODA and 9-HDA,13,1,30,30,0,
Skylab,9-ODA and 9-HDA,13,1,70,70,0,
Skylab,9-ODA and 9-HDA,13,1,75,89,14,bee touching paper whilst lying on its side - honestly probably jsut struggling to get the right way up
Skylab,9-ODA and 9-HDA,13,1,99,100,1,
Skylab,9-ODA and 9-HDA,13,1,172,172,0,
Skylab,9-ODA and 9-HDA,13,1,193,194,1,
Skylab,9-ODA and 9-HDA,13,1,202,204,2,
Skylab,9-ODA and 9-HDA,13,1,291,295,4,
Skylab,9-ODA and 9-HDA,13,1,317,318,1,
Skylab,9-ODA and 9-HDA,13,1,330,330,0,
Skylab,9-ODA and 9-HDA,13,1,403,404,1,
Skylab,9-ODA and 9-HDA,13,1,490,492,2,
Skylab,9-ODA and 9-HDA,13,1,559,559,0,
Skylab,9-ODA and 9-HDA,13,1,610,611,1,
Skylab,9-ODA and 9-HDA,13,1,674,674,0,
Skylab,9-ODA and 9-HDA,13,1,680,682,2,
Skylab,9-ODA and 9-HDA,13,1,714,714,0,
Skylab,9-ODA and 9-HDA,13,1,810,811,1,
Skylab,9-ODA and 9-HDA,13,1,844,847,3,
Skylab,9-ODA and 9-HDA,13,1,848,853,5,
Skylab,9-ODA and 9-HDA,13,1,959,960,1,
Skylab,9-ODA and 9-HDA,13,1,962,963,1,
Skylab,9-ODA and 9-HDA,13,1,1053,1054,1,
Skylab,9-ODA and 9-HDA,13,1,1123,1124,1,
Skylab,9-ODA and 9-HDA,13,1,1155,1159,4,
Skylab,9-ODA and 9-HDA,13,1,1167,1169,2,
Skylab,9-ODA and 9-HDA,13,1,1185,1186,1,
Skylab,9-ODA and 9-HDA,13,1,1192,1203,11,
Skylab,9-ODA and 9-HDA,13,1,1217,1224,7,
Skylab,9-ODA and 9-HDA,13,1,1265,1267,2,
Skylab,9-ODA and 9-HDA,13,1,1277,1277,0,
Skylab,9-ODA and 9-HDA,13,1,1324,1325,1,
Skylab,9-ODA and 9-HDA,13,1,1391,1396,5,
Skylab,9-ODA and 9-HDA,13,1,1425,1429,4,
Skylab,9-ODA and 9-HDA,13,1,1458,1459,1,
Skylab,9-ODA and 9-HDA,13,1,1482,1483,1,
Skylab,9-ODA and 9-HDA,13,1,1493,1496,3,
Skylab,9-ODA and 9-HDA,13,1,1531,1531,0,
Skylab,9-ODA and 9-HDA,13,1,1571,1574,3,
Skylab,9-ODA and 9-HDA,13,1,1630,1630,0,
Skylab,9-ODA and 9-HDA,13,1,1671,1671,0,
Skylab,9-ODA and 9-HDA,13,1,1691,1692,1,
Skylab,9-ODA and 9-HDA,13,1,900,907,7,
Skylab,9-ODA and 9-HDA,15,12,24,25,1,
Skylab,9-ODA and 9-HDA,15,12,26,28,2,
Skylab,9-ODA and 9-HDA,15,12,47,47,0,
Skylab,9-ODA and 9-HDA,15,12,64,64,0,
Skylab,9-ODA and 9-HDA,15,12,82,83,1,
Skylab,9-ODA and 9-HDA,15,12,121,122,1,
Skylab,9-ODA and 9-HDA,15,12,182,186,4,
Skylab,9-ODA and 9-HDA,15,12,198,205,7,"bee actively sniffing, then it faces paper still until 3:39"
Skylab,9-ODA and 9-HDA,15,12,207,212,5,
Skylab,9-ODA and 9-HDA,15,12,214,217,3,
Skylab,9-ODA and 9-HDA,15,12,222,225,3,
Skylab,9-ODA and 9-HDA,15,12,239,241,2,
Skylab,9-ODA and 9-HDA,15,12,291,294,3,
Skylab,9-ODA and 9-HDA,15,12,329,329,0,
Skylab,9-ODA and 9-HDA,15,12,372,375,3,
Skylab,9-ODA and 9-HDA,15,12,377,384,7,
Skylab,9-ODA and 9-HDA,15,12,398,401,3,
Skylab,9-ODA and 9-HDA,15,12,412,415,3,
Skylab,9-ODA and 9-HDA,15,12,438,440,2,
Skylab,9-ODA and 9-HDA,15,12,447,448,1,
Skylab,9-ODA and 9-HDA,15,12,458,462,4,
Skylab,9-ODA and 9-HDA,15,12,461,463,2,
Skylab,9-ODA and 9-HDA,15,12,471,472,1,
Skylab,9-ODA and 9-HDA,15,12,493,495,2,
Skylab,9-ODA and 9-HDA,15,12,510,515,5,
Skylab,9-ODA and 9-HDA,15,12,536,536,0,
Skylab,9-ODA and 9-HDA,15,12,553,553,0,
Skylab,9-ODA and 9-HDA,15,12,555,556,1,
Skylab,9-ODA and 9-HDA,15,12,587,590,3,
Skylab,9-ODA and 9-HDA,15,12,603,604,1,
Skylab,9-ODA and 9-HDA,15,12,612,614,2,
Skylab,9-ODA and 9-HDA,15,12,613,613,0,
Skylab,9-ODA and 9-HDA,15,12,625,625,0,
Skylab,9-ODA and 9-HDA,15,12,707,708,1,
Skylab,9-ODA and 9-HDA,15,12,720,722,2,
Skylab,9-ODA and 9-HDA,15,12,749,751,2,
Skylab,9-ODA and 9-HDA,15,12,767,768,1,
Skylab,9-ODA and 9-HDA,15,12,815,816,1,
Skylab,9-ODA and 9-HDA,15,12,828,830,2,
Skylab,9-ODA and 9-HDA,15,12,836,836,0,
Skylab,9-ODA and 9-HDA,15,12,900,911,11,
Skylab,9-ODA and 9-HDA,15,12,911,912,1,
Skylab,9-ODA and 9-HDA,15,12,933,934,1,
Skylab,9-ODA and 9-HDA,15,12,940,941,1,
Skylab,9-ODA and 9-HDA,15,12,959,966,7,
Skylab,9-ODA and 9-HDA,15,12,975,975,0,
Skylab,9-ODA and 9-HDA,15,12,976,977,1,
Skylab,9-ODA and 9-HDA,15,12,989,991,2,
Skylab,9-ODA and 9-HDA,15,12,992,992,0,
Skylab,9-ODA and 9-HDA,15,12,996,996,0,bump
Skylab,9-ODA and 9-HDA,15,12,1003,1004,1,
Skylab,9-ODA and 9-HDA,15,12,1017,1017,0,
Skylab,9-ODA and 9-HDA,15,12,1026,1027,1,
Skylab,9-ODA and 9-HDA,15,12,1037,1038,1,
Skylab,9-ODA and 9-HDA,15,12,1066,1067,1,
Skylab,9-ODA and 9-HDA,15,12,1070,1071,1,
Skylab,9-ODA and 9-HDA,15,12,1080,1082,2,
Skylab,9-ODA and 9-HDA,15,12,1086,1088,2,
Skylab,9-ODA and 9-HDA,15,12,1097,1100,3,18:23 is when it moves off paper
Skylab,9-ODA and 9-HDA,15,12,1179,1214,35,
Skylab,9-ODA and 9-HDA,15,12,1263,1268,5,
Skylab,9-ODA and 9-HDA,15,12,1279,1280,1,
Skylab,9-ODA and 9-HDA,15,12,1281,1283,2,
Skylab,9-ODA and 9-HDA,15,12,1284,1285,1,
Skylab,9-ODA and 9-HDA,15,12,1288,1303,15,
Skylab,9-ODA and 9-HDA,15,12,1295,1297,2,
Skylab,9-ODA and 9-HDA,15,12,1341,1341,0,
Skylab,9-ODA and 9-HDA,15,12,1348,1350,2,
Skylab,9-ODA and 9-HDA,15,12,1349,1349,0,
Skylab,9-ODA and 9-HDA,15,12,1361,1361,0,
Skylab,9-ODA and 9-HDA,15,12,1366,1366,0,
Skylab,9-ODA and 9-HDA,15,12,1370,1373,3,
Skylab,9-ODA and 9-HDA,15,12,1377,1387,10,
Skylab,9-ODA and 9-HDA,15,12,1384,1387,3,
Skylab,9-ODA and 9-HDA,15,12,1398,1399,1,
Skylab,9-ODA and 9-HDA,15,12,1431,1439,8,
Skylab,9-ODA and 9-HDA,15,12,1460,1463,3,
Skylab,9-ODA and 9-HDA,15,12,1482,1483,1,
Skylab,9-ODA and 9-HDA,15,12,1503,1505,2,
Skylab,9-ODA and 9-HDA,15,12,1568,1570,2,
Skylab,9-ODA and 9-HDA,15,12,1588,1589,1,
Skylab,9-ODA and 9-HDA,15,12,1591,1598,7,
Skylab,9-ODA and 9-HDA,15,12,1614,1621,7,
Skylab,9-ODA and 9-HDA,15,12,1615,1615,0,
Skylab,9-ODA and 9-HDA,15,12,1627,1627,0,
Skylab,9-ODA and 9-HDA,15,12,1629,1631,2,
Skylab,9-ODA and 9-HDA,15,12,1636,1639,3,
Skylab,9-ODA and 9-HDA,15,12,1642,1644,2,
Skylab,9-ODA and 9-HDA,15,12,1659,1659,0,
Skylab,9-ODA and 9-HDA,15,12,1674,1676,2,
Skylab,9-ODA and 9-HDA,15,12,1680,1698,18,
Skylab,9-ODA and 9-HDA,15,12,1698,1698,0,
Skylab,9-ODA and 9-HDA,15,12,1709,1709,0,
Skylab,9-ODA and 9-HDA,15,12,1727,1730,3,
Skylab,9-ODA and 9-HDA,15,12,1736,1737,1,
Skylab,9-ODA and 9-HDA,15,12,1737,1738,1,
Skylab,9-ODA and 9-HDA,15,12,1746,1786,40,
Skylab,9-ODA and 9-HDA,15,12,1787,1790,3,
Skylab,9-ODA and 9-HDA,15,12,1795,1800,5,
Skylab,9-ODA and 9-HDA,16,9,0,1,1,
Skylab,9-ODA and 9-HDA,16,9,20,23,3,
Skylab,9-ODA and 9-HDA,16,9,42,43,1,
Skylab,9-ODA and 9-HDA,16,9,97,98,1,
Skylab,9-ODA and 9-HDA,16,9,113,113,0,
Skylab,9-ODA and 9-HDA,16,9,115,115,0,
Skylab,9-ODA and 9-HDA,16,9,132,134,2,
Skylab,9-ODA and 9-HDA,16,9,156,156,0,
Skylab,9-ODA and 9-HDA,16,9,165,167,2,
Skylab,9-ODA and 9-HDA,16,9,239,239,0,
Skylab,9-ODA and 9-HDA,16,9,245,247,2,
Skylab,9-ODA and 9-HDA,16,9,322,323,1,
Skylab,9-ODA and 9-HDA,16,9,421,424,3,
Skylab,9-ODA and 9-HDA,16,9,440,441,1,
Skylab,9-ODA and 9-HDA,16,9,557,558,1,
Skylab,9-ODA and 9-HDA,16,9,559,563,4,
Skylab,9-ODA and 9-HDA,16,9,646,646,0,
Skylab,9-ODA and 9-HDA,16,9,660,663,3,bee walks over corner of paper
Skylab,9-ODA and 9-HDA,16,9,735,735,0,
Skylab,9-ODA and 9-HDA,16,9,783,784,1,
Skylab,9-ODA and 9-HDA,16,9,1098,1099,1,
Skylab,9-ODA and 9-HDA,16,9,1104,1105,1,
Skylab,9-ODA and 9-HDA,16,9,1140,1140,0,
Skylab,9-ODA and 9-HDA,16,9,1156,1157,1,
Skylab,9-ODA and 9-HDA,16,9,1232,1232,0,
Skylab,9-ODA and 9-HDA,16,9,1330,1330,0,
Skylab,9-ODA and 9-HDA,16,9,1347,1347,0,
Skylab,9-ODA and 9-HDA,16,9,1377,1377,0,
Skylab,9-ODA and 9-HDA,16,9,1521,1522,1,
Skylab,9-ODA and 9-HDA,16,9,1530,1530,0,
Skylab,9-ODA and 9-HDA,16,9,1625,1625,0,
Skylab,9-ODA and 9-HDA,16,9,1708,1708,0,
Skylab,9-ODA and 9-HDA,16,9,1712,1712,0,
Skylab,9-ODA and 9-HDA,16,9,1726,1726,0,
Skylab,9-ODA and 9-HDA,17,7,99,99,0,
Skylab,9-ODA and 9-HDA,17,7,102,103,1,
Skylab,9-ODA and 9-HDA,17,7,106,107,1,
Skylab,9-ODA and 9-HDA,17,7,134,134,0,
Skylab,9-ODA and 9-HDA,17,7,132,133,1,bee doesn't really face the paper but it brushes agsinst it
Skylab,9-ODA and 9-HDA,17,7,141,142,1,
Skylab,9-ODA and 9-HDA,17,7,212,214,2,
Skylab,9-ODA and 9-HDA,17,7,250,250,0,
Skylab,9-ODA and 9-HDA,17,7,253,257,4,
Skylab,9-ODA and 9-HDA,17,7,264,264,0,
Skylab,9-ODA and 9-HDA,17,7,294,298,4,
Skylab,9-ODA and 9-HDA,17,7,307,310,3,
Skylab,9-ODA and 9-HDA,17,7,313,313,0,bee sort of sniffs as it walks past - not too sure
Skylab,9-ODA and 9-HDA,17,7,327,327,0,bee sort of walks in to paper
Skylab,9-ODA and 9-HDA,17,7,359,361,2,
Skylab,9-ODA and 9-HDA,17,7,362,362,0,
Skylab,9-ODA and 9-HDA,17,7,365,365,0,
Skylab,9-ODA and 9-HDA,17,7,391,395,4,
Skylab,9-ODA and 9-HDA,17,7,392,394,2,
Skylab,9-ODA and 9-HDA,17,7,395,395,0,
Skylab,9-ODA and 9-HDA,17,7,488,488,0,
Skylab,9-ODA and 9-HDA,17,7,527,527,0,
Skylab,9-ODA and 9-HDA,17,7,566,567,1,
Skylab,9-ODA and 9-HDA,17,7,648,648,0,
Skylab,9-ODA and 9-HDA,17,7,686,688,2,
Skylab,9-ODA and 9-HDA,17,7,729,730,1,
Skylab,9-ODA and 9-HDA,17,7,749,750,1,
Skylab,9-ODA and 9-HDA,17,7,795,795,0,
Skylab,9-ODA and 9-HDA,17,7,825,825,0,
Skylab,9-ODA and 9-HDA,17,7,835,835,0,
Skylab,9-ODA and 9-HDA,17,7,869,869,0,
Skylab,9-ODA and 9-HDA,17,7,879,879,0,
Skylab,9-ODA and 9-HDA,17,7,900,901,1,
Skylab,9-ODA and 9-HDA,17,7,904,906,2,
Skylab,9-ODA and 9-HDA,17,7,938,938,0,
Skylab,9-ODA and 9-HDA,17,7,955,956,1,
Skylab,9-ODA and 9-HDA,17,7,964,966,2,
Skylab,9-ODA and 9-HDA,17,7,1096,1099,3,
Skylab,9-ODA and 9-HDA,17,7,1108,1108,0,
Skylab,9-ODA and 9-HDA,17,7,1110,1114,4,
Skylab,9-ODA and 9-HDA,17,7,1117,1118,1,
Skylab,9-ODA and 9-HDA,17,7,1135,1135,0,
Skylab,9-ODA and 9-HDA,17,7,1139,1139,0,
Skylab,9-ODA and 9-HDA,17,7,1196,1196,0,
Skylab,9-ODA and 9-HDA,17,7,1230,1231,1,
Skylab,9-ODA and 9-HDA,17,7,1232,1233,1,
Skylab,9-ODA and 9-HDA,17,7,1279,1279,0,
Skylab,9-ODA and 9-HDA,17,7,1292,1292,0,
Skylab,9-ODA and 9-HDA,17,7,1327,1331,4,
Skylab,9-ODA and 9-HDA,17,7,1368,1369,1,bee sort of bumbles in to the paper
Skylab,9-ODA and 9-HDA,17,7,1386,1386,0,
Skylab,9-ODA and 9-HDA,17,7,1409,1410,1,
Skylab,9-ODA and 9-HDA,17,7,1438,1439,1,
Skylab,9-ODA and 9-HDA,17,7,1461,1462,1,
Skylab,9-ODA and 9-HDA,17,7,1485,1486,1,
Skylab,9-ODA and 9-HDA,17,7,1500,1500,0,
Skylab,9-ODA and 9-HDA,17,7,1510,1510,0,
Skylab,9-ODA and 9-HDA,17,7,1525,1527,2,
Skylab,9-ODA and 9-HDA,17,7,1574,1579,5,
Skylab,9-ODA and 9-HDA,17,7,1603,1603,0,seems sort of like an accidental bump
Skylab,9-ODA and 9-HDA,17,7,1619,1619,0,
Skylab,9-ODA and 9-HDA,17,7,1630,1631,1,
Skylab,9-ODA and 9-HDA,17,7,1645,1646,1,
Skylab,9-ODA and 9-HDA,17,7,1662,1665,3,
Skylab,9-ODA and 9-HDA,17,7,1675,1680,5,
Skylab,9-ODA and 9-HDA,17,7,1698,1700,2,
Skylab,9-ODA and 9-HDA,17,7,1739,1739,0,
Skylab,9-ODA and 9-HDA,17,7,1757,1761,4,
Zoology,Solvent control,4,9,86,86,0,
Zoology,Solvent control,4,9,107,109,2,
Zoology,Solvent control,4,9,113,113,0,
Zoology,Solvent control,4,9,138,138,0,
Zoology,Solvent control,4,9,243,243,0,
Zoology,Solvent control,4,9,245,246,1,
Zoology,Solvent control,4,9,293,294,1,
Zoology,Solvent control,4,9,299,300,1,
Zoology,Solvent control,4,9,310,310,0,
Zoology,Solvent control,4,9,340,340,0,
Zoology,Solvent control,4,9,350,350,0,
Zoology,Solvent control,4,9,395,397,2,
Zoology,Solvent control,4,9,400,400,0,
Zoology,Solvent control,4,9,411,411,0,
Zoology,Solvent control,4,9,419,419,0,
Zoology,Solvent control,4,9,471,471,0,
Zoology,Solvent control,4,9,487,487,0,
Zoology,Solvent control,4,9,518,518,0,
Zoology,Solvent control,4,9,666,666,0,
Zoology,Solvent control,4,9,726,726,0,
Zoology,Solvent control,4,9,785,785,0,
Zoology,Solvent control,4,9,865,865,0,
Zoology,Solvent control,4,9,882,885,3,
Zoology,Solvent control,4,9,999,999,0,
Zoology,Solvent control,4,9,1020,1021,1,
Zoology,Solvent control,4,9,1029,1029,0,
Zoology,Solvent control,4,9,1044,1044,0,bee sort of sniffs from afar
Zoology,Solvent control,4,9,1074,1074,0,
Zoology,Solvent control,4,9,1114,1114,0,
Zoology,Solvent control,4,9,1125,1125,0,
Zoology,Solvent control,4,9,1136,1136,0,
Zoology,Solvent control,4,9,1155,1155,0,
Zoology,Solvent control,4,9,1180,1180,0,
Zoology,Solvent control,4,9,1218,1219,1,
Zoology,Solvent control,4,9,1355,1357,2,
Zoology,Solvent control,4,9,1363,1363,0,
Zoology,Solvent control,4,9,1379,1379,0,
Zoology,Solvent control,4,9,1391,1391,0,
Zoology,Solvent control,4,9,1401,1403,2,
Zoology,Solvent control,4,9,1430,1432,2,
Zoology,Solvent control,4,9,1460,1460,0,
Zoology,Solvent control,4,9,1474,1474,0,
Zoology,Solvent control,4,9,1579,1580,1,
Zoology,Solvent control,4,9,1581,1583,2,
Zoology,Solvent control,4,9,1595,1595,0,
Zoology,Solvent control,4,9,1651,1651,0,
Zoology,Solvent control,4,9,1659,1659,0,
Zoology,Solvent control,4,9,1708,1719,11,
Zoology,Solvent control,5,2,13,13,0,
Zoology,Solvent control,5,2,41,41,0,
Zoology,Solvent control,5,2,44,45,1,
Zoology,Solvent control,5,2,66,67,1,
Zoology,Solvent control,5,2,80,80,0,
Zoology,Solvent control,5,2,93,95,2,
Zoology,Solvent control,5,2,168,168,0,
Zoology,Solvent control,5,2,195,195,0,
Zoology,Solvent control,5,2,202,202,0,
Zoology,Solvent control,5,2,210,210,0,
Zoology,Solvent control,5,2,312,312,0,
Zoology,Solvent control,5,2,386,391,5,
Zoology,Solvent control,5,2,506,506,0,
Zoology,Solvent control,5,2,506,506,0,
Zoology,Solvent control,5,2,576,576,0,
Zoology,Solvent control,5,2,592,592,0,
Zoology,Solvent control,5,2,604,605,1,
Zoology,Solvent control,5,2,615,615,0,
Zoology,Solvent control,5,2,622,623,1,
Zoology,Solvent control,5,2,636,637,1,
Zoology,Solvent control,5,2,644,644,0,
Zoology,Solvent control,5,2,675,675,0,
Zoology,Solvent control,5,2,718,718,0,
Zoology,Solvent control,5,2,736,736,0,
Zoology,Solvent control,5,2,816,816,0,
Zoology,Solvent control,5,2,867,868,1,
Zoology,Solvent control,5,2,942,942,0,
Zoology,Solvent control,5,2,995,996,1,
Zoology,Solvent control,5,2,1041,1041,0,
Zoology,Solvent control,5,2,1280,1280,0,
Zoology,Solvent control,5,2,1286,1288,2,
Zoology,Solvent control,5,2,1320,1321,1,
Zoology,Solvent control,5,2,1385,1385,0,
Zoology,Solvent control,5,2,1403,1404,1,
Zoology,Solvent control,5,2,1417,1417,0,
Zoology,Solvent control,5,2,1539,1539,0,
Zoology,Solvent control,5,2,1566,1567,1,
Zoology,Solvent control,5,2,1586,1586,0,
Zoology,Solvent control,5,2,1592,1594,2,
Zoology,Solvent control,5,2,1593,1594,1,
Zoology,Solvent control,5,2,1595,1597,2,
Zoology,Solvent control,5,2,1667,1668,1,
Zoology,Solvent control,5,2,1675,1675,0,
Zoology,Solvent control,5,2,1690,1690,0,
Zoology,Solvent control,5,2,1777,1777,0,
Zoology,Solvent control,6,1,9,16,7,
Zoology,Solvent control,6,1,44,44,0,
Zoology,Solvent control,6,1,63,63,0,
Zoology,Solvent control,6,1,66,67,1,
Zoology,Solvent control,6,1,94,102,8,
Zoology,Solvent control,6,1,101,101,0,
Zoology,Solvent control,6,1,111,115,4,
Zoology,Solvent control,6,1,128,128,0,
Zoology,Solvent control,6,1,142,143,1,
Zoology,Solvent control,6,1,150,150,0,
Zoology,Solvent control,6,1,159,160,1,
Zoology,Solvent control,6,1,184,184,0,
Zoology,Solvent control,6,1,224,224,0,
Zoology,Solvent control,6,1,259,260,1,
Zoology,Solvent control,6,1,281,281,0,
Zoology,Solvent control,6,1,286,286,0,
Zoology,Solvent control,6,1,321,322,1,
Zoology,Solvent control,6,1,350,352,2,
Zoology,Solvent control,6,1,355,355,0,
Zoology,Solvent control,6,1,360,360,0,
Zoology,Solvent control,6,1,391,392,1,
Zoology,Solvent control,6,1,400,400,0,
Zoology,Solvent control,6,1,420,421,1,
Zoology,Solvent control,6,1,444,446,2,
Zoology,Solvent control,6,1,472,473,1,
Zoology,Solvent control,6,1,480,481,1,
Zoology,Solvent control,6,1,525,533,8,
Zoology,Solvent control,6,1,535,536,1,
Zoology,Solvent control,6,1,541,542,1,sniffs from afar
Zoology,Solvent control,6,1,573,576,3,not quite touching paper
Zoology,Solvent control,6,1,651,651,0,
Zoology,Solvent control,6,1,663,663,0,
Zoology,Solvent control,6,1,697,697,0,
Zoology,Solvent control,6,1,700,703,3,
Zoology,Solvent control,6,1,703,704,1,
Zoology,Solvent control,6,1,706,707,1,
Zoology,Solvent control,6,1,723,726,3,
Zoology,Solvent control,6,1,808,812,4,
Zoology,Solvent control,6,1,829,830,1,
Zoology,Solvent control,6,1,845,848,3,
Zoology,Solvent control,6,1,877,884,7,
Zoology,Solvent control,6,1,892,897,5,
Zoology,Solvent control,6,1,894,897,3,
Zoology,Solvent control,6,1,907,916,9,
Zoology,Solvent control,6,1,973,974,1,
Zoology,Solvent control,6,1,982,982,0,
Zoology,Solvent control,6,1,989,989,0,
Zoology,Solvent control,6,1,1033,1052,19,
Zoology,Solvent control,6,1,1052,1052,0,
Zoology,Solvent control,6,1,1067,1067,0,
Zoology,Solvent control,6,1,1089,1090,1,
Zoology,Solvent control,6,1,1092,1093,1,
Zoology,Solvent control,6,1,1133,1134,1,
Zoology,Solvent control,6,1,1141,1141,0,
Zoology,Solvent control,6,1,1160,1161,1,
Zoology,Solvent control,6,1,1169,1169,0,
Zoology,Solvent control,6,1,1171,1171,0,
Zoology,Solvent control,6,1,1181,1182,1,
Zoology,Solvent control,6,1,1194,1194,0,
Zoology,Solvent control,6,1,1198,1203,5,
Zoology,Solvent control,6,1,1216,1216,0,bee sort of bumps in to paper
Zoology,Solvent control,6,1,1231,1231,0,
Zoology,Solvent control,6,1,1233,1234,1,
Zoology,Solvent control,6,1,1259,1260,1,
Zoology,Solvent control,6,1,1263,1263,0,
Zoology,Solvent control,6,1,1338,1338,0,
Zoology,Solvent control,6,1,1351,1356,5,
Zoology,Solvent control,6,1,1356,1357,1,
Zoology,Solvent control,6,1,1376,1377,1,
Zoology,Solvent control,6,1,1412,1412,0,
Zoology,Solvent control,6,1,1417,1429,12,
Zoology,Solvent control,6,1,1441,1443,2,
Zoology,Solvent control,6,1,1453,1454,1,
Zoology,Solvent control,6,1,1466,1467,1,
Zoology,Solvent control,6,1,1473,1473,0,
Zoology,Solvent control,6,1,1540,1540,0,
Zoology,Solvent control,6,1,1545,1546,1,
Zoology,Solvent control,6,1,1547,1547,0,
Zoology,Solvent control,6,1,1549,1549,0,
Zoology,Solvent control,6,1,1598,1602,4,
Zoology,Solvent control,6,1,1613,1615,2,
Zoology,Solvent control,6,1,1634,1634,0,
Zoology,Solvent control,6,1,1658,1658,0,
Zoology,Solvent control,6,1,1672,1673,1,"sort of snifs, not quite touching"
Zoology,Solvent control,6,1,1684,1684,0,
Zoology,Solvent control,6,1,1739,1739,0,
Zoology,Solvent control,6,1,1765,1767,2,
Zoology,Solvent control,7,7,29,29,0,
Zoology,Solvent control,7,7,47,49,2,
Zoology,Solvent control,7,7,86,86,0,
Zoology,Solvent control,7,7,208,229,21,
Zoology,Solvent control,7,7,257,258,1,
Zoology,Solvent control,7,7,328,328,0,
Zoology,Solvent control,7,7,334,335,1,
Zoology,Solvent control,7,7,393,393,0,
Zoology,Solvent control,7,7,681,681,0,
Zoology,Solvent control,7,7,732,733,1,
Zoology,Solvent control,7,7,737,737,0,
Zoology,Solvent control,7,7,766,779,13,
Zoology,Solvent control,7,7,811,813,2,
Zoology,Solvent control,7,7,904,904,0,
Zoology,Solvent control,7,7,1106,1106,0,
Zoology,Solvent control,7,7,1158,1159,1,
Zoology,Solvent control,7,7,1159,1160,1,
Zoology,Solvent control,7,7,1175,1176,1,
Zoology,Solvent control,7,7,1184,1184,0,
Zoology,Solvent control,7,7,1202,1220,18,
Zoology,Solvent control,7,7,1209,1211,2,
Zoology,Solvent control,7,7,1220,1221,1,
Zoology,Solvent control,7,7,1221,1222,1,
Zoology,Solvent control,7,7,1224,1225,1,
Zoology,Solvent control,7,7,1233,1234,1,
Zoology,Solvent control,7,7,1278,1278,0,
Zoology,Solvent control,7,7,1283,1283,0,
Zoology,Solvent control,7,7,1294,1294,0,
Zoology,Solvent control,7,7,1328,1330,2,
Zoology,Solvent control,7,7,1485,1485,0,
Zoology,Solvent control,7,7,1492,1514,22,
Zoology,Solvent control,7,7,1554,1555,1,
Zoology,Solvent control,7,7,1577,1578,1,
Zoology,Solvent control,7,7,1584,1587,3,
Zoology,Solvent control,7,7,1615,1619,4,
Zoology,Solvent control,7,7,1709,1719,10,
Zoology,Solvent control,7,7,1747,1748,1,
Zoology,Solvent control,7,7,1750,1752,2,
Zoology,Solvent control,8,12,8,12,4,
Zoology,Solvent control,8,12,38,42,4,
Zoology,Solvent control,8,12,69,69,0,
Zoology,Solvent control,8,12,93,93,0,
Zoology,Solvent control,8,12,109,109,0,
Zoology,Solvent control,8,12,109,110,1,
Zoology,Solvent control,8,12,126,127,1,
Zoology,Solvent control,8,12,210,210,0,
Zoology,Solvent control,8,12,217,220,3,
Zoology,Solvent control,8,12,319,321,2,
Zoology,Solvent control,8,12,353,354,1,
Zoology,Solvent control,8,12,357,358,1,
Zoology,Solvent control,8,12,394,396,2,
Zoology,Solvent control,8,12,493,494,1,
Zoology,Solvent control,8,12,507,507,0,
Zoology,Solvent control,8,12,542,543,1,
Zoology,Solvent control,8,12,554,554,0,
Zoology,Solvent control,8,12,570,571,1,
Zoology,Solvent control,8,12,576,576,0,
Zoology,Solvent control,8,12,580,583,3,
Zoology,Solvent control,8,12,622,622,0,
Zoology,Solvent control,8,12,637,637,0,
Zoology,Solvent control,8,12,691,691,0,bee sort of bumps in to paper
Zoology,Solvent control,8,12,707,707,0,
Zoology,Solvent control,8,12,725,726,1,
Zoology,Solvent control,8,12,742,745,3,
Zoology,Solvent control,8,12,751,753,2,
Zoology,Solvent control,8,12,807,811,4,
Zoology,Solvent control,8,12,827,828,1,
Zoology,Solvent control,8,12,830,830,0,very short touch not sure
Zoology,Solvent control,8,12,870,871,1,
Zoology,Solvent control,8,12,885,886,1,
Zoology,Solvent control,8,12,890,891,1,
Zoology,Solvent control,8,12,913,913,0,
Zoology,Solvent control,8,12,921,934,13,bee sniffing from afar
Zoology,Solvent control,8,12,951,951,0,
Zoology,Solvent control,8,12,964,964,0,
Zoology,Solvent control,8,12,1021,1022,1,
Zoology,Solvent control,8,12,1030,1030,0,
Zoology,Solvent control,8,12,1058,1059,1,
Zoology,Solvent control,8,12,1075,1075,0,
Zoology,Solvent control,8,12,1086,1086,0,
Zoology,Solvent control,8,12,1097,1097,0,
Zoology,Solvent control,8,12,1141,1141,0,
Zoology,Solvent control,8,12,1143,1143,0,
Zoology,Solvent control,8,12,1144,1155,11,
Zoology,Solvent control,8,12,1162,1163,1,
Zoology,Solvent control,8,12,1172,1173,1,
Zoology,Solvent control,8,12,1174,1183,9,
Zoology,Solvent control,8,12,1189,1190,1,
Zoology,Solvent control,8,12,1194,1194,0,
Zoology,Solvent control,8,12,1229,1230,1,
Zoology,Solvent control,8,12,1248,1249,1,
Zoology,Solvent control,8,12,1253,1260,7,
Zoology,Solvent control,8,12,1257,1261,4,
Zoology,Solvent control,8,12,1263,1263,0,
Zoology,Solvent control,8,12,1265,1269,4,
Zoology,Solvent control,8,12,1275,1279,4,
Zoology,Solvent control,8,12,1300,1300,0,
Zoology,Solvent control,8,12,1317,1317,0,sort of small touch - not sure about it
Zoology,Solvent control,8,12,1321,1322,1,
Zoology,Solvent control,8,12,1379,1379,0,
Zoology,Solvent control,8,12,1416,1416,0,
Zoology,Solvent control,8,12,1421,1421,0,
Zoology,Solvent control,8,12,1448,1453,5,
Zoology,Solvent control,8,12,1456,1456,0,
Zoology,Solvent control,8,12,1461,1462,1,
Zoology,Solvent control,8,12,1462,1464,2,
Zoology,Solvent control,8,12,1471,1471,0,
Zoology,Solvent control,8,12,1474,1475,1,
Zoology,Solvent control,8,12,1524,1524,0,
Zoology,Solvent control,8,12,1526,1526,0,
Zoology,Solvent control,8,12,1556,1556,0,
Zoology,Solvent control,8,12,1557,1558,1,
Zoology,Solvent control,8,12,1584,1591,7,bee sits very close to the paper - not quite sure if it counts
Zoology,Solvent control,8,12,1598,1598,0,
Zoology,Solvent control,8,12,1600,1604,4,
Zoology,Solvent control,8,12,1605,1605,0,
Zoology,Solvent control,8,12,1605,1617,12,
Zoology,Solvent control,8,12,1616,1617,1,
Zoology,Solvent control,8,12,1624,1624,0,
Zoology,Solvent control,8,12,1646,1646,0,
Zoology,Solvent control,8,12,1650,1652,2,
Zoology,Solvent control,8,12,1682,1690,8,
Zoology,Solvent control,8,12,1703,1703,0,
Zoology,Solvent control,8,12,1760,1761,1,
Zoology,Solvent control,8,12,1763,1764,1,
Zoology,Solvent control,8,12,1795,1795,0,
Zoology,Solvent control,8,12,1796,1796,0,
Zoology,Solvent control,9,9,33,33,0,
Zoology,Solvent control,9,9,39,41,2,
Zoology,Solvent control,9,9,75,76,1,
Zoology,Solvent control,9,9,78,78,0,
Zoology,Solvent control,9,9,87,88,1,
Zoology,Solvent control,9,9,112,114,2,
Zoology,Solvent control,9,9,123,123,0,
Zoology,Solvent control,9,9,201,201,0,
Zoology,Solvent control,9,9,251,251,0,bee sort of sniffs from afar
Zoology,Solvent control,9,9,269,269,0,
Zoology,Solvent control,9,9,294,294,0,
Zoology,Solvent control,9,9,336,337,1,
Zoology,Solvent control,9,9,342,342,0,
Zoology,Solvent control,9,9,374,374,0,
Zoology,Solvent control,9,9,396,397,1,
Zoology,Solvent control,9,9,546,546,0,
Zoology,Solvent control,9,9,594,595,1,
Zoology,Solvent control,9,9,614,615,1,
Zoology,Solvent control,9,9,626,632,6,
Zoology,Solvent control,9,9,635,635,0,
Zoology,Solvent control,9,9,641,641,0,
Zoology,Solvent control,9,9,641,641,0,
Zoology,Solvent control,9,9,649,651,2,
Zoology,Solvent control,9,9,693,694,1,
Zoology,Solvent control,9,9,736,738,2,
Zoology,Solvent control,9,9,749,749,0,
Zoology,Solvent control,9,9,753,753,0,
Zoology,Solvent control,9,9,763,763,0,
Zoology,Solvent control,9,9,782,783,1,
Zoology,Solvent control,9,9,836,836,0,
Zoology,Solvent control,9,9,840,840,0,
Zoology,Solvent control,9,9,860,861,1,
Zoology,Solvent control,9,9,887,887,0,
Zoology,Solvent control,9,9,890,890,0,
Zoology,Solvent control,9,9,945,945,0,
Zoology,Solvent control,9,9,970,970,0,
Zoology,Solvent control,9,9,1001,1001,0,
Zoology,Solvent control,9,9,1077,1078,1,not touching at all but seems to be sniffing
Zoology,Solvent control,9,9,1134,1134,0,
Zoology,Solvent control,9,9,1141,1141,0,very breif touch - maybe shouldn't count
Zoology,Solvent control,9,9,1169,1171,2,
Zoology,Solvent control,9,9,1185,1186,1,
Zoology,Solvent control,9,9,1207,1207,0,
Zoology,Solvent control,9,9,1239,1239,0,
Zoology,Solvent control,9,9,1242,1242,0,
Zoology,Solvent control,9,9,1283,1283,0,
Zoology,Solvent control,9,9,1444,1444,0,
Zoology,Solvent control,9,9,1451,1452,1,
Zoology,Solvent control,9,9,1545,1545,0,
Zoology,Solvent control,9,9,1642,1643,1,
Zoology,Solvent control,9,9,1727,1727,0,
Zoology,Solvent control,9,9,1765,1765,0,
Zoology,Solvent control,9,9,1769,1769,0,
Zoology,Solvent control,11,9,10,15,5,
Zoology,Solvent control,11,9,85,88,3,
Zoology,Solvent control,11,9,252,252,0,maybe - not quite touching
Zoology,Solvent control,11,9,264,271,7,
Zoology,Solvent control,11,9,277,278,1,
Zoology,Solvent control,11,9,326,326,0,
Zoology,Solvent control,11,9,328,331,3,
Zoology,Solvent control,11,9,374,375,1,
Zoology,Solvent control,11,9,387,388,1,
Zoology,Solvent control,11,9,491,491,0,
Zoology,Solvent control,11,9,494,494,0,
Zoology,Solvent control,11,9,548,560,12,
Zoology,Solvent control,11,9,620,620,0,
Zoology,Solvent control,11,9,636,636,0,
Zoology,Solvent control,11,9,677,685,8,
Zoology,Solvent control,11,9,839,840,1,
Zoology,Solvent control,11,9,857,857,0,
Zoology,Solvent control,11,9,913,914,1,
Zoology,Solvent control,11,9,1005,1005,0,
Zoology,Solvent control,11,9,1020,1021,1,
Zoology,Solvent control,11,9,1102,1102,0,
Zoology,Solvent control,11,9,1106,1108,2,
Zoology,Solvent control,11,9,1109,1110,1,
Zoology,Solvent control,11,9,1109,1111,2,
Zoology,Solvent control,11,9,1119,1125,6,
Zoology,Solvent control,11,9,1258,1258,0,
Zoology,Solvent control,11,9,1327,1338,11,
Zoology,Solvent control,11,9,1328,1328,0,
Zoology,Solvent control,11,9,1342,1343,1,
Zoology,Solvent control,11,9,1344,1344,0,
Zoology,Solvent control,11,9,1348,1348,0,
Zoology,Solvent control,11,9,1364,1365,1,
Zoology,Solvent control,11,9,1369,1369,0,
Zoology,Solvent control,11,9,1401,1401,0,
Zoology,Solvent control,11,9,1422,1422,0,
Zoology,Solvent control,11,9,1423,1424,1,
Zoology,Solvent control,11,9,1451,1451,0,
Zoology,Solvent control,11,9,1471,1471,0,
Zoology,Solvent control,11,9,1499,1499,0,
Zoology,Solvent control,11,9,1582,1582,0,
Zoology,Solvent control,11,9,1588,1588,0,
Zoology,Solvent control,11,9,1643,1644,1,
Zoology,Solvent control,11,9,1646,1646,0,
Zoology,Solvent control,11,9,1702,1703,1,
Zoology,Solvent control,11,9,1707,1707,0,
Zoology,Solvent control,11,9,1721,1721,0,
Zoology,Solvent control,11,9,1740,1740,0,
Zoology,Solvent control,11,9,1789,1791,2,maybe sideways touch
Zoology,Solvent control,14,5,12,14,2,
Zoology,Solvent control,14,5,75,76,1,bee turns around on paper
Zoology,Solvent control,14,5,114,115,1,
Zoology,Solvent control,14,5,137,138,1,
Zoology,Solvent control,14,5,137,138,1,
Zoology,Solvent control,14,5,149,150,1,
Zoology,Solvent control,14,5,190,190,0,
Zoology,Solvent control,14,5,195,195,0,not sure
Zoology,Solvent control,14,5,322,322,0,
Zoology,Solvent control,14,5,343,350,7,
Zoology,Solvent control,14,5,363,366,3,
Zoology,Solvent control,14,5,368,371,3,
Zoology,Solvent control,14,5,636,636,0,bee bumps in tp paper as it turns around - probably dosen't count
Zoology,Solvent control,14,5,640,641,1,bee bumps in tp paper as it turns around - probably dosen't count
Zoology,Solvent control,14,5,710,710,0,
Zoology,Solvent control,14,5,752,752,0,
Zoology,Solvent control,14,5,756,757,1,
Zoology,Solvent control,14,5,761,761,0,
Zoology,Solvent control,14,5,775,775,0,
Zoology,Solvent control,14,5,813,813,0,
Zoology,Solvent control,14,5,832,838,6,
Zoology,Solvent control,14,5,839,842,3,
Zoology,Solvent control,14,5,839,840,1,
Zoology,Solvent control,14,5,842,843,1,bee walks over paper
Zoology,Solvent control,14,5,894,900,6,
Zoology,Solvent control,14,5,896,896,0,
Zoology,Solvent control,14,5,909,912,3,
Zoology,Solvent control,14,5,914,914,0,
Zoology,Solvent control,14,5,944,944,0,
Zoology,Solvent control,14,5,951,951,0,
Zoology,Solvent control,14,5,958,958,0,
Zoology,Solvent control,14,5,983,983,0,
Zoology,Solvent control,14,5,1e3,1001,1,
Zoology,Solvent control,14,5,1153,1153,0,bee sniffs as it turns around maybe
Zoology,Solvent control,14,5,1158,1161,3,
Zoology,Solvent control,14,5,1163,1164,1,bee sits motionless facing paper until 19:38
Zoology,Solvent control,14,5,1175,1175,0,
Zoology,Solvent control,14,5,1203,1204,1,
Zoology,Solvent control,14,5,1300,1381,81,bee sits still facing paper very close to it
Zoology,Solvent control,14,5,1417,1420,3,
Zoology,Solvent control,14,5,1425,1427,2,
Zoology,Solvent control,14,5,1426,1429,3,
Zoology,Solvent control,14,5,1559,1559,0,
Zoology,Solvent control,14,5,1639,1641,2,
Zoology,Solvent control,14,5,1645,1645,0,
Zoology,Solvent control,14,5,1656,1657,1,
Zoology,Solvent control,14,5,1698,1701,3,
Zoology,Solvent control,14,5,1705,1705,0,"think its interrested, doesn't touch paper"
Zoology,Solvent control,14,5,1710,1710,0,
Zoology,Solvent control,14,5,1770,1770,0,
Zoology,Solvent control,14,5,1777,1777,0,think it counts bee walks by practically on top of paper
Zoology,Solvent control,18,1,32,36,4,
Zoology,Solvent control,18,1,46,48,2,
Zoology,Solvent control,18,1,59,64,5,
Zoology,Solvent control,18,1,78,79,1,
Zoology,Solvent control,18,1,89,90,1,
Zoology,Solvent control,18,1,163,167,4,
Zoology,Solvent control,18,1,348,350,2,
Zoology,Solvent control,18,1,389,391,2,
Zoology,Solvent control,18,1,549,552,3,
Zoology,Solvent control,18,1,557,561,4,
Zoology,Solvent control,18,1,606,612,6,
Zoology,Solvent control,18,1,608,610,2,
Zoology,Solvent control,18,1,620,623,3,
Zoology,Solvent control,18,1,677,679,2,
Zoology,Solvent control,18,1,688,688,0,
Zoology,Solvent control,18,1,920,922,2,bee walks right near paper
Zoology,Solvent control,18,1,1067,1070,3,
Zoology,Solvent control,18,1,1173,1183,10,
Zoology,Solvent control,19,7,49,50,1,
Zoology,Solvent control,19,7,123,124,1,
Zoology,Solvent control,19,7,136,137,1,
Zoology,Solvent control,19,7,282,283,1,
Zoology,Solvent control,19,7,307,311,4,
Zoology,Solvent control,19,7,361,361,0,
Zoology,Solvent control,19,7,368,369,1,
Zoology,Solvent control,19,7,377,377,0,
Zoology,Solvent control,19,7,398,399,1,
Zoology,Solvent control,19,7,405,408,3,
Zoology,Solvent control,19,7,425,430,5,
Zoology,Solvent control,19,7,465,478,13,bee sitting still real close
Zoology,Solvent control,19,7,507,509,2,
Zoology,Solvent control,19,7,530,532,2,
Zoology,Solvent control,19,7,534,534,0,
Zoology,Solvent control,19,7,562,564,2,
Zoology,Solvent control,19,7,667,669,2,
Zoology,Solvent control,19,7,678,678,0,
Zoology,Solvent control,19,7,696,696,0,
Zoology,Solvent control,19,7,740,740,0,
Zoology,Solvent control,19,7,786,786,0,
Zoology,Solvent control,19,7,824,824,0,
Zoology,Solvent control,19,7,837,838,1,
Zoology,Solvent control,19,7,839,842,3,
Zoology,Solvent control,19,7,855,861,6,
Zoology,Solvent control,19,7,861,861,0,
Zoology,Solvent control,19,7,928,934,6,
Zoology,Solvent control,19,7,980,982,2,
Zoology,Solvent control,19,7,1016,1016,0,
Zoology,Solvent control,19,7,1075,1079,4,
Zoology,Solvent control,19,7,1094,1098,4,
Zoology,Solvent control,19,7,1114,1114,0,
Zoology,Solvent control,19,7,1132,1133,1,
Zoology,Solvent control,19,7,1156,1158,2,
Zoology,Solvent control,19,7,1167,1168,1,
Zoology,Solvent control,19,7,1182,1182,0,
Zoology,Solvent control,19,7,1210,1210,0,
Zoology,Solvent control,19,7,1220,1220,0,
Zoology,Solvent control,19,7,1236,1236,0,
Zoology,Solvent control,19,7,1365,1366,1,
Zoology,Solvent control,19,7,1376,1376,0,
Zoology,Solvent control,19,7,1471,1477,6,
Zoology,Solvent control,19,7,1481,1483,2,
Zoology,Solvent control,19,7,1507,1508,1,
Zoology,Solvent control,19,7,1514,1516,2,
Zoology,Solvent control,19,7,1526,1526,0,
Zoology,Solvent control,19,7,1562,1564,2,
Zoology,Solvent control,19,7,1566,1566,0,
Zoology,Solvent control,19,7,1602,1602,0,
Zoology,Solvent control,19,7,1724,1726,2,
Zoology,Solvent control,19,7,1771,1771,0,
Zoology,Solvent control,19,7,1775,1782,7,bee not touching paper but seems to be sniffing
Zoology,Solvent control,19,7,1792,1794,2,
Zoology,Solvent control,23,7,48,49,1,
Zoology,Solvent control,23,7,57,59,2,
Zoology,Solvent control,23,7,172,173,1,
Zoology,Solvent control,23,7,181,181,0,
Zoology,Solvent control,23,7,271,271,0,
Zoology,Solvent control,23,7,276,276,0,
Zoology,Solvent control,23,7,386,387,1,
Zoology,Solvent control,23,7,408,409,1,bees just settle down and don't move after this
Zoology,Solvent control,27,12,3,3,0,
Zoology,Solvent control,27,12,26,28,2,
Zoology,Solvent control,27,12,63,63,0,
Zoology,Solvent control,27,12,66,68,2,
Zoology,Solvent control,27,12,77,78,1,
Zoology,Solvent control,27,12,104,105,1,
Zoology,Solvent control,27,12,118,120,2,
Zoology,Solvent control,27,12,148,148,0,
Zoology,Solvent control,27,12,169,177,8,
Zoology,Solvent control,27,12,176,177,1,
Zoology,Solvent control,27,12,178,180,2,
Zoology,Solvent control,27,12,184,186,2,
Zoology,Solvent control,27,12,192,192,0,
Zoology,Solvent control,27,12,198,200,2,
Zoology,Solvent control,27,12,220,221,1,
Zoology,Solvent control,27,12,223,226,3,
Zoology,Solvent control,27,12,342,350,8,
Zoology,Solvent control,27,12,293,296,3,
Zoology,Solvent control,27,12,452,455,3,
Zoology,Solvent control,27,12,474,475,1,
Zoology,Solvent control,27,12,487,488,1,
Zoology,Solvent control,27,12,582,583,1,
Zoology,Solvent control,27,12,686,686,0,
Zoology,Solvent control,27,12,716,716,0,
Zoology,Solvent control,27,12,840,841,1,
Zoology,Solvent control,27,12,916,916,0,
Zoology,Solvent control,27,12,941,948,7,
Zoology,Solvent control,27,12,1028,1029,1,
Zoology,Solvent control,27,12,1051,1055,4,
Zoology,Solvent control,27,12,1204,1204,0,
Zoology,Solvent control,27,12,1253,1254,1,
Zoology,Solvent control,27,12,1342,1345,3,
Zoology,Solvent control,27,12,1368,1368,0,
Zoology,Solvent control,27,12,1723,1726,3,
Zoology,Solvent control,27,12,1761,1761,0,
Zoology,Solvent control,32,6,2,2,0,NEED TO GO BACK TO THIS TRAY
Zoology,Solvent control,32,6,11,11,0,
Zoology,Solvent control,32,6,19,20,1,
Zoology,Solvent control,32,6,59,62,3,
Zoology,Solvent control,32,6,95,95,0,
Zoology,Solvent control,32,6,104,104,0,
Zoology,Solvent control,32,6,105,105,0,
Zoology,Solvent control,32,6,151,152,1,
Zoology,Solvent control,32,6,156,156,0,
Zoology,Solvent control,32,6,177,178,1,
Zoology,Solvent control,32,6,214,214,0,
Zoology,Solvent control,32,6,285,290,5,
Zoology,Solvent control,32,6,308,308,0,
Zoology,Solvent control,32,6,344,344,0,
Zoology,Solvent control,32,6,369,369,0,
Zoology,Solvent control,32,6,401,401,0,
Zoology,Solvent control,32,6,405,405,0,
Zoology,Solvent control,32,6,421,421,0,
Zoology,Solvent control,32,6,490,490,0,
Zoology,Solvent control,32,6,535,535,0,
Zoology,Solvent control,32,6,537,538,1,
Zoology,Solvent control,32,6,615,615,0,
Zoology,Solvent control,32,6,634,634,0,
Zoology,Solvent control,32,6,649,653,4,
Zoology,Solvent control,32,6,696,696,0,
Zoology,Solvent control,32,6,725,728,3,
Zoology,Solvent control,32,6,729,729,0,
Zoology,Solvent control,32,6,747,747,0,
Zoology,Solvent control,32,6,750,750,0,
Zoology,Solvent control,32,6,768,768,0,
Zoology,Solvent control,32,6,809,811,2,
Zoology,Solvent control,32,6,840,846,6,
Zoology,Solvent control,32,6,855,855,0,
Zoology,Solvent control,32,6,878,878,0,
Zoology,Solvent control,32,6,884,884,0,
Zoology,Solvent control,32,6,886,886,0,
Zoology,Solvent control,32,6,921,923,2,
Zoology,Solvent control,32,6,937,941,4,
Zoology,Solvent control,32,6,963,963,0,
Zoology,Solvent control,32,6,973,978,5,
Zoology,Solvent control,32,6,1008,1013,5,
Zoology,Solvent control,32,6,1037,1037,0,
Zoology,Solvent control,32,6,1057,1057,0,
Zoology,Solvent control,32,6,1085,1086,1,
Zoology,Solvent control,32,6,1089,1089,0,
Zoology,Solvent control,32,6,1109,1111,2,
Zoology,Solvent control,32,6,1175,1175,0,
Zoology,Solvent control,32,6,1177,1177,0,
Zoology,Solvent control,32,6,1241,1241,0,
Zoology,Solvent control,32,6,1389,1389,0,
Zoology,Solvent control,32,6,1395,1395,0,
Zoology,Solvent control,32,6,1496,1496,0,
Zoology,Solvent control,32,6,1522,1527,5,
Zoology,Solvent control,32,6,1548,1548,0,
Zoology,Solvent control,32,6,1586,1586,0,
Zoology,Solvent control,32,6,1595,1598,3,
Zoology,Solvent control,32,6,1600,1609,9,
Zoology,Solvent control,32,6,1621,1621,0,
Zoology,Solvent control,32,6,1654,1654,0,
Zoology,Solvent control,32,6,1699,1702,3,
Zoology,Solvent control,32,6,122,127,5,
Zoology,10-HDA (worker control),4,10,73,77,4,
Zoology,10-HDA (worker control),4,10,139,140,1,
Zoology,10-HDA (worker control),4,10,143,143,0,
Zoology,10-HDA (worker control),4,10,141,141,0,
Zoology,10-HDA (worker control),4,10,179,179,0,
Zoology,10-HDA (worker control),4,10,181,181,0,
Zoology,10-HDA (worker control),4,10,214,215,1,
Zoology,10-HDA (worker control),4,10,216,217,1,
Zoology,10-HDA (worker control),4,10,240,242,2,
Zoology,10-HDA (worker control),4,10,243,244,1,
Zoology,10-HDA (worker control),4,10,290,290,0,
Zoology,10-HDA (worker control),4,10,303,306,3,
Zoology,10-HDA (worker control),4,10,311,315,4,
Zoology,10-HDA (worker control),4,10,317,317,0,
Zoology,10-HDA (worker control),4,10,331,332,1,
Zoology,10-HDA (worker control),4,10,353,354,1,
Zoology,10-HDA (worker control),4,10,382,382,0,
Zoology,10-HDA (worker control),4,10,419,420,1,
Zoology,10-HDA (worker control),4,10,425,426,1,
Zoology,10-HDA (worker control),4,10,438,439,1,
Zoology,10-HDA (worker control),4,10,444,445,1,
Zoology,10-HDA (worker control),4,10,452,454,2,
Zoology,10-HDA (worker control),4,10,460,461,1,
Zoology,10-HDA (worker control),4,10,469,469,0,
Zoology,10-HDA (worker control),4,10,471,471,0,
Zoology,10-HDA (worker control),4,10,474,474,0,
Zoology,10-HDA (worker control),4,10,506,506,0,
Zoology,10-HDA (worker control),4,10,519,520,1,
Zoology,10-HDA (worker control),4,10,525,526,1,
Zoology,10-HDA (worker control),4,10,584,584,0,
Zoology,10-HDA (worker control),4,10,617,617,0,
Zoology,10-HDA (worker control),4,10,628,630,2,
Zoology,10-HDA (worker control),4,10,669,670,1,
Zoology,10-HDA (worker control),4,10,738,738,0,
Zoology,10-HDA (worker control),4,10,747,750,3,
Zoology,10-HDA (worker control),4,10,760,763,3,
Zoology,10-HDA (worker control),4,10,765,766,1,
Zoology,10-HDA (worker control),4,10,787,788,1,
Zoology,10-HDA (worker control),4,10,802,802,0,
Zoology,10-HDA (worker control),4,10,1106,1106,0,
Zoology,10-HDA (worker control),4,10,1116,1116,0,
Zoology,10-HDA (worker control),4,10,1134,1134,0,
Zoology,10-HDA (worker control),4,10,1189,1189,0,
Zoology,10-HDA (worker control),4,10,1195,1196,1,
Zoology,10-HDA (worker control),4,10,1246,1246,0,
Zoology,10-HDA (worker control),4,10,1248,1248,0,
Zoology,10-HDA (worker control),4,10,1278,1278,0,
Zoology,10-HDA (worker control),4,10,1299,1300,1,
Zoology,10-HDA (worker control),4,10,1328,1328,0,
Zoology,10-HDA (worker control),4,10,1332,1334,2,
Zoology,10-HDA (worker control),4,10,1487,1489,2,
Zoology,10-HDA (worker control),4,10,1518,1519,1,
Zoology,10-HDA (worker control),4,10,1599,1601,2,
Zoology,10-HDA (worker control),4,10,1634,1634,0,
Zoology,10-HDA (worker control),4,10,1689,1755,66,
Zoology,10-HDA (worker control),5,6,0,3,3,
Zoology,10-HDA (worker control),5,6,4,9,5,
Zoology,10-HDA (worker control),5,6,11,12,1,
Zoology,10-HDA (worker control),5,6,17,18,1,
Zoology,10-HDA (worker control),5,6,81,85,4,
Zoology,10-HDA (worker control),5,6,93,94,1,
Zoology,10-HDA (worker control),5,6,116,118,2,
Zoology,10-HDA (worker control),5,6,132,134,2,
Zoology,10-HDA (worker control),5,6,189,191,2,
Zoology,10-HDA (worker control),5,6,192,194,2,
Zoology,10-HDA (worker control),5,6,202,208,6,
Zoology,10-HDA (worker control),5,6,222,225,3,
Zoology,10-HDA (worker control),5,6,268,272,4,
Zoology,10-HDA (worker control),5,6,318,319,1,
Zoology,10-HDA (worker control),5,6,326,341,15,"bee sort of faces the paper from afar, maybe sniffing"
Zoology,10-HDA (worker control),5,6,344,346,2,
Zoology,10-HDA (worker control),5,6,411,413,2,
Zoology,10-HDA (worker control),5,6,483,488,5,
Zoology,10-HDA (worker control),5,6,548,553,5,
Zoology,10-HDA (worker control),5,6,569,570,1,
Zoology,10-HDA (worker control),5,6,604,604,0,
Zoology,10-HDA (worker control),5,6,620,620,0,
Zoology,10-HDA (worker control),5,6,630,644,14,
Zoology,10-HDA (worker control),5,6,670,670,0,
Zoology,10-HDA (worker control),5,6,680,681,1,
Zoology,10-HDA (worker control),5,6,701,702,1,
Zoology,10-HDA (worker control),5,6,724,724,0,
Zoology,10-HDA (worker control),5,6,761,762,1,
Zoology,10-HDA (worker control),5,6,771,771,0,
Zoology,10-HDA (worker control),5,6,853,860,7,
Zoology,10-HDA (worker control),5,6,863,864,1,
Zoology,10-HDA (worker control),5,6,869,888,19,
Zoology,10-HDA (worker control),5,6,897,916,19,
Zoology,10-HDA (worker control),5,6,941,946,5,
Zoology,10-HDA (worker control),5,6,946,954,8,
Zoology,10-HDA (worker control),5,6,955,963,8,
Zoology,10-HDA (worker control),5,6,1005,1007,2,
Zoology,10-HDA (worker control),5,6,1009,1013,4,
Zoology,10-HDA (worker control),5,6,1027,1031,4,
Zoology,10-HDA (worker control),5,6,1034,1035,1,
Zoology,10-HDA (worker control),5,6,1038,1043,5,
Zoology,10-HDA (worker control),5,6,1045,1045,0,
Zoology,10-HDA (worker control),5,6,979,1021,42,bee sniffs from afar maybe.
Zoology,10-HDA (worker control),5,6,1028,1039,11,
Zoology,10-HDA (worker control),5,6,1044,1090,46,bee mostly sniffs from afar 17:53 18 20 bee actively touching paper
Zoology,10-HDA (worker control),5,6,1107,1110,3,
Zoology,10-HDA (worker control),5,6,1149,1150,1,
Zoology,10-HDA (worker control),5,6,1167,1167,0,
Zoology,10-HDA (worker control),5,6,1169,1169,0,
Zoology,10-HDA (worker control),5,6,1176,1182,6,
Zoology,10-HDA (worker control),5,6,1217,1217,0,
Zoology,10-HDA (worker control),5,6,1222,1224,2,
Zoology,10-HDA (worker control),5,6,1228,1232,4,
Zoology,10-HDA (worker control),5,6,1258,1266,8,
Zoology,10-HDA (worker control),5,6,1289,1290,1,
Zoology,10-HDA (worker control),5,6,1290,1314,24,
Zoology,10-HDA (worker control),5,6,1310,1312,2,
Zoology,10-HDA (worker control),5,6,1334,1335,1,
Zoology,10-HDA (worker control),5,6,1335,1335,0,
Zoology,10-HDA (worker control),5,6,1348,1348,0,maybe very fast touch
Zoology,10-HDA (worker control),5,6,1382,1382,0,
Zoology,10-HDA (worker control),5,6,1403,1404,1,
Zoology,10-HDA (worker control),5,6,1403,1404,1,
Zoology,10-HDA (worker control),5,6,1407,1408,1,
Zoology,10-HDA (worker control),5,6,1410,1411,1,
Zoology,10-HDA (worker control),5,6,1447,1449,2,
Zoology,10-HDA (worker control),5,6,1477,1484,7,
Zoology,10-HDA (worker control),5,6,1494,1495,1,
Zoology,10-HDA (worker control),5,6,1520,1521,1,
Zoology,10-HDA (worker control),5,6,1524,1538,14,
Zoology,10-HDA (worker control),5,6,1551,1552,1,
Zoology,10-HDA (worker control),5,6,1598,1600,2,
Zoology,10-HDA (worker control),5,6,1599,1609,10,
Zoology,10-HDA (worker control),5,6,1612,1616,4,
Zoology,10-HDA (worker control),5,6,1623,1623,0,
Zoology,10-HDA (worker control),5,6,1658,1658,0,
Zoology,10-HDA (worker control),5,6,1668,1670,2,
Zoology,10-HDA (worker control),5,6,1703,1706,3,
Zoology,10-HDA (worker control),5,6,1714,1719,5,
Zoology,10-HDA (worker control),5,6,1743,1743,0,
Zoology,10-HDA (worker control),5,6,1775,1778,3,
Zoology,10-HDA (worker control),6,2,42,50,8,
Zoology,10-HDA (worker control),6,2,81,81,0,
Zoology,10-HDA (worker control),6,2,89,89,0,
Zoology,10-HDA (worker control),6,2,92,92,0,
Zoology,10-HDA (worker control),6,2,116,117,1,
Zoology,10-HDA (worker control),6,2,118,120,2,
Zoology,10-HDA (worker control),6,2,176,177,1,
Zoology,10-HDA (worker control),6,2,212,213,1,
Zoology,10-HDA (worker control),6,2,226,227,1,
Zoology,10-HDA (worker control),6,2,241,241,0,
Zoology,10-HDA (worker control),6,2,266,268,2,
Zoology,10-HDA (worker control),6,2,318,320,2,
Zoology,10-HDA (worker control),6,2,329,329,0,
Zoology,10-HDA (worker control),6,2,338,339,1,
Zoology,10-HDA (worker control),6,2,352,352,0,
Zoology,10-HDA (worker control),6,2,373,374,1,
Zoology,10-HDA (worker control),6,2,384,394,10,
Zoology,10-HDA (worker control),6,2,453,453,0,
Zoology,10-HDA (worker control),6,2,476,476,0,
Zoology,10-HDA (worker control),6,2,507,508,1,
Zoology,10-HDA (worker control),6,2,519,519,0,
Zoology,10-HDA (worker control),6,2,541,541,0,
Zoology,10-HDA (worker control),6,2,590,590,0,
Zoology,10-HDA (worker control),6,2,657,659,2,
Zoology,10-HDA (worker control),6,2,754,754,0,
Zoology,10-HDA (worker control),6,2,765,766,1,
Zoology,10-HDA (worker control),6,2,768,774,6,
Zoology,10-HDA (worker control),6,2,799,806,7,
Zoology,10-HDA (worker control),6,2,848,849,1,
Zoology,10-HDA (worker control),6,2,856,856,0,
Zoology,10-HDA (worker control),6,2,866,867,1,
Zoology,10-HDA (worker control),6,2,867,868,1,
Zoology,10-HDA (worker control),6,2,889,889,0,
Zoology,10-HDA (worker control),6,2,908,911,3,
Zoology,10-HDA (worker control),6,2,926,927,1,
Zoology,10-HDA (worker control),6,2,937,937,0,
Zoology,10-HDA (worker control),6,2,942,942,0,
Zoology,10-HDA (worker control),6,2,991,992,1,
Zoology,10-HDA (worker control),6,2,1005,1005,0,
Zoology,10-HDA (worker control),6,2,1102,1104,2,
Zoology,10-HDA (worker control),6,2,1118,1119,1,
Zoology,10-HDA (worker control),6,2,1154,1155,1,
Zoology,10-HDA (worker control),6,2,1193,1202,9,
Zoology,10-HDA (worker control),6,2,1233,1236,3,"bee sort of sniffs from afar, not super convinced."
Zoology,10-HDA (worker control),6,2,1238,1238,0,
Zoology,10-HDA (worker control),6,2,1277,1278,1,
Zoology,10-HDA (worker control),6,2,1281,1281,0,
Zoology,10-HDA (worker control),6,2,1288,1288,0,
Zoology,10-HDA (worker control),6,2,1336,1336,0,
Zoology,10-HDA (worker control),6,2,1358,1358,0,
Zoology,10-HDA (worker control),6,2,1367,1370,3,bee sit still facing the paper a distance from it
Zoology,10-HDA (worker control),6,2,1379,1380,1,
Zoology,10-HDA (worker control),6,2,1378,1386,8,bee sit still facing the paper a distance from it
Zoology,10-HDA (worker control),6,2,1432,1437,5,
Zoology,10-HDA (worker control),6,2,1459,1460,1,
Zoology,10-HDA (worker control),6,2,1464,1464,0,
Zoology,10-HDA (worker control),6,2,1481,1482,1,
Zoology,10-HDA (worker control),6,2,1486,1488,2,
Zoology,10-HDA (worker control),6,2,1515,1515,0,
Zoology,10-HDA (worker control),6,2,1530,1532,2,
Zoology,10-HDA (worker control),6,2,1539,1544,5,
Zoology,10-HDA (worker control),6,2,1584,1588,4,
Zoology,10-HDA (worker control),6,2,1592,1593,1,
Zoology,10-HDA (worker control),6,2,1600,1601,1,maybe
Zoology,10-HDA (worker control),6,2,1607,1608,1,bee sort of sniffs from afar
Zoology,10-HDA (worker control),6,2,1619,1619,0,
Zoology,10-HDA (worker control),6,2,1620,1621,1,
Zoology,10-HDA (worker control),6,2,1275,1275,0,maybe
Zoology,10-HDA (worker control),6,2,1276,1276,0,maybe
Zoology,10-HDA (worker control),6,2,1671,1672,1,
Zoology,10-HDA (worker control),6,2,1675,1676,1,
Zoology,10-HDA (worker control),6,2,1688,1688,0,
Zoology,10-HDA (worker control),6,2,1702,1702,0,
Zoology,10-HDA (worker control),6,2,1712,1713,1,
Zoology,10-HDA (worker control),6,2,1717,1717,0,
Zoology,10-HDA (worker control),6,2,1762,1763,1,
Zoology,10-HDA (worker control),6,2,1773,1775,2,
Zoology,10-HDA (worker control),6,2,1789,1790,1,bee bumps in to paper
Zoology,10-HDA (worker control),7,8,11,12,1,
Zoology,10-HDA (worker control),7,8,29,30,1,
Zoology,10-HDA (worker control),7,8,52,52,0,
Zoology,10-HDA (worker control),7,8,117,120,3,
Zoology,10-HDA (worker control),7,8,207,208,1,
Zoology,10-HDA (worker control),7,8,223,226,3,
Zoology,10-HDA (worker control),7,8,287,288,1,
Zoology,10-HDA (worker control),7,8,298,298,0,
Zoology,10-HDA (worker control),7,8,299,300,1,
Zoology,10-HDA (worker control),7,8,306,306,0,
Zoology,10-HDA (worker control),7,8,328,329,1,
Zoology,10-HDA (worker control),7,8,338,338,0,
Zoology,10-HDA (worker control),7,8,356,356,0,
Zoology,10-HDA (worker control),7,8,375,376,1,
Zoology,10-HDA (worker control),7,8,398,399,1,
Zoology,10-HDA (worker control),7,8,441,441,0,
Zoology,10-HDA (worker control),7,8,443,445,2,
Zoology,10-HDA (worker control),7,8,444,444,0,
Zoology,10-HDA (worker control),7,8,449,450,1,
Zoology,10-HDA (worker control),7,8,461,461,0,
Zoology,10-HDA (worker control),7,8,527,531,4,
Zoology,10-HDA (worker control),7,8,531,531,0,
Zoology,10-HDA (worker control),7,8,549,551,2,
Zoology,10-HDA (worker control),7,8,555,556,1,
Zoology,10-HDA (worker control),7,8,576,577,1,
Zoology,10-HDA (worker control),7,8,598,598,0,
Zoology,10-HDA (worker control),7,8,663,664,1,
Zoology,10-HDA (worker control),7,8,676,676,0,
Zoology,10-HDA (worker control),7,8,697,698,1,
Zoology,10-HDA (worker control),7,8,717,719,2,
Zoology,10-HDA (worker control),7,8,726,728,2,
Zoology,10-HDA (worker control),7,8,729,729,0,
Zoology,10-HDA (worker control),7,8,765,766,1,
Zoology,10-HDA (worker control),7,8,782,782,0,
Zoology,10-HDA (worker control),7,8,783,784,1,
Zoology,10-HDA (worker control),7,8,793,793,0,
Zoology,10-HDA (worker control),7,8,812,812,0,
Zoology,10-HDA (worker control),7,8,1012,1013,1,
Zoology,10-HDA (worker control),7,8,1023,1024,1,
Zoology,10-HDA (worker control),7,8,1026,1028,2,
Zoology,10-HDA (worker control),7,8,1040,1044,4,
Zoology,10-HDA (worker control),7,8,1124,1126,2,
Zoology,10-HDA (worker control),7,8,1146,1146,0,
Zoology,10-HDA (worker control),7,8,1170,1173,3,
Zoology,10-HDA (worker control),7,8,1196,1199,3,
Zoology,10-HDA (worker control),7,8,1252,1253,1,
Zoology,10-HDA (worker control),7,8,1281,1282,1,
Zoology,10-HDA (worker control),7,8,1339,1343,4,
Zoology,10-HDA (worker control),7,8,1381,1382,1,
Zoology,10-HDA (worker control),7,8,1393,1393,0,
Zoology,10-HDA (worker control),7,8,1393,1395,2,
Zoology,10-HDA (worker control),7,8,1429,1429,0,
Zoology,10-HDA (worker control),7,8,1510,1511,1,
Zoology,10-HDA (worker control),7,8,1516,1518,2,
Zoology,10-HDA (worker control),7,8,1523,1523,0,
Zoology,10-HDA (worker control),7,8,1578,1578,0,
Zoology,10-HDA (worker control),7,8,1651,1652,1,
Zoology,10-HDA (worker control),7,8,1664,1664,0,
Zoology,10-HDA (worker control),7,8,1687,1693,6,
Zoology,10-HDA (worker control),7,8,1710,1710,0,
Zoology,10-HDA (worker control),7,8,1717,1718,1,
Zoology,10-HDA (worker control),7,8,1730,1730,0,
Zoology,10-HDA (worker control),7,8,1751,1752,1,
Zoology,10-HDA (worker control),8,8,28,30,2,
Zoology,10-HDA (worker control),8,8,40,40,0,
Zoology,10-HDA (worker control),8,8,72,72,0,
Zoology,10-HDA (worker control),8,8,72,72,0,
Zoology,10-HDA (worker control),8,8,77,90,13,
Zoology,10-HDA (worker control),8,8,101,102,1,
Zoology,10-HDA (worker control),8,8,140,142,2,
Zoology,10-HDA (worker control),8,8,186,186,0,very fast almost touch
Zoology,10-HDA (worker control),8,8,195,195,0,
Zoology,10-HDA (worker control),8,8,198,202,4,
Zoology,10-HDA (worker control),8,8,199,203,4,
Zoology,10-HDA (worker control),8,8,205,206,1,
Zoology,10-HDA (worker control),8,8,231,231,0,
Zoology,10-HDA (worker control),8,8,237,237,0,
Zoology,10-HDA (worker control),8,8,280,281,1,
Zoology,10-HDA (worker control),8,8,317,320,3,
Zoology,10-HDA (worker control),8,8,331,331,0,
Zoology,10-HDA (worker control),8,8,219,220,1,
Zoology,10-HDA (worker control),8,8,231,231,0,
Zoology,10-HDA (worker control),8,8,381,381,0,
Zoology,10-HDA (worker control),8,8,444,446,2,
Zoology,10-HDA (worker control),8,8,508,508,0,
Zoology,10-HDA (worker control),8,8,510,510,0,
Zoology,10-HDA (worker control),8,8,511,512,1,
Zoology,10-HDA (worker control),8,8,537,541,4,
Zoology,10-HDA (worker control),8,8,546,548,2,
Zoology,10-HDA (worker control),8,8,550,550,0,
Zoology,10-HDA (worker control),8,8,566,567,1,
Zoology,10-HDA (worker control),8,8,602,603,1,
Zoology,10-HDA (worker control),8,8,624,625,1,
Zoology,10-HDA (worker control),8,8,637,646,9,
Zoology,10-HDA (worker control),8,8,654,656,2,
Zoology,10-HDA (worker control),8,8,673,676,3,
Zoology,10-HDA (worker control),8,8,741,741,0,
Zoology,10-HDA (worker control),8,8,755,755,0,
Zoology,10-HDA (worker control),8,8,761,766,5,
Zoology,10-HDA (worker control),8,8,780,780,0,
Zoology,10-HDA (worker control),8,8,793,796,3,
Zoology,10-HDA (worker control),8,8,901,901,0,
Zoology,10-HDA (worker control),8,8,903,903,0,
Zoology,10-HDA (worker control),8,8,917,917,0,
Zoology,10-HDA (worker control),8,8,934,935,1,
Zoology,10-HDA (worker control),8,8,940,941,1,
Zoology,10-HDA (worker control),8,8,1e3,1e3,0,
Zoology,10-HDA (worker control),8,8,1029,1030,1,sort of touches circle around paper deliberately
Zoology,10-HDA (worker control),8,8,1041,1042,1,
Zoology,10-HDA (worker control),8,8,1044,1044,0,
Zoology,10-HDA (worker control),8,8,1047,1047,0,
Zoology,10-HDA (worker control),8,8,1085,1086,1,
Zoology,10-HDA (worker control),8,8,1088,1090,2,
Zoology,10-HDA (worker control),8,8,1109,1110,1,
Zoology,10-HDA (worker control),8,8,1133,1134,1,
Zoology,10-HDA (worker control),8,8,1165,1166,1,
Zoology,10-HDA (worker control),8,8,1184,1185,1,
Zoology,10-HDA (worker control),8,8,1194,1195,1,
Zoology,10-HDA (worker control),8,8,1197,1198,1,
Zoology,10-HDA (worker control),8,8,1214,1219,5,bee sort of sniffs at the circle around the paper.
Zoology,10-HDA (worker control),8,8,1242,1243,1,
Zoology,10-HDA (worker control),8,8,1243,1244,1,
Zoology,10-HDA (worker control),8,8,1249,1249,0,
Zoology,10-HDA (worker control),8,8,1256,1258,2,
Zoology,10-HDA (worker control),8,8,1273,1273,0,
Zoology,10-HDA (worker control),8,8,1276,1276,0,
Zoology,10-HDA (worker control),8,8,1282,1282,0,
Zoology,10-HDA (worker control),8,8,1289,1292,3,
Zoology,10-HDA (worker control),8,8,1307,1308,1,
Zoology,10-HDA (worker control),8,8,1317,1318,1,
Zoology,10-HDA (worker control),8,8,1340,1340,0,
Zoology,10-HDA (worker control),8,8,1353,1353,0,
Zoology,10-HDA (worker control),8,8,1367,1367,0,
Zoology,10-HDA (worker control),8,8,1370,1381,11,
Zoology,10-HDA (worker control),8,8,1390,1391,1,
Zoology,10-HDA (worker control),8,8,1391,1410,19,
Zoology,10-HDA (worker control),8,8,1399,1399,0,
Zoology,10-HDA (worker control),8,8,1417,1429,12,
Zoology,10-HDA (worker control),8,8,1421,1422,1,faces paper from a distance
Zoology,10-HDA (worker control),8,8,1461,1461,0,
Zoology,10-HDA (worker control),8,8,1463,1463,0,
Zoology,10-HDA (worker control),8,8,1478,1480,2,
Zoology,10-HDA (worker control),8,8,1503,1505,2,
Zoology,10-HDA (worker control),8,8,1536,1537,1,
Zoology,10-HDA (worker control),8,8,1561,1561,0,
Zoology,10-HDA (worker control),8,8,1566,1568,2,
Zoology,10-HDA (worker control),8,8,1571,1573,2,
Zoology,10-HDA (worker control),8,8,1572,1577,5,
Zoology,10-HDA (worker control),8,8,1592,1593,1,
Zoology,10-HDA (worker control),8,8,1594,1595,1,
Zoology,10-HDA (worker control),8,8,1613,1614,1,
Zoology,10-HDA (worker control),8,8,1624,1624,0,
Zoology,10-HDA (worker control),8,8,1643,1645,2,
Zoology,10-HDA (worker control),8,8,1666,1666,0,
Zoology,10-HDA (worker control),8,8,1671,1672,1,
Zoology,10-HDA (worker control),8,8,1673,1674,1,
Zoology,10-HDA (worker control),8,8,1709,1710,1,
Zoology,10-HDA (worker control),8,8,1748,1749,1,
Zoology,10-HDA (worker control),8,8,1752,1752,0,
Zoology,10-HDA (worker control),8,8,1758,1761,3,
Zoology,10-HDA (worker control),8,8,1772,1772,0,
Zoology,10-HDA (worker control),8,8,1786,1786,0,
Zoology,10-HDA (worker control),8,8,1796,1796,0,
Zoology,10-HDA (worker control),9,5,2,2,0,
Zoology,10-HDA (worker control),9,5,38,38,0,
Zoology,10-HDA (worker control),9,5,81,81,0,
Zoology,10-HDA (worker control),9,5,84,84,0,
Zoology,10-HDA (worker control),9,5,156,156,0,
Zoology,10-HDA (worker control),9,5,177,184,7,
Zoology,10-HDA (worker control),9,5,228,232,4,
Zoology,10-HDA (worker control),9,5,235,235,0,
Zoology,10-HDA (worker control),9,5,241,241,0,
Zoology,10-HDA (worker control),9,5,259,261,2,
Zoology,10-HDA (worker control),9,5,330,330,0,
Zoology,10-HDA (worker control),9,5,337,337,0,
Zoology,10-HDA (worker control),9,5,354,354,0,
Zoology,10-HDA (worker control),9,5,355,356,1,
Zoology,10-HDA (worker control),9,5,380,381,1,
Zoology,10-HDA (worker control),9,5,403,403,0,
Zoology,10-HDA (worker control),9,5,411,413,2,
Zoology,10-HDA (worker control),9,5,416,418,2,
Zoology,10-HDA (worker control),9,5,557,557,0,
Zoology,10-HDA (worker control),9,5,596,596,0,
Zoology,10-HDA (worker control),9,5,606,606,0,
Zoology,10-HDA (worker control),9,5,638,640,2,
Zoology,10-HDA (worker control),9,5,642,643,1,
Zoology,10-HDA (worker control),9,5,646,647,1,
Zoology,10-HDA (worker control),9,5,659,662,3,
Zoology,10-HDA (worker control),9,5,680,680,0,
Zoology,10-HDA (worker control),9,5,699,699,0,
Zoology,10-HDA (worker control),9,5,703,703,0,
Zoology,10-HDA (worker control),9,5,773,776,3,
Zoology,10-HDA (worker control),9,5,796,799,3,
Zoology,10-HDA (worker control),9,5,855,855,0,
Zoology,10-HDA (worker control),9,5,907,907,0,
Zoology,10-HDA (worker control),9,5,925,925,0,maybe - very quick passing touch
Zoology,10-HDA (worker control),9,5,939,939,0,
Zoology,10-HDA (worker control),9,5,940,942,2,
Zoology,10-HDA (worker control),9,5,959,960,1,
Zoology,10-HDA (worker control),9,5,1044,1044,0,
Zoology,10-HDA (worker control),9,5,1066,1066,0,
Zoology,10-HDA (worker control),9,5,1070,1070,0,
Zoology,10-HDA (worker control),9,5,1130,1133,3,
Zoology,10-HDA (worker control),9,5,1206,1209,3,
Zoology,10-HDA (worker control),9,5,1210,1212,2,
Zoology,10-HDA (worker control),9,5,1213,1217,4,
Zoology,10-HDA (worker control),9,5,1222,1222,0,
Zoology,10-HDA (worker control),9,5,1235,1236,1,
Zoology,10-HDA (worker control),9,5,1236,1237,1,
Zoology,10-HDA (worker control),9,5,1237,1239,2,
Zoology,10-HDA (worker control),9,5,1243,1248,5,
Zoology,10-HDA (worker control),9,5,1274,1275,1,
Zoology,10-HDA (worker control),9,5,1362,1362,0,
Zoology,10-HDA (worker control),9,5,1367,1368,1,
Zoology,10-HDA (worker control),9,5,1394,1394,0,
Zoology,10-HDA (worker control),9,5,1443,1444,1,
Zoology,10-HDA (worker control),9,5,1473,1473,0,
Zoology,10-HDA (worker control),9,5,1524,1525,1,
Zoology,10-HDA (worker control),9,5,1550,1552,2,
Zoology,10-HDA (worker control),9,5,1567,1568,1,
Zoology,10-HDA (worker control),9,5,1589,1589,0,
Zoology,10-HDA (worker control),9,5,1615,1617,2,
Zoology,10-HDA (worker control),9,5,1637,1638,1,
Zoology,10-HDA (worker control),9,5,1675,1675,0,
Zoology,10-HDA (worker control),9,5,1715,1716,1,
Zoology,10-HDA (worker control),9,5,1718,1718,0,
Zoology,10-HDA (worker control),9,5,1790,1790,0,
Zoology,10-HDA (worker control),11,10,14,14,0,
Zoology,10-HDA (worker control),11,10,15,15,0,
Zoology,10-HDA (worker control),11,10,54,54,0,
Zoology,10-HDA (worker control),11,10,57,57,0,
Zoology,10-HDA (worker control),11,10,105,107,2,
Zoology,10-HDA (worker control),11,10,129,129,0,
Zoology,10-HDA (worker control),11,10,132,132,0,
Zoology,10-HDA (worker control),11,10,197,198,1,
Zoology,10-HDA (worker control),11,10,363,363,0,
Zoology,10-HDA (worker control),11,10,416,416,0,
Zoology,10-HDA (worker control),11,10,449,449,0,
Zoology,10-HDA (worker control),11,10,472,472,0,
Zoology,10-HDA (worker control),11,10,472,473,1,
Zoology,10-HDA (worker control),11,10,473,477,4,
Zoology,10-HDA (worker control),11,10,477,477,0,
Zoology,10-HDA (worker control),11,10,510,523,13,
Zoology,10-HDA (worker control),11,10,526,526,0,
Zoology,10-HDA (worker control),11,10,626,631,5,
Zoology,10-HDA (worker control),11,10,677,678,1,
Zoology,10-HDA (worker control),11,10,689,689,0,
Zoology,10-HDA (worker control),11,10,721,721,0,
Zoology,10-HDA (worker control),11,10,1002,1005,3,
Zoology,10-HDA (worker control),11,10,1020,1020,0,
Zoology,10-HDA (worker control),11,10,1054,1054,0,
Zoology,10-HDA (worker control),11,10,1063,1063,0,maybe - not really touching
Zoology,10-HDA (worker control),11,10,1117,1117,0,
Zoology,10-HDA (worker control),11,10,1120,1120,0,
Zoology,10-HDA (worker control),11,10,1154,1154,0,
Zoology,10-HDA (worker control),11,10,1168,1168,0,
Zoology,10-HDA (worker control),11,10,1208,1208,0,
Zoology,10-HDA (worker control),11,10,1271,1271,0,
Zoology,10-HDA (worker control),11,10,1349,1349,0,
Zoology,10-HDA (worker control),11,10,1394,1394,0,
Zoology,10-HDA (worker control),11,10,1532,1532,0,
Zoology,10-HDA (worker control),11,10,1597,1602,5,
Zoology,10-HDA (worker control),11,10,1609,1611,2,
Zoology,10-HDA (worker control),11,10,1629,1700,71,bee mostly still really close to paper facing it
Zoology,10-HDA (worker control),11,10,1639,1641,2,
Zoology,10-HDA (worker control),11,10,1705,1714,9,bee mostly still really close to paper facing it
Zoology,10-HDA (worker control),11,10,1713,1714,1,
Zoology,10-HDA (worker control),11,10,1721,1721,0,
Zoology,10-HDA (worker control),11,10,1773,1776,3,
Zoology,10-HDA (worker control),11,10,1766,1779,13,
Zoology,10-HDA (worker control),11,10,1781,1781,0,
Zoology,10-HDA (worker control),11,10,1781,1781,0,
Zoology,10-HDA (worker control),14,6,5,7,2,
Zoology,10-HDA (worker control),14,6,28,30,2,
Zoology,10-HDA (worker control),14,6,32,32,0,"not touching but it seems interrested, lunges towards paper"
Zoology,10-HDA (worker control),14,6,195,196,1,
Zoology,10-HDA (worker control),14,6,207,207,0,bee bumps in to paper
Zoology,10-HDA (worker control),14,6,228,230,2,
Zoology,10-HDA (worker control),14,6,263,265,2,
Zoology,10-HDA (worker control),14,6,286,287,1,
Zoology,10-HDA (worker control),14,6,302,304,2,
Zoology,10-HDA (worker control),14,6,331,331,0,
Zoology,10-HDA (worker control),14,6,494,498,4,
Zoology,10-HDA (worker control),14,6,559,559,0,maybe not - seems interrested
Zoology,10-HDA (worker control),14,6,622,622,0,
Zoology,10-HDA (worker control),14,6,627,627,0,
Zoology,10-HDA (worker control),14,6,669,669,0,maybe not - seems interrested
Zoology,10-HDA (worker control),14,6,723,723,0,
Zoology,10-HDA (worker control),14,6,728,729,1,
Zoology,10-HDA (worker control),14,6,769,769,0,
Zoology,10-HDA (worker control),14,6,815,817,2,
Zoology,10-HDA (worker control),14,6,859,860,1,
Zoology,10-HDA (worker control),14,6,929,929,0,
Zoology,10-HDA (worker control),14,6,975,976,1,
Zoology,10-HDA (worker control),14,6,1043,1047,4,
Zoology,10-HDA (worker control),14,6,1067,1068,1,
Zoology,10-HDA (worker control),14,6,1074,1076,2,
Zoology,10-HDA (worker control),14,6,1077,1079,2,
Zoology,10-HDA (worker control),14,6,1090,1091,1,
Zoology,10-HDA (worker control),14,6,1340,1340,0,bump as it walks past
Zoology,10-HDA (worker control),14,6,1398,1401,3,
Zoology,10-HDA (worker control),14,6,1484,1485,1,
Zoology,10-HDA (worker control),14,6,1541,1541,0,
Zoology,10-HDA (worker control),14,6,1651,1651,0,maybe -sideways sniff
Zoology,10-HDA (worker control),14,6,1703,1704,1,
Zoology,10-HDA (worker control),14,6,1775,1778,3,
Zoology,10-HDA (worker control),18,6,1,4,3,
Zoology,10-HDA (worker control),18,6,59,59,0,
Zoology,10-HDA (worker control),18,6,63,64,1,
Zoology,10-HDA (worker control),18,6,62,64,2,
Zoology,10-HDA (worker control),18,6,77,83,6,
Zoology,10-HDA (worker control),18,6,89,89,0,bee walks on paper
Zoology,10-HDA (worker control),18,6,92,95,3,bee walks on paper
Zoology,10-HDA (worker control),18,6,178,180,2,
Zoology,10-HDA (worker control),18,6,217,226,9,
Zoology,10-HDA (worker control),18,6,318,321,3,
Zoology,10-HDA (worker control),18,6,326,326,0,
Zoology,10-HDA (worker control),18,6,413,425,12,bee sniffs from afar
Zoology,10-HDA (worker control),18,6,426,426,0,
Zoology,10-HDA (worker control),18,6,448,450,2,
Zoology,10-HDA (worker control),18,6,485,487,2,
Zoology,10-HDA (worker control),18,6,528,528,0,
Zoology,10-HDA (worker control),18,6,772,775,3,
Zoology,10-HDA (worker control),18,6,783,786,3,
Zoology,10-HDA (worker control),18,6,976,978,2,
Zoology,10-HDA (worker control),18,6,980,980,0,
Zoology,10-HDA (worker control),18,6,988,989,1,
Zoology,10-HDA (worker control),18,6,1009,1010,1,
Zoology,10-HDA (worker control),18,6,1257,1258,1,
Zoology,10-HDA (worker control),18,6,1279,1281,2,
Zoology,10-HDA (worker control),18,6,1308,1309,1,
Zoology,10-HDA (worker control),18,6,1326,1327,1,
Zoology,10-HDA (worker control),18,6,1363,1366,3,bee walks over paper
Zoology,10-HDA (worker control),18,6,1495,1496,1,
Zoology,10-HDA (worker control),18,6,1525,1526,1,
Zoology,10-HDA (worker control),18,6,1572,1572,0,
Zoology,10-HDA (worker control),18,6,1629,1632,3,
Zoology,10-HDA (worker control),18,6,1653,1655,2,bee sniffs whilst walking along
Zoology,10-HDA (worker control),18,6,1648,1667,19,bee sits still facing the paper a little way off - still pretty close
Zoology,10-HDA (worker control),18,6,1709,1709,0,
Zoology,10-HDA (worker control),18,6,1719,1719,0,not super sure
Zoology,10-HDA (worker control),18,6,1780,1780,0,
Zoology,10-HDA (worker control),18,6,1786,1786,0,
Zoology,10-HDA (worker control),19,6,24,24,0,
Zoology,10-HDA (worker control),19,6,47,49,2,
Zoology,10-HDA (worker control),19,6,63,64,1,
Zoology,10-HDA (worker control),19,6,64,64,0,
Zoology,10-HDA (worker control),19,6,105,105,0,
Zoology,10-HDA (worker control),19,6,109,113,4,
Zoology,10-HDA (worker control),19,6,121,124,3,
Zoology,10-HDA (worker control),19,6,121,128,7,
Zoology,10-HDA (worker control),19,6,125,125,0,
Zoology,10-HDA (worker control),19,6,128,129,1,
Zoology,10-HDA (worker control),19,6,142,144,2,
Zoology,10-HDA (worker control),19,6,148,151,3,
Zoology,10-HDA (worker control),19,6,152,153,1,
Zoology,10-HDA (worker control),19,6,174,182,8,
Zoology,10-HDA (worker control),19,6,184,190,6,
Zoology,10-HDA (worker control),19,6,202,202,0,
Zoology,10-HDA (worker control),19,6,202,205,3,
Zoology,10-HDA (worker control),19,6,227,231,4,
Zoology,10-HDA (worker control),19,6,268,271,3,
Zoology,10-HDA (worker control),19,6,278,278,0,
Zoology,10-HDA (worker control),19,6,316,317,1,
Zoology,10-HDA (worker control),19,6,316,316,0,
Zoology,10-HDA (worker control),19,6,346,352,6,
Zoology,10-HDA (worker control),19,6,352,354,2,
Zoology,10-HDA (worker control),19,6,372,373,1,
Zoology,10-HDA (worker control),19,6,396,401,5,
Zoology,10-HDA (worker control),19,6,413,413,0,
Zoology,10-HDA (worker control),19,6,461,461,0,
Zoology,10-HDA (worker control),19,6,509,509,0,
Zoology,10-HDA (worker control),19,6,523,525,2,
Zoology,10-HDA (worker control),19,6,543,544,1,
Zoology,10-HDA (worker control),19,6,582,585,3,bee walks over paper
Zoology,10-HDA (worker control),19,6,606,606,0,
Zoology,10-HDA (worker control),19,6,617,618,1,
Zoology,10-HDA (worker control),19,6,620,621,1,
Zoology,10-HDA (worker control),19,6,625,625,0,
Zoology,10-HDA (worker control),19,6,636,638,2,
Zoology,10-HDA (worker control),19,6,651,651,0,
Zoology,10-HDA (worker control),19,6,661,664,3,
Zoology,10-HDA (worker control),19,6,681,684,3,
Zoology,10-HDA (worker control),19,6,690,691,1,
Zoology,10-HDA (worker control),19,6,706,710,4,
Zoology,10-HDA (worker control),19,6,717,718,1,
Zoology,10-HDA (worker control),19,6,737,738,1,
Zoology,10-HDA (worker control),19,6,756,756,0,
Zoology,10-HDA (worker control),19,6,799,800,1,
Zoology,10-HDA (worker control),19,6,806,806,0,
Zoology,10-HDA (worker control),19,6,818,820,2,
Zoology,10-HDA (worker control),19,6,837,837,0,
Zoology,10-HDA (worker control),19,6,838,839,1,
Zoology,10-HDA (worker control),19,6,863,864,1,
Zoology,10-HDA (worker control),19,6,922,923,1,
Zoology,10-HDA (worker control),19,6,927,929,2,
Zoology,10-HDA (worker control),19,6,962,965,3,
Zoology,10-HDA (worker control),19,6,979,980,1,
Zoology,10-HDA (worker control),19,6,1025,1028,3,
Zoology,10-HDA (worker control),19,6,1026,1027,1,
Zoology,10-HDA (worker control),19,6,1035,1038,3,
Zoology,10-HDA (worker control),19,6,1045,1048,3,
Zoology,10-HDA (worker control),19,6,1050,1052,2,
Zoology,10-HDA (worker control),19,6,1076,1078,2,
Zoology,10-HDA (worker control),19,6,1099,1099,0,
Zoology,10-HDA (worker control),19,6,1113,1114,1,
Zoology,10-HDA (worker control),19,6,1136,1143,7,
Zoology,10-HDA (worker control),19,6,1145,1146,1,
Zoology,10-HDA (worker control),19,6,1147,1150,3,
Zoology,10-HDA (worker control),19,6,1154,1158,4,
Zoology,10-HDA (worker control),19,6,1158,1159,1,
Zoology,10-HDA (worker control),19,6,1174,1175,1,
Zoology,10-HDA (worker control),19,6,1188,1195,7,
Zoology,10-HDA (worker control),19,6,1197,1197,0,
Zoology,10-HDA (worker control),19,6,1222,1224,2,
Zoology,10-HDA (worker control),19,6,1235,1236,1,
Zoology,10-HDA (worker control),19,6,1239,1241,2,
Zoology,10-HDA (worker control),19,6,1245,1247,2,
Zoology,10-HDA (worker control),19,6,1251,1252,1,
Zoology,10-HDA (worker control),19,6,1266,1266,0,
Zoology,10-HDA (worker control),19,6,1272,1276,4,
Zoology,10-HDA (worker control),19,6,1279,1279,0,
Zoology,10-HDA (worker control),19,6,1285,1297,12,21:58 bee sits on aper until this time
Zoology,10-HDA (worker control),19,6,1359,1363,4,
Zoology,10-HDA (worker control),19,6,1364,1369,5,22:52
Zoology,10-HDA (worker control),19,6,1377,1377,0,
Zoology,10-HDA (worker control),19,6,1390,1390,0,
Zoology,10-HDA (worker control),19,6,1404,1404,0,
Zoology,10-HDA (worker control),19,6,1406,1410,4,
Zoology,10-HDA (worker control),19,6,1410,1416,6,
Zoology,10-HDA (worker control),19,6,1413,1413,0,
Zoology,10-HDA (worker control),19,6,1425,1425,0,
Zoology,10-HDA (worker control),19,6,1440,1440,0,
Zoology,10-HDA (worker control),19,6,1445,1446,1,
Zoology,10-HDA (worker control),19,6,1450,1454,4,
Zoology,10-HDA (worker control),19,6,1461,1463,2,
Zoology,10-HDA (worker control),19,6,1483,1483,0,
Zoology,10-HDA (worker control),19,6,1492,1492,0,
Zoology,10-HDA (worker control),19,6,1560,1560,0,
Zoology,10-HDA (worker control),19,6,1574,1574,0,
Zoology,10-HDA (worker control),19,6,1580,1581,1,
Zoology,10-HDA (worker control),19,6,1587,1593,6,
Zoology,10-HDA (worker control),19,6,1599,1602,3,
Zoology,10-HDA (worker control),19,6,1599,1601,2,
Zoology,10-HDA (worker control),19,6,1635,1642,7,
Zoology,10-HDA (worker control),19,6,1683,1693,10,
Zoology,10-HDA (worker control),19,6,1696,1697,1,
Zoology,10-HDA (worker control),19,6,1706,1707,1,
Zoology,10-HDA (worker control),19,6,1707,1707,0,
Zoology,10-HDA (worker control),19,6,1781,1785,4,
Zoology,10-HDA (worker control),23,9,1627,1629,2,
Zoology,10-HDA (worker control),23,9,1644,1645,1,
Zoology,10-HDA (worker control),23,9,1653,1655,2,
Zoology,10-HDA (worker control),23,9,1660,1663,3,
Zoology,10-HDA (worker control),23,9,1675,1676,1,
Zoology,HOB,4,11,24,31,7,
Zoology,HOB,4,11,59,59,0,
Zoology,HOB,4,11,89,90,1,
Zoology,HOB,4,11,191,191,0,
Zoology,HOB,4,11,192,192,0,
Zoology,HOB,4,11,200,202,2,
Zoology,HOB,4,11,274,276,2,
Zoology,HOB,4,11,304,304,0,
Zoology,HOB,4,11,353,353,0,
Zoology,HOB,4,11,478,478,0,
Zoology,HOB,4,11,479,483,4,
Zoology,HOB,4,11,512,512,0,
Zoology,HOB,4,11,537,537,0,
Zoology,HOB,4,11,877,899,22,
Zoology,HOB,4,11,910,912,2,
Zoology,HOB,4,11,1012,1012,0,
Zoology,HOB,4,11,1014,1015,1,
Zoology,HOB,4,11,1021,1029,8,
Zoology,HOB,4,11,1027,1035,8,bee sort of sniffs from afar
Zoology,HOB,4,11,1055,1055,0,
Zoology,HOB,4,11,1069,1076,7,
Zoology,HOB,4,11,1080,1122,42,
Zoology,HOB,4,11,1081,1083,2,
Zoology,HOB,4,11,1141,1143,2,
Zoology,HOB,4,11,1144,1146,2,
Zoology,HOB,4,11,1146,1222,76,
Zoology,HOB,4,11,1151,1151,0,
Zoology,HOB,4,11,1219,1222,3,
Zoology,HOB,4,11,1328,1329,1,bee sort of sniffs from afar
Zoology,HOB,4,11,1352,1354,2,
Zoology,HOB,4,11,1373,1374,1,
Zoology,HOB,4,11,1468,1468,0,
Zoology,HOB,4,11,1502,1522,20,
Zoology,HOB,4,11,1519,1522,3,
Zoology,HOB,4,11,1524,1591,67,bee sort of sits next to paper - really think it porobably shouldnt count
Zoology,HOB,4,11,1544,1546,2,
Zoology,HOB,4,11,1587,1590,3,
Zoology,HOB,4,11,1604,1610,6,
Zoology,HOB,4,11,1611,1629,18,
Zoology,HOB,4,11,1627,1629,2,
Zoology,HOB,4,11,1647,1647,0,
Zoology,HOB,4,11,1655,1656,1,
Zoology,HOB,4,11,1696,1699,3,
Zoology,HOB,4,11,1699,1700,1,
Zoology,HOB,4,11,1706,1800,94,bee sort of sits next to paper
Zoology,HOB,4,11,1758,1759,1,
Zoology,HOB,5,5,9,12,3,
Zoology,HOB,5,5,15,17,2,
Zoology,HOB,5,5,20,31,11,
Zoology,HOB,5,5,58,61,3,
Zoology,HOB,5,5,60,61,1,
Zoology,HOB,5,5,0,44,44,
Zoology,HOB,5,5,87,91,4,
Zoology,HOB,5,5,265,274,9,
Zoology,HOB,5,5,276,279,3,
Zoology,HOB,5,5,305,309,4,
Zoology,HOB,5,5,318,318,0,
Zoology,HOB,5,5,918,918,0,
Zoology,HOB,5,5,340,349,9,
Zoology,HOB,5,5,374,376,2,
Zoology,HOB,5,5,446,450,4,
Zoology,HOB,5,5,531,535,4,
Zoology,HOB,5,5,537,537,0,
Zoology,HOB,5,5,557,596,39,
Zoology,HOB,5,5,573,583,10,
Zoology,HOB,5,5,238,911,673,bee sits still short distance form paper facing it
Zoology,HOB,5,5,628,631,3,
Zoology,HOB,5,5,644,645,1,
Zoology,HOB,5,5,748,755,7,
Zoology,HOB,5,5,758,758,0,
Zoology,HOB,5,5,797,799,2,
Zoology,HOB,5,5,826,833,7,maybw sniffing from a distance
Zoology,HOB,5,5,872,873,1,
Zoology,HOB,5,5,958,965,7,
Zoology,HOB,5,5,960,974,14,maybe? ssort od interrested in annother bee too
Zoology,HOB,5,5,979,1008,29,
Zoology,HOB,5,5,1029,1030,1,
Zoology,HOB,5,5,1145,1152,7,
Zoology,HOB,5,5,1167,1167,0,
Zoology,HOB,5,5,1169,1169,0,
Zoology,HOB,5,5,1190,1190,0,
Zoology,HOB,5,5,1193,1194,1,
Zoology,HOB,5,5,1201,1202,1,
Zoology,HOB,5,5,1211,1213,2,
Zoology,HOB,5,5,1215,1217,2,
Zoology,HOB,5,5,1224,1233,9,
Zoology,HOB,5,5,1246,1259,13,
Zoology,HOB,5,5,1251,1252,1,
Zoology,HOB,5,5,1262,1264,2,
Zoology,HOB,5,5,1265,1265,0,
Zoology,HOB,5,5,1273,1274,1,
Zoology,HOB,5,5,1277,1277,0,
Zoology,HOB,5,5,1283,1286,3,
Zoology,HOB,5,5,1303,1303,0,
Zoology,HOB,5,5,1307,1308,1,
Zoology,HOB,5,5,1318,1318,0,
Zoology,HOB,5,5,1343,1345,2,
Zoology,HOB,5,5,1358,1358,0,
Zoology,HOB,5,5,1373,1373,0,
Zoology,HOB,5,5,1379,1379,0,
Zoology,HOB,5,5,1380,1380,0,
Zoology,HOB,5,5,1439,1440,1,
Zoology,HOB,5,5,1460,1460,0,
Zoology,HOB,5,5,1478,1478,0,
Zoology,HOB,5,5,1481,1481,0,
Zoology,HOB,5,5,1485,1487,2,
Zoology,HOB,5,5,1501,1501,0,
Zoology,HOB,5,5,1547,1547,0,
Zoology,HOB,5,5,1554,1554,0,
Zoology,HOB,5,5,1595,1596,1,
Zoology,HOB,5,5,1598,1598,0,
Zoology,HOB,5,5,1604,1604,0,
Zoology,HOB,5,5,1606,1606,0,
Zoology,HOB,5,5,1650,1651,1,
Zoology,HOB,5,5,1676,1676,0,
Zoology,HOB,5,5,1685,1685,0,
Zoology,HOB,5,5,1782,1783,1,
Zoology,HOB,6,3,18,20,2,
Zoology,HOB,6,3,49,50,1,
Zoology,HOB,6,3,63,67,4,
Zoology,HOB,6,3,72,72,0,
Zoology,HOB,6,3,114,115,1,
Zoology,HOB,6,3,146,146,0,maybe
Zoology,HOB,6,3,158,159,1,
Zoology,HOB,6,3,219,219,0,
Zoology,HOB,6,3,175,176,1,
Zoology,HOB,6,3,204,214,10,
Zoology,HOB,6,3,216,220,4,
Zoology,HOB,6,3,222,222,0,
Zoology,HOB,6,3,245,246,1,
Zoology,HOB,6,3,247,248,1,
Zoology,HOB,6,3,274,274,0,
Zoology,HOB,6,3,1503,1505,2,
Zoology,HOB,6,3,1503,1519,16,bee being strange next to the paper
Zoology,HOB,6,3,329,329,0,
Zoology,HOB,6,3,337,338,1,
Zoology,HOB,6,3,362,363,1,
Zoology,HOB,6,3,363,364,1,
Zoology,HOB,6,3,370,370,0,
Zoology,HOB,6,3,382,383,1,
Zoology,HOB,6,3,394,395,1,
Zoology,HOB,6,3,402,405,3,
Zoology,HOB,6,3,459,459,0,bee bumps in to paper
Zoology,HOB,6,3,465,469,4,
Zoology,HOB,6,3,485,485,0,
Zoology,HOB,6,3,526,533,7,
Zoology,HOB,6,3,540,540,0,
Zoology,HOB,6,3,541,541,0,
Zoology,HOB,6,3,547,548,1,
Zoology,HOB,6,3,570,570,0,
Zoology,HOB,6,3,583,584,1,
Zoology,HOB,6,3,598,598,0,
Zoology,HOB,6,3,608,610,2,be being strange near paper
Zoology,HOB,6,3,658,658,0,
Zoology,HOB,6,3,679,679,0,
Zoology,HOB,6,3,685,685,0,
Zoology,HOB,6,3,693,693,0,
Zoology,HOB,6,3,783,784,1,
Zoology,HOB,6,3,790,793,3,
Zoology,HOB,6,3,817,819,2,
Zoology,HOB,6,3,820,822,2,
Zoology,HOB,6,3,823,839,16,
Zoology,HOB,6,3,859,859,0,
Zoology,HOB,6,3,897,897,0,
Zoology,HOB,6,3,902,907,5,
Zoology,HOB,6,3,908,913,5,
Zoology,HOB,6,3,936,936,0,
Zoology,HOB,6,3,941,941,0,
Zoology,HOB,6,3,947,948,1,
Zoology,HOB,6,3,948,948,0,
Zoology,HOB,6,3,957,958,1,
Zoology,HOB,6,3,969,969,0,
Zoology,HOB,6,3,992,994,2,
Zoology,HOB,6,3,999,1001,2,
Zoology,HOB,6,3,1002,1006,4,
Zoology,HOB,6,3,969,970,1,
Zoology,HOB,6,3,970,971,1,
Zoology,HOB,6,3,1036,1037,1,
Zoology,HOB,6,3,1078,1080,2,
Zoology,HOB,6,3,1109,1111,2,
Zoology,HOB,6,3,1109,1109,0,
Zoology,HOB,6,3,1130,1134,4,
Zoology,HOB,6,3,1139,1148,9,
Zoology,HOB,6,3,1156,1158,2,
Zoology,HOB,6,3,1160,1164,4,maybe - bee sits still near paper facing it
Zoology,HOB,6,3,1166,1170,4,
Zoology,HOB,6,3,1182,1182,0,
Zoology,HOB,6,3,1202,1207,5,
Zoology,HOB,6,3,1218,1218,0,
Zoology,HOB,6,3,1276,1278,2,
Zoology,HOB,6,3,1285,1286,1,
Zoology,HOB,6,3,1302,1303,1,
Zoology,HOB,6,3,1333,1333,0,
Zoology,HOB,6,3,1371,1371,0,
Zoology,HOB,6,3,1373,1373,0,
Zoology,HOB,6,3,1382,1385,3,
Zoology,HOB,6,3,1467,1470,3,
Zoology,HOB,6,3,1471,1479,8,
Zoology,HOB,6,3,1522,1522,0,
Zoology,HOB,6,3,1533,1534,1,
Zoology,HOB,6,3,1543,1544,1,
Zoology,HOB,6,3,1543,1544,1,
Zoology,HOB,6,3,1552,1552,0,
Zoology,HOB,6,3,1561,1563,2,bee sort of walsk past paper very slowly and seems interrested
Zoology,HOB,6,3,1599,1599,0,
Zoology,HOB,6,3,1642,1645,3,bee not touching but seems interrested
Zoology,HOB,6,3,1645,1645,0,
Zoology,HOB,6,3,1647,1648,1,
Zoology,HOB,6,3,1664,1664,0,
Zoology,HOB,6,3,1744,1746,2,
Zoology,HOB,6,3,1759,1760,1,
Zoology,HOB,6,3,1768,1768,0,
Zoology,HOB,6,3,1780,1782,2,
Zoology,HOB,7,6,24,25,1,bee sniffs from afar
Zoology,HOB,7,6,47,51,4,
Zoology,HOB,7,6,208,208,0,
Zoology,HOB,7,6,262,263,1,
Zoology,HOB,7,6,286,286,0,
Zoology,HOB,7,6,318,318,0,
Zoology,HOB,7,6,338,342,4,
Zoology,HOB,7,6,354,355,1,
Zoology,HOB,7,6,368,369,1,
Zoology,HOB,7,6,414,415,1,
Zoology,HOB,7,6,425,426,1,
Zoology,HOB,7,6,454,454,0,
Zoology,HOB,7,6,501,501,0,
Zoology,HOB,7,6,527,527,0,
Zoology,HOB,7,6,547,548,1,bee sort of touches paper with its legs as it walks past
Zoology,HOB,7,6,577,577,0,
Zoology,HOB,7,6,786,786,0,
Zoology,HOB,7,6,827,828,1,
Zoology,HOB,7,6,960,960,0,
Zoology,HOB,7,6,1032,1033,1,
Zoology,HOB,7,6,1058,1059,1,
Zoology,HOB,7,6,1153,1156,3,
Zoology,HOB,7,6,1195,1196,1,
Zoology,HOB,7,6,1232,1232,0,
Zoology,HOB,7,6,1239,1240,1,
Zoology,HOB,7,6,1343,1344,1,
Zoology,HOB,7,6,1415,1416,1,
Zoology,HOB,7,6,1418,1421,3,
Zoology,HOB,7,6,1361,1361,0,
Zoology,HOB,7,6,1404,1405,1,
Zoology,HOB,7,6,1410,1410,0,
Zoology,HOB,7,6,1444,1444,0,
Zoology,HOB,7,6,1507,1507,0,
Zoology,HOB,7,6,1515,1516,1,
Zoology,HOB,7,6,1524,1524,0,
Zoology,HOB,7,6,1525,1525,0,
Zoology,HOB,7,6,1559,1562,3,
Zoology,HOB,7,6,1563,1564,1,
Zoology,HOB,7,6,1565,1566,1,
Zoology,HOB,7,6,1601,1601,0,
Zoology,HOB,7,6,1668,1668,0,
Zoology,HOB,7,6,1752,1752,0,
Zoology,HOB,7,6,1766,1776,10,
Zoology,HOB,7,6,1797,1798,1,
Zoology,HOB,8,4,32,32,0,
Zoology,HOB,8,4,45,45,0,
Zoology,HOB,8,4,73,76,3,
Zoology,HOB,8,4,116,118,2,
Zoology,HOB,8,4,168,171,3,
Zoology,HOB,8,4,318,318,0,
Zoology,HOB,8,4,326,328,2,
Zoology,HOB,8,4,328,328,0,
Zoology,HOB,8,4,339,341,2,
Zoology,HOB,8,4,350,350,0,
Zoology,HOB,8,4,356,357,1,
Zoology,HOB,8,4,430,430,0,
Zoology,HOB,8,4,443,445,2,
Zoology,HOB,8,4,459,459,0,
Zoology,HOB,8,4,476,476,0,
Zoology,HOB,8,4,490,491,1,
Zoology,HOB,8,4,555,557,2,
Zoology,HOB,8,4,586,588,2,
Zoology,HOB,8,4,597,602,5,
Zoology,HOB,8,4,603,607,4,
Zoology,HOB,8,4,645,645,0,sort of bumps in to the paper
Zoology,HOB,8,4,669,671,2,
Zoology,HOB,8,4,703,703,0,
Zoology,HOB,8,4,746,747,1,
Zoology,HOB,8,4,786,788,2,
Zoology,HOB,8,4,815,816,1,
Zoology,HOB,8,4,862,876,14,
Zoology,HOB,8,4,862,862,0,
Zoology,HOB,8,4,888,888,0,
Zoology,HOB,8,4,935,936,1,
Zoology,HOB,8,4,940,941,1,
Zoology,HOB,8,4,992,993,1,
Zoology,HOB,8,4,1012,1014,2,
Zoology,HOB,8,4,1014,1017,3,
Zoology,HOB,8,4,1147,1158,11,
Zoology,HOB,8,4,1158,1158,0,
Zoology,HOB,8,4,1204,1207,3,
Zoology,HOB,8,4,1227,1227,0,
Zoology,HOB,8,4,1317,1317,0,
Zoology,HOB,8,4,1325,1325,0,maybe touch very fast
Zoology,HOB,8,4,1338,1338,0,
Zoology,HOB,8,4,1359,1360,1,
Zoology,HOB,8,4,1365,1374,9,
Zoology,HOB,8,4,1432,1450,18,
Zoology,HOB,8,4,1474,1475,1,
Zoology,HOB,8,4,1494,1495,1,
Zoology,HOB,8,4,1496,1499,3,
Zoology,HOB,8,4,1515,1516,1,
Zoology,HOB,8,4,1549,1549,0,
Zoology,HOB,8,4,1552,1553,1,bee sort of sniffs from a distance
Zoology,HOB,8,4,1571,1579,8,
Zoology,HOB,8,4,1603,1606,3,
Zoology,HOB,8,4,1619,1619,0,
Zoology,HOB,8,4,1623,1625,2,
Zoology,HOB,8,4,1631,1634,3,
Zoology,HOB,8,4,1635,1663,28,
Zoology,HOB,8,4,1710,1711,1,
Zoology,HOB,8,4,1731,1731,0,
Zoology,HOB,8,4,1792,1796,4,sort of sniffing from afar - not sure
Zoology,HOB,9,1,16,18,2,
Zoology,HOB,9,1,89,90,1,
Zoology,HOB,9,1,143,147,4,
Zoology,HOB,9,1,172,172,0,
Zoology,HOB,9,1,175,175,0,
Zoology,HOB,9,1,267,267,0,
Zoology,HOB,9,1,282,282,0,
Zoology,HOB,9,1,300,300,0,
Zoology,HOB,9,1,321,322,1,
Zoology,HOB,9,1,353,353,0,
Zoology,HOB,9,1,359,359,0,
Zoology,HOB,9,1,367,367,0,maybe fast touch as it walks past
Zoology,HOB,9,1,421,422,1,
Zoology,HOB,9,1,440,440,0,maybe fast touch as it walks past
Zoology,HOB,9,1,491,491,0,
Zoology,HOB,9,1,521,521,0,
Zoology,HOB,9,1,573,573,0,maybe fast touch as it walks past
Zoology,HOB,9,1,621,621,0,maybe fast touch as it walks past
Zoology,HOB,9,1,647,647,0,
Zoology,HOB,9,1,662,663,1,
Zoology,HOB,9,1,677,677,0,
Zoology,HOB,9,1,758,759,1,
Zoology,HOB,9,1,775,775,0,
Zoology,HOB,9,1,748,811,63,
Zoology,HOB,9,1,836,836,0,
Zoology,HOB,9,1,945,945,0,maybe fast touch as it walks past
Zoology,HOB,9,1,1031,1031,0,very fast touch - maybe doesn't count
Zoology,HOB,9,1,1169,1169,0,
Zoology,HOB,9,1,1198,1198,0,maybe - bee sort of stumbles in to paper
Zoology,HOB,9,1,1287,1287,0,very fast touch - maybe doesn't count
Zoology,HOB,9,1,1332,1333,1,
Zoology,HOB,9,1,1336,1341,5,
Zoology,HOB,9,1,1361,1361,0,
Zoology,HOB,9,1,1374,1374,0,
Zoology,HOB,9,1,1397,1397,0,
Zoology,HOB,9,1,1425,1428,3,23:55 bee stays on paper until 23:555
Zoology,HOB,9,1,1437,1446,9,
Zoology,HOB,9,1,1453,1458,5,bee walks over paper
Zoology,HOB,9,1,1473,1473,0,
Zoology,HOB,9,1,1583,1591,8,
Zoology,HOB,9,1,1650,1657,7,
Zoology,HOB,9,1,1709,1709,0,
Zoology,HOB,9,1,1731,1731,0,
Zoology,HOB,9,1,1731,1734,3,
Zoology,HOB,9,1,1763,1764,1,
Zoology,HOB,9,1,1797,1798,1,
Zoology,HOB,11,11,11,13,2,
Zoology,HOB,11,11,14,15,1,
Zoology,HOB,11,11,32,35,3,be sniffing from afar
Zoology,HOB,11,11,41,43,2,
Zoology,HOB,11,11,54,54,0,
Zoology,HOB,11,11,27,28,1,
Zoology,HOB,11,11,168,169,1,
Zoology,HOB,11,11,176,176,0,
Zoology,HOB,11,11,252,252,0,
Zoology,HOB,11,11,264,264,0,
Zoology,HOB,11,11,280,280,0,
Zoology,HOB,11,11,307,308,1,
Zoology,HOB,11,11,319,328,9,
Zoology,HOB,11,11,361,361,0,
Zoology,HOB,11,11,362,362,0,
Zoology,HOB,11,11,373,373,0,
Zoology,HOB,11,11,384,384,0,
Zoology,HOB,11,11,396,396,0,
Zoology,HOB,11,11,429,429,0,
Zoology,HOB,11,11,494,496,2,
Zoology,HOB,11,11,496,496,0,
Zoology,HOB,11,11,498,499,1,
Zoology,HOB,11,11,503,504,1,
Zoology,HOB,11,11,510,510,0,
Zoology,HOB,11,11,526,526,0,
Zoology,HOB,11,11,576,576,0,
Zoology,HOB,11,11,607,607,0,
Zoology,HOB,11,11,686,686,0,
Zoology,HOB,11,11,707,707,0,
Zoology,HOB,11,11,712,712,0,
Zoology,HOB,11,11,725,725,0,
Zoology,HOB,11,11,735,735,0,
Zoology,HOB,11,11,766,767,1,
Zoology,HOB,11,11,777,777,0,
Zoology,HOB,11,11,850,850,0,
Zoology,HOB,11,11,979,979,0,
Zoology,HOB,11,11,984,984,0,
Zoology,HOB,11,11,1098,1098,0,
Zoology,HOB,11,11,1100,1101,1,
Zoology,HOB,11,11,1116,1116,0,
Zoology,HOB,11,11,1152,1153,1,
Zoology,HOB,11,11,1249,1250,1,
Zoology,HOB,11,11,1265,1265,0,
Zoology,HOB,11,11,1282,1282,0,
Zoology,HOB,11,11,1356,1356,0,
Zoology,HOB,11,11,1419,1420,1,
Zoology,HOB,11,11,1444,1454,10,
Zoology,HOB,11,11,1456,1458,2,
Zoology,HOB,11,11,1458,1458,0,
Zoology,HOB,11,11,1522,1526,4,
Zoology,HOB,11,11,1591,1591,0,
Zoology,HOB,11,11,1621,1621,0,
Zoology,HOB,11,11,1631,1631,0,
Zoology,HOB,11,11,1647,1647,0,
Zoology,HOB,11,11,1687,1687,0,
Zoology,HOB,11,11,1799,1799,0,
Zoology,HOB,14,4,47,47,0,bee turns around near paper and bumps it a little bit
Zoology,HOB,14,4,107,108,1,
Zoology,HOB,14,4,210,211,1,
Zoology,HOB,14,4,277,277,0,
Zoology,HOB,14,4,332,333,1,
Zoology,HOB,14,4,417,417,0,
Zoology,HOB,14,4,477,478,1,
Zoology,HOB,14,4,541,543,2,
Zoology,HOB,14,4,551,553,2,
Zoology,HOB,14,4,604,604,0,
Zoology,HOB,14,4,621,623,2,
Zoology,HOB,14,4,741,743,2,
Zoology,HOB,14,4,804,806,2,
Zoology,HOB,14,4,806,806,0,
Zoology,HOB,14,4,980,984,4,
Zoology,HOB,14,4,1038,1042,4,
Zoology,HOB,14,4,1041,1043,2,
Zoology,HOB,14,4,1089,1096,7,bee sniffs from afar - not actually touching
Zoology,HOB,14,4,1098,1098,0,
Zoology,HOB,14,4,1145,1146,1,
Zoology,HOB,14,4,1181,1181,0,
Zoology,HOB,14,4,1183,1188,5,
Zoology,HOB,14,4,1184,1198,14,
Zoology,HOB,14,4,1200,1203,3,
Zoology,HOB,14,4,1234,1237,3,
Zoology,HOB,14,4,1308,1310,2,
Zoology,HOB,14,4,1319,1326,7,a little far from paper but seems interrested
Zoology,HOB,14,4,1361,1364,3,
Zoology,HOB,14,4,1416,1425,9,
Zoology,HOB,14,4,1430,1432,2,
Zoology,HOB,14,4,1435,1437,2,
Zoology,HOB,14,4,1437,1438,1,
Zoology,HOB,14,4,1446,1450,4,
Zoology,HOB,14,4,1451,1452,1,
Zoology,HOB,14,4,1509,1519,10,
Zoology,HOB,14,4,1518,1519,1,
Zoology,HOB,14,4,1530,1530,0,
Zoology,HOB,14,4,1643,1643,0,maybe accidental bump
Zoology,HOB,14,4,1680,1687,7,
Zoology,HOB,14,4,1707,1708,1,
Zoology,HOB,14,4,1711,1713,2,
Zoology,HOB,14,4,1766,1766,0,
Zoology,HOB,14,4,1782,1783,1,
Zoology,HOB,14,4,1790,1790,0,
Zoology,HOB,19,9,25,25,0,
Zoology,HOB,19,9,59,59,0,
Zoology,HOB,19,9,143,144,1,
Zoology,HOB,19,9,146,158,12,
Zoology,HOB,19,9,183,191,8,
Zoology,HOB,19,9,216,217,1,
Zoology,HOB,19,9,243,243,0,
Zoology,HOB,19,9,250,250,0,
Zoology,HOB,19,9,274,275,1,
Zoology,HOB,19,9,307,312,5,
Zoology,HOB,19,9,432,432,0,
Zoology,HOB,19,9,452,453,1,
Zoology,HOB,19,9,465,466,1,
Zoology,HOB,19,9,527,527,0,
Zoology,HOB,19,9,539,539,0,
Zoology,HOB,19,9,590,592,2,
Zoology,HOB,19,9,627,628,1,
Zoology,HOB,19,9,701,702,1,
Zoology,HOB,19,9,734,735,1,
Zoology,HOB,19,9,743,748,5,
Zoology,HOB,19,9,768,770,2,
Zoology,HOB,19,9,954,954,0,
Zoology,HOB,19,9,970,975,5,
Zoology,HOB,19,9,1040,1048,8,
Zoology,HOB,19,9,1058,1058,0,
Zoology,HOB,19,9,1086,1087,1,
Zoology,HOB,19,9,1153,1153,0,
Zoology,HOB,19,9,1183,1185,2,
Zoology,HOB,19,9,1254,1256,2,
Zoology,HOB,19,9,1267,1269,2,
Zoology,HOB,19,9,1313,1319,6,
Zoology,HOB,19,9,1338,1339,1,
Zoology,HOB,19,9,1376,1377,1,
Zoology,HOB,19,9,1382,1382,0,
Zoology,HOB,19,9,1384,1384,0,
Zoology,HOB,19,9,1393,1393,0,
Zoology,HOB,19,9,1422,1423,1,
Zoology,HOB,19,9,1494,1495,1,
Zoology,HOB,19,9,1512,1512,0,
Zoology,HOB,19,9,1568,1570,2,
Zoology,HOB,19,9,1609,1628,19,
Zoology,HOB,19,9,1629,1629,0,
Zoology,HOB,19,9,1667,1669,2,
Zoology,HOB,19,9,1708,1708,0,
Zoology,HOB,19,9,1713,1714,1,
Zoology,HOB,19,9,1719,1721,2,
Zoology,HOB,19,9,1748,1749,1,
Zoology,HOB,19,9,1782,1792,10,
Zoology,HOB,23,1,3,3,0,
Zoology,HOB,23,1,12,12,0,
Zoology,HOB,23,1,23,23,0,
Zoology,HOB,23,1,213,213,0,
Zoology,HOB,23,1,339,339,0,
Zoology,HOB,23,1,342,342,0,
Zoology,HOB,23,1,380,383,3,
Zoology,HOB,23,1,384,384,0,
Zoology,HOB,23,1,444,445,1,
Zoology,HOB,23,1,530,530,0,
Zoology,HOB,23,1,507,507,0,
Zoology,HOB,23,1,613,616,3,
Zoology,HOB,23,1,730,730,0,
Zoology,HOB,23,1,972,973,1,
Zoology,HOB,23,1,1075,1078,3,
Zoology,HOB,23,1,1336,1337,1,
Zoology,HOB,23,1,1465,1465,0,
Zoology,HOB,27,4,51,51,0,
Zoology,HOB,27,4,69,70,1,
Zoology,HOB,27,4,138,140,2,
Zoology,HOB,27,4,165,165,0,
Zoology,HOB,27,4,172,172,0,
Zoology,HOB,27,4,178,178,0,
Zoology,HOB,27,4,191,194,3,
Zoology,HOB,27,4,299,299,0,
Zoology,HOB,27,4,360,366,6,
Zoology,HOB,27,4,458,458,0,
Zoology,HOB,27,4,466,467,1,
Zoology,HOB,27,4,667,668,1,
Zoology,HOB,27,4,716,720,4,bee walks over paper but still sort of seems interrested
Zoology,HOB,27,4,738,738,0,
Zoology,HOB,27,4,743,743,0,
Zoology,HOB,27,4,804,807,3,
Zoology,HOB,27,4,882,883,1,
Zoology,HOB,27,4,1031,1032,1,
Zoology,HOB,27,4,1179,1182,3,
Zoology,HOB,27,4,1268,1269,1,
Zoology,HOB,27,4,1276,1279,3,
Zoology,HOB,27,4,1293,1296,3,
Zoology,HOB,27,4,1367,1367,0,bee moves paper with its legs
Zoology,HOB,27,4,1383,1385,2,bee walks over paper
Zoology,HOB,27,4,1454,1454,0,
Zoology,HOB,27,4,1466,1466,0,
Zoology,HOB,27,4,1567,1569,2,bee walks over paper
Zoology,HOB,27,4,1577,1578,1,
Zoology,HOB,27,4,1620,1620,0,bee sort of walks in to paper - barges past it but moves it
Zoology,HOB,27,4,1664,1666,2,bee walks over paper
Zoology,HOB,27,4,1674,1674,0,
Zoology,HOB,27,4,1696,1697,1,bee walks over paper
Zoology,HOB,27,4,1763,1763,0,
Zoology,HVA,4,12,0,73,73,
Zoology,HVA,4,12,75,243,168,
Zoology,HVA,4,12,168,168,0,
Zoology,HVA,4,12,170,173,3,
Zoology,HVA,4,12,175,177,2,
Zoology,HVA,4,12,240,243,3,
Zoology,HVA,4,12,251,254,3,
Zoology,HVA,4,12,256,1800,1544,
Zoology,HVA,4,12,282,287,5,
Zoology,HVA,4,12,295,353,58,
Zoology,HVA,4,12,336,346,10,
Zoology,HVA,4,12,346,348,2,
Zoology,HVA,4,12,351,354,3,
Zoology,HVA,4,12,369,377,8,
Zoology,HVA,4,12,376,378,2,
Zoology,HVA,4,12,1160,1160,0,
Zoology,HVA,4,12,389,391,2,bee sort of sniffs from afar
Zoology,HVA,4,12,410,410,0,
Zoology,HVA,4,12,435,435,0,
Zoology,HVA,4,12,436,436,0,
Zoology,HVA,4,12,453,458,5,
Zoology,HVA,4,12,488,490,2,
Zoology,HVA,4,12,526,526,0,
Zoology,HVA,4,12,593,593,0,
Zoology,HVA,4,12,673,674,1,
Zoology,HVA,4,12,693,694,1,
Zoology,HVA,4,12,759,765,6,
Zoology,HVA,4,12,759,759,0,
Zoology,HVA,4,12,762,766,4,
Zoology,HVA,4,12,773,776,3,
Zoology,HVA,4,12,786,804,18,
Zoology,HVA,4,12,825,828,3,
Zoology,HVA,4,12,872,873,1,
Zoology,HVA,4,12,913,925,12,
Zoology,HVA,4,12,1013,1017,4,
Zoology,HVA,4,12,1073,1496,423,
Zoology,HVA,4,12,1153,1155,2,
Zoology,HVA,4,12,1304,1304,0,
Zoology,HVA,4,12,1426,1428,2,
Zoology,HVA,4,12,1493,1494,1,
Zoology,HVA,4,12,1496,1500,4,
Zoology,HVA,4,12,1515,1519,4,
Zoology,HVA,4,12,1518,1528,10,
Zoology,HVA,4,12,1556,1563,7,
Zoology,HVA,4,12,1660,1663,3,
Zoology,HVA,4,12,1664,1666,2,
Zoology,HVA,5,11,40,41,1,
Zoology,HVA,5,11,119,120,1,
Zoology,HVA,5,11,135,135,0,
Zoology,HVA,5,11,141,143,2,
Zoology,HVA,5,11,242,244,2,bee pauses beside the paper i think it was aniffing not super sure
Zoology,HVA,5,11,303,305,2,
Zoology,HVA,5,11,351,352,1,
Zoology,HVA,5,11,462,462,0,
Zoology,HVA,5,11,494,496,2,
Zoology,HVA,5,11,1095,1104,9,
Zoology,HVA,5,11,564,566,2,
Zoology,HVA,5,11,584,587,3,maybe
Zoology,HVA,5,11,590,593,3,
Zoology,HVA,5,11,654,654,0,
Zoology,HVA,5,11,683,689,6,
Zoology,HVA,5,11,714,714,0,
Zoology,HVA,5,11,716,716,0,
Zoology,HVA,5,11,719,721,2,
Zoology,HVA,5,11,721,722,1,
Zoology,HVA,5,11,858,858,0,
Zoology,HVA,5,11,873,874,1,
Zoology,HVA,5,11,881,882,1,
Zoology,HVA,5,11,980,981,1,
Zoology,HVA,5,11,1008,1008,0,
Zoology,HVA,5,11,1122,1123,1,
Zoology,HVA,5,11,1158,1159,1,
Zoology,HVA,5,11,1162,1162,0,
Zoology,HVA,5,11,1183,1183,0,
Zoology,HVA,5,11,1225,1225,0,
Zoology,HVA,5,11,1244,1244,0,
Zoology,HVA,5,11,1284,1285,1,
Zoology,HVA,5,11,1284,1285,1,
Zoology,HVA,5,11,1289,1289,0,
Zoology,HVA,5,11,1293,1294,1,
Zoology,HVA,5,11,1297,1298,1,
Zoology,HVA,5,11,1534,1538,4,
Zoology,HVA,5,11,1697,1698,1,
Zoology,HVA,5,11,1707,1709,2,
Zoology,HVA,5,11,1714,1714,0,
Zoology,HVA,5,11,1731,1751,20,bee sits near paper facing it very still
Zoology,HVA,5,11,1771,1771,0,
Zoology,HVA,6,4,6,7,1,
Zoology,HVA,6,4,33,33,0,
Zoology,HVA,6,4,36,37,1,
Zoology,HVA,6,4,54,54,0,
Zoology,HVA,6,4,72,74,2,
Zoology,HVA,6,4,94,94,0,
Zoology,HVA,6,4,111,112,1,
Zoology,HVA,6,4,128,128,0,
Zoology,HVA,6,4,151,151,0,
Zoology,HVA,6,4,156,156,0,
Zoology,HVA,6,4,158,159,1,
Zoology,HVA,6,4,161,163,2,
Zoology,HVA,6,4,205,205,0,
Zoology,HVA,6,4,210,211,1,
Zoology,HVA,6,4,213,213,0,
Zoology,HVA,6,4,263,265,2,
Zoology,HVA,6,4,273,276,3,
Zoology,HVA,6,4,351,352,1,
Zoology,HVA,6,4,433,433,0,
Zoology,HVA,6,4,481,482,1,
Zoology,HVA,6,4,617,617,0,maybe
Zoology,HVA,6,4,682,682,0,
Zoology,HVA,6,4,739,739,0,maybe bumps in to circle around paper
Zoology,HVA,6,4,754,755,1,
Zoology,HVA,6,4,756,757,1,bee touching paper with its legs
Zoology,HVA,6,4,825,825,0,
Zoology,HVA,6,4,841,841,0,
Zoology,HVA,6,4,859,860,1,
Zoology,HVA,6,4,866,866,0,
Zoology,HVA,6,4,917,917,0,
Zoology,HVA,6,4,982,985,3,
Zoology,HVA,6,4,995,995,0,
Zoology,HVA,6,4,1052,1052,0,
Zoology,HVA,6,4,1053,1053,0,
Zoology,HVA,6,4,1044,1055,11,
Zoology,HVA,6,4,1057,1058,1,
Zoology,HVA,6,4,1076,1078,2,
Zoology,HVA,6,4,1106,1108,2,
Zoology,HVA,6,4,1129,1130,1,
Zoology,HVA,6,4,1142,1142,0,
Zoology,HVA,6,4,1154,1155,1,
Zoology,HVA,6,4,1162,1163,1,
Zoology,HVA,6,4,1173,1173,0,
Zoology,HVA,6,4,1176,1177,1,
Zoology,HVA,6,4,1182,1183,1,
Zoology,HVA,6,4,1202,1205,3,
Zoology,HVA,6,4,1207,1207,0,
Zoology,HVA,6,4,1223,1223,0,
Zoology,HVA,6,4,1254,1255,1,
Zoology,HVA,6,4,1277,1278,1,
Zoology,HVA,6,4,1297,1297,0,
Zoology,HVA,6,4,1298,1299,1,
Zoology,HVA,6,4,1353,1353,0,
Zoology,HVA,6,4,1379,1381,2,
Zoology,HVA,6,4,1425,1425,0,
Zoology,HVA,6,4,1443,1444,1,
Zoology,HVA,6,4,1452,1452,0,
Zoology,HVA,6,4,1458,1459,1,
Zoology,HVA,6,4,1461,1461,0,
Zoology,HVA,6,4,1491,1492,1,
Zoology,HVA,6,4,1574,1575,1,
Zoology,HVA,6,4,1607,1607,0,
Zoology,HVA,6,4,1746,1747,1,
Zoology,HVA,6,4,1757,1758,1,
Zoology,HVA,7,5,0,0,0,
Zoology,HVA,7,5,10,10,0,
Zoology,HVA,7,5,46,46,0,
Zoology,HVA,7,5,53,54,1,
Zoology,HVA,7,5,116,117,1,
Zoology,HVA,7,5,158,159,1,
Zoology,HVA,7,5,237,238,1,
Zoology,HVA,7,5,241,255,14,
Zoology,HVA,7,5,275,280,5,
Zoology,HVA,7,5,315,315,0,
Zoology,HVA,7,5,334,336,2,
Zoology,HVA,7,5,384,388,4,
Zoology,HVA,7,5,403,403,0,
Zoology,HVA,7,5,441,442,1,
Zoology,HVA,7,5,490,490,0,
Zoology,HVA,7,5,513,514,1,
Zoology,HVA,7,5,515,522,7,
Zoology,HVA,7,5,524,525,1,
Zoology,HVA,7,5,548,549,1,
Zoology,HVA,7,5,599,600,1,
Zoology,HVA,7,5,677,677,0,
Zoology,HVA,7,5,742,743,1,
Zoology,HVA,7,5,804,804,0,
Zoology,HVA,7,5,875,878,3,
Zoology,HVA,7,5,893,894,1,
Zoology,HVA,7,5,896,896,0,
Zoology,HVA,7,5,903,908,5,
Zoology,HVA,7,5,911,911,0,
Zoology,HVA,7,5,931,934,3,
Zoology,HVA,7,5,943,944,1,
Zoology,HVA,7,5,975,976,1,
Zoology,HVA,7,5,994,996,2,
Zoology,HVA,7,5,1021,1022,1,
Zoology,HVA,7,5,1030,1031,1,
Zoology,HVA,7,5,1058,1066,8,
Zoology,HVA,7,5,1088,1089,1,
Zoology,HVA,7,5,1100,1100,0,
Zoology,HVA,7,5,1108,1113,5,
Zoology,HVA,7,5,1123,1123,0,
Zoology,HVA,7,5,1133,1133,0,
Zoology,HVA,7,5,1185,1185,0,
Zoology,HVA,7,5,1241,1244,3,
Zoology,HVA,7,5,1331,1336,5,
Zoology,HVA,7,5,1364,1364,0,
Zoology,HVA,7,5,1372,1379,7,
Zoology,HVA,7,5,1416,1418,2,
Zoology,HVA,7,5,1426,1429,3,
Zoology,HVA,7,5,1434,1434,0,
Zoology,HVA,7,5,1457,1457,0,
Zoology,HVA,7,5,1475,1476,1,
Zoology,HVA,7,5,1476,1477,1,
Zoology,HVA,7,5,1522,1522,0,
Zoology,HVA,7,5,965,965,0,
Zoology,HVA,7,5,1591,1592,1,
Zoology,HVA,7,5,1606,1606,0,
Zoology,HVA,7,5,1622,1626,4,
Zoology,HVA,7,5,1638,1638,0,
Zoology,HVA,7,5,1643,1643,0,
Zoology,HVA,7,5,1661,1661,0,
Zoology,HVA,7,5,1679,1680,1,
Zoology,HVA,7,5,1744,1745,1,
Zoology,HVA,7,5,1706,1767,61,
Zoology,HVA,7,5,1782,1782,0,
Zoology,HVA,8,11,123,123,0,
Zoology,HVA,8,11,156,159,3,
Zoology,HVA,8,11,167,171,4,
Zoology,HVA,8,11,187,189,2,
Zoology,HVA,8,11,206,206,0,
Zoology,HVA,8,11,220,220,0,
Zoology,HVA,8,11,244,245,1,
Zoology,HVA,8,11,264,281,17,
Zoology,HVA,8,11,300,301,1,
Zoology,HVA,8,11,349,349,0,
Zoology,HVA,8,11,355,355,0,
Zoology,HVA,8,11,408,409,1,
Zoology,HVA,8,11,445,445,0,
Zoology,HVA,8,11,480,480,0,
Zoology,HVA,8,11,533,537,4,
Zoology,HVA,8,11,545,555,10,
Zoology,HVA,8,11,562,564,2,
Zoology,HVA,8,11,570,572,2,
Zoology,HVA,8,11,573,573,0,
Zoology,HVA,8,11,645,648,3,
Zoology,HVA,8,11,658,659,1,
Zoology,HVA,8,11,688,692,4,
Zoology,HVA,8,11,694,695,1,
Zoology,HVA,8,11,737,737,0,
Zoology,HVA,8,11,768,768,0,
Zoology,HVA,8,11,798,798,0,
Zoology,HVA,8,11,834,840,6,
Zoology,HVA,8,11,866,866,0,
Zoology,HVA,8,11,916,916,0,
Zoology,HVA,8,11,975,976,1,
Zoology,HVA,8,11,991,994,3,
Zoology,HVA,8,11,1009,1009,0,
Zoology,HVA,8,11,1061,1061,0,
Zoology,HVA,8,11,1104,1104,0,
Zoology,HVA,8,11,1139,1158,19,
Zoology,HVA,8,11,1169,1169,0,
Zoology,HVA,8,11,1171,1185,14,
Zoology,HVA,8,11,1186,1187,1,
Zoology,HVA,8,11,1190,1190,0,
Zoology,HVA,8,11,1192,1208,16,
Zoology,HVA,8,11,1196,1200,4,
Zoology,HVA,8,11,1210,1210,0,
Zoology,HVA,8,11,1213,1213,0,
Zoology,HVA,8,11,1220,1224,4,
Zoology,HVA,8,11,1228,1241,13,
Zoology,HVA,8,11,1238,1242,4,
Zoology,HVA,8,11,1247,1249,2,
Zoology,HVA,8,11,1257,1258,1,
Zoology,HVA,8,11,1257,1257,0,
Zoology,HVA,8,11,1270,1278,8,
Zoology,HVA,8,11,1307,1308,1,
Zoology,HVA,8,11,1318,1320,2,
Zoology,HVA,8,11,1327,1327,0,
Zoology,HVA,8,11,1333,1345,12,
Zoology,HVA,8,11,1353,1356,3,
Zoology,HVA,8,11,1381,1382,1,
Zoology,HVA,8,11,1426,1439,13,
Zoology,HVA,8,11,1510,1510,0,
Zoology,HVA,8,11,1538,1540,2,bee sort of snifs from afar
Zoology,HVA,8,11,1602,1602,0,
Zoology,HVA,8,11,1675,1676,1,
Zoology,HVA,8,11,1700,1700,0,
Zoology,HVA,8,11,1747,1753,6,
Zoology,HVA,8,11,1754,1755,1,
Zoology,HVA,8,11,1772,1774,2,
Zoology,HVA,9,10,1,2,1,
Zoology,HVA,9,10,3,10,7,
Zoology,HVA,9,10,41,42,1,
Zoology,HVA,9,10,55,57,2,
Zoology,HVA,9,10,58,59,1,
Zoology,HVA,9,10,105,106,1,
Zoology,HVA,9,10,109,109,0,
Zoology,HVA,9,10,131,131,0,
Zoology,HVA,9,10,137,138,1,
Zoology,HVA,9,10,151,152,1,
Zoology,HVA,9,10,187,188,1,
Zoology,HVA,9,10,190,190,0,
Zoology,HVA,9,10,235,237,2,
Zoology,HVA,9,10,262,263,1,
Zoology,HVA,9,10,274,274,0,
Zoology,HVA,9,10,297,298,1,
Zoology,HVA,9,10,305,305,0,
Zoology,HVA,9,10,321,321,0,
Zoology,HVA,9,10,375,375,0,
Zoology,HVA,9,10,462,463,1,
Zoology,HVA,9,10,474,474,0,
Zoology,HVA,9,10,477,477,0,
Zoology,HVA,9,10,564,564,0,
Zoology,HVA,9,10,602,602,0,
Zoology,HVA,9,10,600,660,60,
Zoology,HVA,9,10,683,683,0,
Zoology,HVA,9,10,692,693,1,
Zoology,HVA,9,10,727,727,0,
Zoology,HVA,9,10,756,756,0,
Zoology,HVA,9,10,808,808,0,
Zoology,HVA,9,10,822,823,1,
Zoology,HVA,9,10,854,857,3,
Zoology,HVA,9,10,862,862,0,
Zoology,HVA,9,10,891,893,2,
Zoology,HVA,9,10,898,898,0,
Zoology,HVA,9,10,906,908,2,
Zoology,HVA,9,10,1022,1023,1,
Zoology,HVA,9,10,1058,1059,1,
Zoology,HVA,9,10,1152,1152,0,
Zoology,HVA,9,10,1206,1206,0,
Zoology,HVA,9,10,1214,1217,3,
Zoology,HVA,9,10,1231,1231,0,
Zoology,HVA,9,10,1267,1268,1,
Zoology,HVA,9,10,1279,1279,0,
Zoology,HVA,9,10,1285,1289,4,
Zoology,HVA,9,10,1302,1302,0,
Zoology,HVA,9,10,1405,1406,1,
Zoology,HVA,9,10,1415,1418,3,
Zoology,HVA,9,10,1421,1439,18,
Zoology,HVA,9,10,1466,1466,0,
Zoology,HVA,9,10,1494,1496,2,bee walks over paper
Zoology,HVA,9,10,1502,1503,1,
Zoology,HVA,9,10,1505,1506,1,
Zoology,HVA,9,10,1518,1518,0,
Zoology,HVA,9,10,1571,1572,1,
Zoology,HVA,9,10,1600,1601,1,
Zoology,HVA,9,10,1636,1636,0,
Zoology,HVA,9,10,1657,1657,0,
Zoology,HVA,9,10,1683,1683,0,
Zoology,HVA,9,10,1713,1714,1,
Zoology,HVA,9,10,1770,1771,1,
Zoology,HVA,9,10,1772,1774,2,
Zoology,HVA,9,10,1788,1788,0,
Zoology,HVA,11,12,2,2,0,
Zoology,HVA,11,12,24,24,0,
Zoology,HVA,11,12,28,28,0,
Zoology,HVA,11,12,32,32,0,
Zoology,HVA,11,12,47,51,4,
Zoology,HVA,11,12,53,53,0,
Zoology,HVA,11,12,88,88,0,
Zoology,HVA,11,12,93,93,0,
Zoology,HVA,11,12,108,108,0,maybe - not quite touch
Zoology,HVA,11,12,113,113,0,
Zoology,HVA,11,12,174,174,0,
Zoology,HVA,11,12,174,174,0,
Zoology,HVA,11,12,197,197,0,
Zoology,HVA,11,12,226,226,0,
Zoology,HVA,11,12,238,239,1,
Zoology,HVA,11,12,280,280,0,
Zoology,HVA,11,12,295,295,0,
Zoology,HVA,11,12,305,305,0,
Zoology,HVA,11,12,306,306,0,
Zoology,HVA,11,12,321,322,1,
Zoology,HVA,11,12,323,323,0,
Zoology,HVA,11,12,345,345,0,
Zoology,HVA,11,12,385,385,0,
Zoology,HVA,11,12,387,387,0,
Zoology,HVA,11,12,416,417,1,
Zoology,HVA,11,12,443,477,34,
Zoology,HVA,11,12,453,454,1,
Zoology,HVA,11,12,474,476,2,
Zoology,HVA,11,12,481,498,17,
Zoology,HVA,11,12,493,497,4,
Zoology,HVA,11,12,504,504,0,
Zoology,HVA,11,12,505,506,1,
Zoology,HVA,11,12,533,535,2,
Zoology,HVA,11,12,549,549,0,
Zoology,HVA,11,12,552,552,0,
Zoology,HVA,11,12,562,562,0,
Zoology,HVA,11,12,566,567,1,
Zoology,HVA,11,12,570,571,1,
Zoology,HVA,11,12,571,579,8,
Zoology,HVA,11,12,577,578,1,
Zoology,HVA,11,12,588,589,1,
Zoology,HVA,11,12,590,594,4,
Zoology,HVA,11,12,598,599,1,
Zoology,HVA,11,12,603,603,0,
Zoology,HVA,11,12,649,657,8,
Zoology,HVA,11,12,695,696,1,
Zoology,HVA,11,12,707,708,1,
Zoology,HVA,11,12,710,711,1,
Zoology,HVA,11,12,743,744,1,
Zoology,HVA,11,12,765,765,0,
Zoology,HVA,11,12,804,804,0,
Zoology,HVA,11,12,819,819,0,
Zoology,HVA,11,12,844,844,0,
Zoology,HVA,11,12,848,848,0,
Zoology,HVA,11,12,859,859,0,
Zoology,HVA,11,12,867,874,7,
Zoology,HVA,11,12,884,884,0,
Zoology,HVA,11,12,913,914,1,
Zoology,HVA,11,12,941,943,2,
Zoology,HVA,11,12,962,963,1,
Zoology,HVA,11,12,978,979,1,
Zoology,HVA,11,12,994,994,0,
Zoology,HVA,11,12,1016,1017,1,
Zoology,HVA,11,12,1039,1039,0,
Zoology,HVA,11,12,1102,1102,0,side touch
Zoology,HVA,11,12,1114,1115,1,
Zoology,HVA,11,12,1131,1131,0,
Zoology,HVA,11,12,1167,1176,9,
Zoology,HVA,11,12,1178,1180,2,
Zoology,HVA,11,12,1181,1183,2,
Zoology,HVA,11,12,1183,1183,0,
Zoology,HVA,11,12,1216,1217,1,
Zoology,HVA,11,12,1229,1230,1,
Zoology,HVA,11,12,1233,1233,0,
Zoology,HVA,11,12,1264,1264,0,
Zoology,HVA,11,12,1284,1285,1,
Zoology,HVA,11,12,1294,1294,0,accidental bump maybe
Zoology,HVA,11,12,1302,1302,0,
Zoology,HVA,11,12,1311,1311,0,
Zoology,HVA,11,12,1363,1363,0,
Zoology,HVA,11,12,1366,1366,0,
Zoology,HVA,11,12,1367,1367,0,
Zoology,HVA,11,12,1375,1376,1,
Zoology,HVA,11,12,1376,1377,1,
Zoology,HVA,11,12,1438,1438,0,
Zoology,HVA,11,12,1476,1476,0,
Zoology,HVA,11,12,1515,1522,7,
Zoology,HVA,11,12,1524,1530,6,
Zoology,HVA,11,12,1530,1535,5,
Zoology,HVA,11,12,1536,1536,0,
Zoology,HVA,11,12,1537,1539,2,
Zoology,HVA,11,12,1561,1563,2,
Zoology,HVA,11,12,1566,1566,0,
Zoology,HVA,11,12,1573,1573,0,
Zoology,HVA,11,12,1599,1604,5,
Zoology,HVA,11,12,1609,1613,4,
Zoology,HVA,11,12,1666,1666,0,
Zoology,HVA,11,12,1695,1695,0,
Zoology,HVA,11,12,1768,1770,2,
Zoology,HVA,11,12,1774,1774,0,
Zoology,HVA,11,12,1785,1793,8,
Zoology,HVA,14,3,2,2,0,
Zoology,HVA,14,3,10,13,3,
Zoology,HVA,14,3,20,20,0,
Zoology,HVA,14,3,35,36,1,
Zoology,HVA,14,3,40,40,0,
Zoology,HVA,14,3,96,98,2,
Zoology,HVA,14,3,245,245,0,maybe
Zoology,HVA,14,3,318,320,2,
Zoology,HVA,14,3,325,325,0,
Zoology,HVA,14,3,425,428,3,
Zoology,HVA,14,3,433,434,1,
Zoology,HVA,14,3,446,446,0,
Zoology,HVA,14,3,462,462,0,
Zoology,HVA,14,3,614,614,0,
Zoology,HVA,14,3,653,653,0,
Zoology,HVA,14,3,724,724,0,bee bumps paper
Zoology,HVA,14,3,893,893,0,
Zoology,HVA,14,3,930,932,2,
Zoology,HVA,14,3,936,936,0,bee turns in to paper
Zoology,HVA,14,3,945,947,2,
Zoology,HVA,14,3,1078,1083,5,
Zoology,HVA,14,3,1119,1120,1,
Zoology,HVA,14,3,1254,1255,1,
Zoology,HVA,14,3,1354,1356,2,
Zoology,HVA,14,3,1431,1431,0,bee turns around near paper
Zoology,HVA,14,3,1561,1561,0,
Zoology,HVA,14,3,1615,1615,0,
Zoology,HVA,14,3,1718,1718,0,
Zoology,HVA,14,3,1733,1733,0,bee bumps in to paper
Zoology,HVA,18,2,0,7,7,be sniffing and sitting on top of paper a bit
Zoology,HVA,18,2,1,5,4,
Zoology,HVA,18,2,13,15,2,
Zoology,HVA,18,2,19,24,5,
Zoology,HVA,18,2,25,26,1,
Zoology,HVA,18,2,26,29,3,
Zoology,HVA,18,2,32,36,4,
Zoology,HVA,18,2,34,36,2,bee walsk over part of paper
Zoology,HVA,18,2,37,38,1,
Zoology,HVA,18,2,42,44,2,
Zoology,HVA,18,2,47,49,2,
Zoology,HVA,18,2,56,60,4,
Zoology,HVA,18,2,66,67,1,bee walks over part of the paper
Zoology,HVA,18,2,67,70,3,
Zoology,HVA,18,2,94,94,0,
Zoology,HVA,18,2,203,203,0,
Zoology,HVA,18,2,229,229,0,
Zoology,HVA,18,2,296,296,0,
Zoology,HVA,18,2,327,328,1,
Zoology,HVA,18,2,412,425,13,
Zoology,HVA,18,2,428,429,1,
Zoology,HVA,18,2,436,436,0,
Zoology,HVA,18,2,448,452,4,
Zoology,HVA,18,2,471,472,1,
Zoology,HVA,18,2,503,507,4,
Zoology,HVA,18,2,805,807,2,
Zoology,HVA,18,2,846,851,5,
Zoology,HVA,18,2,863,863,0,
Zoology,HVA,18,2,865,865,0,
Zoology,HVA,18,2,947,950,3,
Zoology,HVA,18,2,1045,1045,0,
Zoology,HVA,18,2,1046,1051,5,
Zoology,HVA,18,2,1056,1056,0,
Zoology,HVA,18,2,1120,1120,0,
Zoology,HVA,18,2,1204,1204,0,
Zoology,HVA,18,2,1249,1249,0,
Zoology,HVA,18,2,1265,1269,4,
Zoology,HVA,18,2,1300,1304,4,
Zoology,HVA,18,2,1304,1304,0,
Zoology,HVA,18,2,1475,1481,6,
Zoology,HVA,18,2,1531,1532,1,
Zoology,HVA,18,2,1578,1582,4,
Zoology,HVA,18,2,1596,1600,4,
Zoology,HVA,18,2,1622,1622,0,
Zoology,HVA,19,2,23,24,1,
Zoology,HVA,19,2,211,212,1,
Zoology,HVA,19,2,406,408,2,
Zoology,HVA,19,2,472,472,0,
Zoology,HVA,19,2,477,479,2,
Zoology,HVA,19,2,564,564,0,
Zoology,HVA,19,2,575,575,0,
Zoology,HVA,19,2,612,612,0,
Zoology,HVA,19,2,633,633,0,
Zoology,HVA,19,2,681,683,2,
Zoology,HVA,19,2,708,711,3,
Zoology,HVA,19,2,888,888,0,
Zoology,HVA,19,2,914,915,1,
Zoology,HVA,19,2,920,920,0,
Zoology,HVA,19,2,962,963,1,
Zoology,HVA,19,2,970,970,0,
Zoology,HVA,19,2,973,975,2,
Zoology,HVA,19,2,976,978,2,
Zoology,HVA,19,2,1175,1180,5,
Zoology,HVA,19,2,1177,1177,0,
Zoology,HVA,19,2,1217,1219,2,
Zoology,HVA,19,2,1270,1273,3,
Zoology,HVA,19,2,1305,1305,0,
Zoology,HVA,19,2,1326,1326,0,
Zoology,HVA,19,2,1480,1481,1,
Zoology,HVA,19,2,1491,1498,7,
Zoology,HVA,19,2,1540,1543,3,
Zoology,HVA,19,2,1547,1549,2,
Zoology,HVA,19,2,1657,1657,0,
Zoology,HVA,19,2,1677,1681,4,
Zoology,HVA,19,2,1743,1746,3,
Zoology,HVA,19,2,1764,1764,0,
Zoology,HVA,23,2,22,22,0,
Zoology,HVA,23,2,43,43,0,
Zoology,HVA,23,2,75,75,0,
Zoology,HVA,23,2,81,83,2,
Zoology,HVA,23,2,91,91,0,
Zoology,HVA,23,2,141,141,0,
Zoology,HVA,23,2,158,158,0,
Zoology,HVA,23,2,181,182,1,
Zoology,HVA,23,2,199,199,0,
Zoology,HVA,23,2,223,223,0,
Zoology,HVA,23,2,315,315,0,
Zoology,HVA,23,2,400,404,4,
Zoology,HVA,23,2,462,463,1,
Zoology,HVA,23,2,498,502,4,
Zoology,HVA,23,2,505,505,0,
Zoology,HVA,23,2,519,520,1,
Zoology,HVA,23,2,560,560,0,
Zoology,HVA,23,2,654,672,18,bee sits facing paper a little distance from it. It does seem interrested
Zoology,HVA,23,2,681,682,1,
Zoology,HVA,23,2,733,734,1,bee seems interrested not actually touching
Zoology,HVA,23,2,804,804,0,
Zoology,HVA,23,2,893,897,4,
Zoology,HVA,23,2,948,950,2,
Zoology,HVA,23,2,975,975,0,
Zoology,HVA,23,2,978,978,0,
Zoology,HVA,23,2,1196,1208,12,
Zoology,HVA,23,2,1252,1252,0,
Zoology,HVA,23,2,1337,1337,0,
Zoology,HVA,23,2,1354,1355,1,
Zoology,HVA,23,2,1397,1397,0,
Zoology,HVA,23,2,1404,1408,4,
Zoology,HVA,23,2,1416,1418,2,bee sniffing around not actually touching though
Zoology,HVA,23,2,1482,1484,2,
Zoology,HVA,23,2,1503,1503,0,
Zoology,HVA,23,2,1508,1508,0,
Zoology,HVA,23,2,1610,1616,6,
Zoology,HVA,23,2,1621,1621,0,
Zoology,HVA,23,2,1762,1762,0,
Zoology,9-HDA,4,7,320,326,6,
Zoology,9-HDA,4,7,422,423,1,
Zoology,9-HDA,4,7,502,504,2,
Zoology,9-HDA,4,7,527,529,2,
Zoology,9-HDA,5,12,106,113,7,
Zoology,9-HDA,5,12,120,121,1,
Zoology,9-HDA,5,12,121,123,2,
Zoology,9-HDA,5,12,122,126,4,
Zoology,9-HDA,5,12,171,172,1,
Zoology,9-HDA,5,12,171,176,5,
Zoology,9-HDA,5,12,275,275,0,
Zoology,9-HDA,5,12,305,305,0,
Zoology,9-HDA,5,12,427,431,4,
Zoology,9-HDA,5,12,769,769,0,
Zoology,9-HDA,5,12,1137,1138,1,
Zoology,9-HDA,5,12,1294,1295,1,
Zoology,9-HDA,5,12,1518,1529,11,maybe - sort of facing paper from afar
Zoology,9-HDA,5,12,1548,1548,0,
Zoology,9-HDA,5,12,1554,1554,0,
Zoology,9-HDA,5,12,1555,1556,1,
Zoology,9-HDA,5,12,1572,1572,0,
Zoology,9-HDA,5,12,1616,1616,0,
Zoology,9-HDA,5,12,1648,1651,3,
Zoology,9-HDA,5,12,1665,1665,0,
Zoology,9-HDA,5,12,1696,1697,1,
Zoology,9-HDA,5,12,1715,1715,0,
Zoology,9-HDA,5,12,1715,1718,3,
Zoology,9-HDA,5,12,1720,1720,0,
Zoology,9-HDA,5,12,1732,1732,0,
Zoology,9-HDA,5,12,1737,1738,1,
Zoology,9-HDA,5,12,1743,1744,1,
Zoology,9-HDA,5,12,1756,1756,0,
Zoology,9-HDA,5,12,1757,1759,2,
Zoology,9-HDA,5,12,1768,1769,1,
Zoology,9-HDA,5,12,1779,1779,0,
Zoology,9-HDA,5,12,1787,1787,0,
Zoology,9-HDA,6,10,5,8,3,
Zoology,9-HDA,6,10,30,30,0,
Zoology,9-HDA,6,10,30,30,0,
Zoology,9-HDA,6,10,50,51,1,
Zoology,9-HDA,6,10,61,61,0,
Zoology,9-HDA,6,10,69,69,0,
Zoology,9-HDA,6,10,83,84,1,
Zoology,9-HDA,6,10,96,96,0,
Zoology,9-HDA,6,10,150,150,0,
Zoology,9-HDA,6,10,274,275,1,
Zoology,9-HDA,6,10,278,278,0,
Zoology,9-HDA,6,10,294,294,0,
Zoology,9-HDA,6,10,297,297,0,
Zoology,9-HDA,6,10,301,302,1,
Zoology,9-HDA,6,10,333,334,1,
Zoology,9-HDA,6,10,355,355,0,
Zoology,9-HDA,6,10,389,389,0,
Zoology,9-HDA,6,10,424,424,0,
Zoology,9-HDA,6,10,491,491,0,
Zoology,9-HDA,6,10,553,553,0,bumps in to paper as its turning around
Zoology,9-HDA,6,10,667,667,0,
Zoology,9-HDA,6,10,686,689,3,
Zoology,9-HDA,6,10,720,720,0,
Zoology,9-HDA,6,10,792,792,0,
Zoology,9-HDA,6,10,802,804,2,
Zoology,9-HDA,6,10,846,847,1,
Zoology,9-HDA,6,10,860,860,0,
Zoology,9-HDA,6,10,866,866,0,bumps in to paper as its turning around
Zoology,9-HDA,6,10,872,873,1,
Zoology,9-HDA,6,10,963,963,0,
Zoology,9-HDA,6,10,969,970,1,
Zoology,9-HDA,6,10,1e3,1004,4,
Zoology,9-HDA,6,10,1079,1080,1,
Zoology,9-HDA,6,10,1099,1103,4,
Zoology,9-HDA,6,10,1168,1168,0,
Zoology,9-HDA,6,10,1176,1176,0,
Zoology,9-HDA,6,10,1181,1182,1,
Zoology,9-HDA,6,10,1203,1204,1,
Zoology,9-HDA,6,10,1220,1220,0,
Zoology,9-HDA,6,10,1230,1230,0,
Zoology,9-HDA,6,10,1263,1263,0,
Zoology,9-HDA,6,10,1460,1460,0,
Zoology,9-HDA,6,10,1500,1505,5,
Zoology,9-HDA,6,10,1579,1582,3,bee sniffs from afar
Zoology,9-HDA,6,10,1597,1597,0,
Zoology,9-HDA,6,10,1600,1600,0,
Zoology,9-HDA,6,10,1794,1794,0,
Zoology,9-HDA,7,4,20,20,0,
Zoology,9-HDA,7,4,105,107,2,
Zoology,9-HDA,7,4,108,108,0,
Zoology,9-HDA,7,4,121,121,0,
Zoology,9-HDA,7,4,174,175,1,
Zoology,9-HDA,7,4,220,221,1,
Zoology,9-HDA,7,4,225,225,0,
Zoology,9-HDA,7,4,245,245,0,
Zoology,9-HDA,7,4,253,253,0,
Zoology,9-HDA,7,4,256,257,1,
Zoology,9-HDA,7,4,300,300,0,
Zoology,9-HDA,7,4,305,305,0,
Zoology,9-HDA,7,4,318,318,0,
Zoology,9-HDA,7,4,339,339,0,
Zoology,9-HDA,7,4,355,356,1,
Zoology,9-HDA,7,4,397,397,0,
Zoology,9-HDA,7,4,443,444,1,
Zoology,9-HDA,7,4,451,451,0,
Zoology,9-HDA,7,4,468,468,0,
Zoology,9-HDA,7,4,476,476,0,
Zoology,9-HDA,7,4,483,484,1,
Zoology,9-HDA,7,4,526,526,0,
Zoology,9-HDA,7,4,556,556,0,
Zoology,9-HDA,7,4,570,571,1,
Zoology,9-HDA,7,4,617,618,1,
Zoology,9-HDA,7,4,824,825,1,
Zoology,9-HDA,7,4,905,906,1,
Zoology,9-HDA,7,4,947,947,0,
Zoology,9-HDA,7,4,1037,1037,0,bee sort of lunges towards paper from afar
Zoology,9-HDA,7,4,1075,1075,0,
Zoology,9-HDA,7,4,1085,1085,0,
Zoology,9-HDA,7,4,1261,1263,2,
Zoology,9-HDA,7,4,1335,1336,1,
Zoology,9-HDA,7,4,1366,1373,7,
Zoology,9-HDA,7,4,1415,1415,0,
Zoology,9-HDA,7,4,1437,1437,0,
Zoology,9-HDA,7,4,1550,1550,0,
Zoology,9-HDA,7,4,1613,1613,0,
Zoology,9-HDA,7,4,1636,1642,6,
Zoology,9-HDA,7,4,1711,1712,1,
Zoology,9-HDA,7,4,1728,1728,0,
Zoology,9-HDA,8,9,51,51,0,
Zoology,9-HDA,8,9,109,109,0,
Zoology,9-HDA,8,9,216,216,0,
Zoology,9-HDA,8,9,275,275,0,
Zoology,9-HDA,8,9,310,311,1,
Zoology,9-HDA,8,9,393,396,3,
Zoology,9-HDA,8,9,396,396,0,
Zoology,9-HDA,8,9,403,403,0,
Zoology,9-HDA,8,9,471,471,0,
Zoology,9-HDA,8,9,532,533,1,
Zoology,9-HDA,8,9,619,625,6,
Zoology,9-HDA,8,9,651,652,1,
Zoology,9-HDA,8,9,727,728,1,
Zoology,9-HDA,8,9,728,728,0,
Zoology,9-HDA,8,9,764,764,0,
Zoology,9-HDA,8,9,804,805,1,
Zoology,9-HDA,8,9,816,817,1,
Zoology,9-HDA,8,9,846,846,0,
Zoology,9-HDA,8,9,907,907,0,
Zoology,9-HDA,8,9,914,914,0,
Zoology,9-HDA,8,9,926,926,0,
Zoology,9-HDA,8,9,927,928,1,
Zoology,9-HDA,8,9,962,962,0,
Zoology,9-HDA,8,9,996,996,0,
Zoology,9-HDA,8,9,1005,1005,0,
Zoology,9-HDA,8,9,1022,1023,1,
Zoology,9-HDA,8,9,1048,1049,1,
Zoology,9-HDA,8,9,1091,1091,0,
Zoology,9-HDA,8,9,1100,1100,0,
Zoology,9-HDA,8,9,1103,1104,1,
Zoology,9-HDA,8,9,1109,1109,0,
Zoology,9-HDA,8,9,1186,1186,0,
Zoology,9-HDA,8,9,1204,1204,0,
Zoology,9-HDA,8,9,1236,1237,1,
Zoology,9-HDA,8,9,1241,1241,0,
Zoology,9-HDA,8,9,1371,1378,7,
Zoology,9-HDA,8,9,1384,1392,8,
Zoology,9-HDA,8,9,1700,1701,1,
Zoology,9-HDA,8,9,1773,1773,0,
Zoology,9-HDA,8,9,1773,1773,0,
Zoology,9-HDA,9,12,12,13,1,
Zoology,9-HDA,9,12,45,48,3,
Zoology,9-HDA,9,12,79,79,0,
Zoology,9-HDA,9,12,108,109,1,
Zoology,9-HDA,9,12,148,150,2,
Zoology,9-HDA,9,12,222,222,0,
Zoology,9-HDA,9,12,297,301,4,
Zoology,9-HDA,9,12,422,422,0,
Zoology,9-HDA,9,12,449,449,0,
Zoology,9-HDA,9,12,451,452,1,
Zoology,9-HDA,9,12,466,466,0,
Zoology,9-HDA,9,12,470,472,2,
Zoology,9-HDA,9,12,490,490,0,
Zoology,9-HDA,9,12,491,491,0,
Zoology,9-HDA,9,12,529,530,1,
Zoology,9-HDA,9,12,592,593,1,
Zoology,9-HDA,9,12,695,695,0,
Zoology,9-HDA,9,12,698,698,0,
Zoology,9-HDA,9,12,704,704,0,
Zoology,9-HDA,9,12,715,715,0,
Zoology,9-HDA,9,12,794,796,2,
Zoology,9-HDA,9,12,796,798,2,
Zoology,9-HDA,9,12,824,826,2,
Zoology,9-HDA,9,12,824,828,4,
Zoology,9-HDA,9,12,839,840,1,
Zoology,9-HDA,9,12,911,911,0,
Zoology,9-HDA,9,12,924,924,0,
Zoology,9-HDA,9,12,937,937,0,
Zoology,9-HDA,9,12,968,968,0,maybe - not quite touching
Zoology,9-HDA,9,12,980,980,0,maybe - not quite touching
Zoology,9-HDA,9,12,993,996,3,
Zoology,9-HDA,9,12,1019,1023,4,
Zoology,9-HDA,9,12,1047,1049,2,
Zoology,9-HDA,9,12,1108,1108,0,
Zoology,9-HDA,9,12,1223,1224,1,
Zoology,9-HDA,9,12,1252,1252,0,
Zoology,9-HDA,9,12,1258,1263,5,
Zoology,9-HDA,9,12,1309,1309,0,
Zoology,9-HDA,9,12,1332,1332,0,maybe - not quite touching
Zoology,9-HDA,9,12,1335,1335,0,
Zoology,9-HDA,9,12,1378,1379,1,
Zoology,9-HDA,9,12,1378,1379,1,
Zoology,9-HDA,9,12,1463,1464,1,
Zoology,9-HDA,9,12,1485,1485,0,
Zoology,9-HDA,9,12,1505,1507,2,
Zoology,9-HDA,9,12,1554,1555,1,no touching seems interrested
Zoology,9-HDA,9,12,1703,1703,0,
Zoology,9-HDA,9,12,1753,1754,1,
Zoology,9-HDA,9,12,1768,1768,0,
Zoology,9-HDA,9,12,1782,1785,3,
Zoology,9-HDA,9,12,1791,1793,2,
Zoology,9-HDA,11,2,40,40,0,
Zoology,9-HDA,11,2,121,125,4,
Zoology,9-HDA,11,2,141,141,0,
Zoology,9-HDA,11,2,143,144,1,
Zoology,9-HDA,11,2,145,148,3,
Zoology,9-HDA,11,2,147,147,0,
Zoology,9-HDA,11,2,156,158,2,
Zoology,9-HDA,11,2,166,167,1,
Zoology,9-HDA,11,2,179,180,1,
Zoology,9-HDA,11,2,237,238,1,
Zoology,9-HDA,11,2,238,239,1,
Zoology,9-HDA,11,2,259,260,1,
Zoology,9-HDA,11,2,264,264,0,
Zoology,9-HDA,11,2,269,269,0,
Zoology,9-HDA,11,2,273,273,0,
Zoology,9-HDA,11,2,360,360,0,
Zoology,9-HDA,11,2,363,363,0,
Zoology,9-HDA,11,2,368,368,0,
Zoology,9-HDA,11,2,389,389,0,
Zoology,9-HDA,11,2,453,454,1,"maybe, not really touching just interrested"
Zoology,9-HDA,11,2,455,461,6,
Zoology,9-HDA,11,2,482,482,0,
Zoology,9-HDA,11,2,486,486,0,
Zoology,9-HDA,11,2,553,553,0,
Zoology,9-HDA,11,2,557,558,1,
Zoology,9-HDA,11,2,562,562,0,
Zoology,9-HDA,11,2,650,651,1,
Zoology,9-HDA,11,2,706,707,1,
Zoology,9-HDA,11,2,724,733,9,
Zoology,9-HDA,11,2,778,779,1,
Zoology,9-HDA,11,2,866,866,0,
Zoology,9-HDA,11,2,866,871,5,
Zoology,9-HDA,11,2,878,880,2,
Zoology,9-HDA,11,2,881,886,5,
Zoology,9-HDA,11,2,886,892,6,
Zoology,9-HDA,11,2,891,898,7,
Zoology,9-HDA,11,2,909,909,0,
Zoology,9-HDA,11,2,930,930,0,
Zoology,9-HDA,11,2,937,942,5,
Zoology,9-HDA,11,2,952,953,1,
Zoology,9-HDA,11,2,958,958,0,
Zoology,9-HDA,11,2,975,975,0,
Zoology,9-HDA,11,2,1105,1105,0,
Zoology,9-HDA,11,2,1166,1166,0,
Zoology,9-HDA,11,2,1171,1171,0,
Zoology,9-HDA,11,2,1234,1243,9,
Zoology,9-HDA,11,2,1294,1295,1,
Zoology,9-HDA,11,2,1301,1307,6,
Zoology,9-HDA,11,2,1311,1312,1,
Zoology,9-HDA,11,2,1328,1329,1,
Zoology,9-HDA,11,2,1335,1337,2,
Zoology,9-HDA,11,2,1383,1384,1,
Zoology,9-HDA,11,2,1388,1389,1,
Zoology,9-HDA,11,2,1405,1407,2,
Zoology,9-HDA,11,2,1447,1449,2,
Zoology,9-HDA,11,2,1460,1460,0,
Zoology,9-HDA,11,2,1507,1507,0,
Zoology,9-HDA,11,2,1513,1513,0,
Zoology,9-HDA,11,2,1529,1529,0,
Zoology,9-HDA,11,2,1535,1535,0,
Zoology,9-HDA,11,2,1555,1557,2,
Zoology,9-HDA,11,2,1704,1707,3,
Zoology,9-HDA,11,2,1708,1708,0,
Zoology,9-HDA,11,2,1748,1750,2,
Zoology,9-HDA,11,2,1795,1796,1,
Zoology,9-HDA,11,2,1798,1798,0,
Zoology,9-HDA,14,10,29,32,3,
Zoology,9-HDA,14,10,34,36,2,"not touching, kinda seems interrested, not so sure"
Zoology,9-HDA,14,10,41,41,0,
Zoology,9-HDA,14,10,55,58,3,
Zoology,9-HDA,14,10,56,60,4,
Zoology,9-HDA,14,10,62,63,1,
Zoology,9-HDA,14,10,73,74,1,sideways touch probs dosen't count
Zoology,9-HDA,14,10,87,88,1,
Zoology,9-HDA,14,10,93,98,5,
Zoology,9-HDA,14,10,113,113,0,
Zoology,9-HDA,14,10,124,124,0,touches corner of paper may be interrested in other bee rather than paper
Zoology,9-HDA,14,10,136,136,0,
Zoology,9-HDA,14,10,147,147,0,no touch seems a little interrested
Zoology,9-HDA,14,10,154,158,4,
Zoology,9-HDA,14,10,225,230,5,
Zoology,9-HDA,14,10,232,233,1,
Zoology,9-HDA,14,10,236,237,1,
Zoology,9-HDA,14,10,258,263,5,
Zoology,9-HDA,14,10,275,280,5,
Zoology,9-HDA,14,10,306,308,2,
Zoology,9-HDA,14,10,322,322,0,
Zoology,9-HDA,14,10,317,324,7,
Zoology,9-HDA,14,10,326,329,3,
Zoology,9-HDA,14,10,355,359,4,
Zoology,9-HDA,14,10,362,367,5,
Zoology,9-HDA,14,10,370,372,2,
Zoology,9-HDA,14,10,464,464,0,
Zoology,9-HDA,14,10,510,515,5,
Zoology,9-HDA,14,10,510,510,0,
Zoology,9-HDA,14,10,545,547,2,
Zoology,9-HDA,14,10,576,576,0,
Zoology,9-HDA,14,10,585,587,2,
Zoology,9-HDA,14,10,633,634,1,
Zoology,9-HDA,14,10,635,635,0,
Zoology,9-HDA,14,10,653,653,0,
Zoology,9-HDA,14,10,768,769,1,
Zoology,9-HDA,14,10,808,810,2,
Zoology,9-HDA,14,10,824,825,1,
Zoology,9-HDA,14,10,843,843,0,
Zoology,9-HDA,14,10,908,912,4,
Zoology,9-HDA,14,10,939,939,0,
Zoology,9-HDA,14,10,945,947,2,
Zoology,9-HDA,14,10,970,971,1,
Zoology,9-HDA,14,10,980,980,0,
Zoology,9-HDA,14,10,1018,1020,2,
Zoology,9-HDA,14,10,1061,1063,2,
Zoology,9-HDA,14,10,1096,1097,1,
Zoology,9-HDA,14,10,1149,1150,1,
Zoology,9-HDA,14,10,1173,1174,1,
Zoology,9-HDA,14,10,1185,1191,6,
Zoology,9-HDA,14,10,1207,1209,2,
Zoology,9-HDA,14,10,1212,1214,2,
Zoology,9-HDA,14,10,162,165,3,
Zoology,9-HDA,14,10,1247,1251,4,
Zoology,9-HDA,14,10,1256,1256,0,
Zoology,9-HDA,14,10,1258,1259,1,
Zoology,9-HDA,14,10,1262,1266,4,
Zoology,9-HDA,14,10,1349,1350,1,
Zoology,9-HDA,14,10,1356,1360,4,
Zoology,9-HDA,14,10,1390,1390,0,maybe
Zoology,9-HDA,14,10,1396,1397,1,
Zoology,9-HDA,14,10,1407,1409,2,
Zoology,9-HDA,14,10,1441,1441,0,
Zoology,9-HDA,14,10,1472,1473,1,bee bumps in to paper as it turns around
Zoology,9-HDA,14,10,1515,1516,1,
Zoology,9-HDA,14,10,1517,1519,2,
Zoology,9-HDA,14,10,1591,1591,0,maybe
Zoology,9-HDA,14,10,1621,1621,0,
Zoology,9-HDA,14,10,1630,1631,1,
Zoology,9-HDA,14,10,1654,1656,2,
Zoology,9-HDA,14,10,1665,1665,0,
Zoology,9-HDA,14,10,1675,1676,1,
Zoology,9-HDA,14,10,1683,1683,0,
Zoology,9-HDA,14,10,1696,1696,0,
Zoology,9-HDA,14,10,1723,1724,1,
Zoology,9-HDA,14,10,1730,1730,0,
Zoology,9-HDA,14,10,1744,1744,0,
Zoology,9-HDA,18,10,0,2,2,
Zoology,9-HDA,18,10,7,10,3,
Zoology,9-HDA,18,10,13,13,0,
Zoology,9-HDA,18,10,24,29,5,sits on paper until 00:45
Zoology,9-HDA,18,10,53,60,7,
Zoology,9-HDA,18,10,58,63,5,sits on paper until 1:09
Zoology,9-HDA,18,10,110,113,3,
Zoology,9-HDA,18,10,123,132,9,
Zoology,9-HDA,18,10,138,140,2,
Zoology,9-HDA,18,10,167,167,0,
Zoology,9-HDA,18,10,199,200,1,
Zoology,9-HDA,18,10,206,219,13,
Zoology,9-HDA,18,10,238,239,1,
Zoology,9-HDA,18,10,241,246,5,
Zoology,9-HDA,18,10,243,250,7,
Zoology,9-HDA,18,10,328,328,0,
Zoology,9-HDA,18,10,363,367,4,
Zoology,9-HDA,18,10,367,367,0,
Zoology,9-HDA,18,10,367,368,1,
Zoology,9-HDA,18,10,474,477,3,
Zoology,9-HDA,18,10,526,528,2,
Zoology,9-HDA,18,10,559,569,10,
Zoology,9-HDA,18,10,573,573,0,
Zoology,9-HDA,18,10,577,580,3,
Zoology,9-HDA,18,10,607,608,1,"bee turns in to paper as its walking around, not sure if it counts"
Zoology,9-HDA,18,10,631,633,2,
Zoology,9-HDA,18,10,634,636,2,
Zoology,9-HDA,18,10,635,638,3,
Zoology,9-HDA,18,10,649,651,2,
Zoology,9-HDA,18,10,683,688,5,
Zoology,9-HDA,18,10,694,695,1,
Zoology,9-HDA,18,10,730,737,7,
Zoology,9-HDA,18,10,742,748,6,
Zoology,9-HDA,18,10,754,765,11,
Zoology,9-HDA,18,10,759,759,0,
Zoology,9-HDA,18,10,762,765,3,
Zoology,9-HDA,18,10,766,767,1,
Zoology,9-HDA,18,10,769,807,38,
Zoology,9-HDA,18,10,809,814,5,
Zoology,9-HDA,18,10,810,811,1,
Zoology,9-HDA,18,10,932,933,1,
Zoology,9-HDA,18,10,956,974,18,
Zoology,9-HDA,18,10,989,991,2,
Zoology,9-HDA,18,10,1051,1051,0,
Zoology,9-HDA,18,10,1051,1108,57,
Zoology,9-HDA,18,10,1070,1074,4,
Zoology,9-HDA,18,10,1077,1078,1,
Zoology,9-HDA,18,10,1096,1103,7,
Zoology,9-HDA,18,10,1106,1109,3,
Zoology,9-HDA,18,10,1117,1120,3,
Zoology,9-HDA,18,10,1127,1128,1,
Zoology,9-HDA,18,10,1181,1182,1,
Zoology,9-HDA,18,10,1281,1282,1,
Zoology,9-HDA,18,10,1342,1344,2,
Zoology,9-HDA,18,10,1389,1389,0,
Zoology,9-HDA,18,10,1458,1458,0,
Zoology,9-HDA,18,10,1512,1521,9,
Zoology,9-HDA,18,10,1554,1555,1,
Zoology,9-HDA,18,10,1629,1637,8,
Zoology,9-HDA,18,10,1680,1685,5,
Zoology,9-HDA,18,10,1685,1689,4,sits on apper intarracting with annother bee until 28:47
Zoology,9-HDA,18,10,1738,1743,5,
Zoology,9-HDA,18,10,1746,1747,1,
Zoology,9-HDA,18,10,1749,1749,0,
Zoology,9-HDA,18,10,1774,1776,2,
Zoology,9-HDA,18,10,1770,1774,4,
Zoology,9-HDA,18,10,1784,1788,4,bee walks over paper
Zoology,9-HDA,18,10,1129,1800,671,bee sits kind of still right next to paper
Zoology,9-HDA,19,3,20,20,0,
Zoology,9-HDA,19,3,99,99,0,
Zoology,9-HDA,19,3,146,148,2,
Zoology,9-HDA,19,3,147,150,3,
Zoology,9-HDA,19,3,177,177,0,
Zoology,9-HDA,19,3,200,207,7,
Zoology,9-HDA,19,3,215,219,4,
Zoology,9-HDA,19,3,250,252,2,
Zoology,9-HDA,19,3,266,268,2,
Zoology,9-HDA,19,3,347,347,0,
Zoology,9-HDA,19,3,375,377,2,
Zoology,9-HDA,19,3,375,377,2,
Zoology,9-HDA,19,3,521,523,2,
Zoology,9-HDA,19,3,660,663,3,
Zoology,9-HDA,19,3,1119,1119,0,
Zoology,9-HDA,19,3,1134,1138,4,
Zoology,9-HDA,19,3,1152,1152,0,
Zoology,9-HDA,19,3,1179,1186,7,
Zoology,9-HDA,19,3,1305,1310,5,
Zoology,9-HDA,19,3,1316,1316,0,
Zoology,9-HDA,19,3,1438,1438,0,
Zoology,9-HDA,19,3,1462,1467,5,
Zoology,9-HDA,19,3,1534,1536,2,
Zoology,9-HDA,19,3,1575,1576,1,
Zoology,9-HDA,19,3,1618,1618,0,
Zoology,9-HDA,19,3,1640,1640,0,
Zoology,9-HDA,19,3,1654,1655,1,
Zoology,9-HDA,19,3,1671,1674,3,
Zoology,9-HDA,23,12,0,121,121,"bee mucking about with paper sideways, not sure if it counts."
Zoology,9-HDA,23,12,29,29,0,
Zoology,9-HDA,23,12,35,37,2,
Zoology,9-HDA,23,12,54,57,3,
Zoology,9-HDA,23,12,126,127,1,
Zoology,9-HDA,23,12,141,203,62,
Zoology,9-HDA,23,12,213,217,4,
Zoology,9-HDA,23,12,237,239,2,
Zoology,9-HDA,23,12,241,243,2,
Zoology,9-HDA,23,12,258,261,3,
Zoology,9-HDA,23,12,261,264,3,
Zoology,9-HDA,23,12,288,296,8,
Zoology,9-HDA,23,12,311,318,7,
Zoology,9-HDA,23,12,340,350,10,
Zoology,9-HDA,23,12,365,370,5,
Zoology,9-HDA,23,12,375,383,8,
Zoology,9-HDA,23,12,562,579,17,bee seems to be interested - could be interrested in the other bee thst is sitting next to the paper insetad. Other bee sitting next to paper is not at all interrested in it.
Zoology,9-HDA,23,12,808,916,108,bee sits still facing paper and really close to it
Zoology,9-HDA,27,9,0,0,0,
Zoology,9-HDA,27,9,0,0,0,
Zoology,9-HDA,27,9,7,8,1,
Zoology,9-HDA,27,9,74,74,0,
Zoology,9-HDA,27,9,105,105,0,
Zoology,9-HDA,27,9,117,117,0,
Zoology,9-HDA,27,9,128,128,0,
Zoology,9-HDA,27,9,136,136,0,
Zoology,9-HDA,27,9,164,164,0,
Zoology,9-HDA,27,9,211,211,0,
Zoology,9-HDA,27,9,239,239,0,
Zoology,9-HDA,27,9,263,264,1,
Zoology,9-HDA,27,9,273,273,0,
Zoology,9-HDA,27,9,329,331,2,
Zoology,9-HDA,27,9,362,363,1,
Zoology,9-HDA,27,9,376,376,0,
Zoology,9-HDA,27,9,413,413,0,
Zoology,9-HDA,27,9,443,443,0,
Zoology,9-HDA,27,9,476,477,1,
Zoology,9-HDA,27,9,505,505,0,
Zoology,9-HDA,27,9,521,521,0,
Zoology,9-HDA,27,9,554,554,0,
Zoology,9-HDA,27,9,600,602,2,
Zoology,9-HDA,27,9,720,722,2,
Zoology,9-HDA,27,9,733,733,0,
Zoology,9-HDA,27,9,836,836,0,
Zoology,9-HDA,27,9,856,856,0,
Zoology,9-HDA,27,9,999,1e3,1,
Zoology,9-HDA,27,9,1074,1075,1,
Zoology,9-HDA,27,9,1075,1077,2,
Zoology,9-HDA,27,9,1085,1087,2,
Zoology,9-HDA,27,9,1090,1094,4,
Zoology,9-HDA,27,9,1098,1098,0,
Zoology,9-HDA,27,9,1130,1134,4,
Zoology,9-HDA,27,9,1138,1144,6,
Zoology,9-HDA,27,9,1149,1149,0,
Zoology,9-HDA,27,9,1158,1159,1,
Zoology,9-HDA,27,9,1161,1161,0,
Zoology,9-HDA,27,9,1180,1183,3,
Zoology,9-HDA,27,9,1207,1207,0,
Zoology,9-HDA,27,9,1216,1217,1,
Zoology,9-HDA,27,9,1243,1244,1,
Zoology,9-HDA,27,9,1249,1249,0,
Zoology,9-HDA,27,9,1259,1259,0,
Zoology,9-HDA,27,9,1281,1282,1,
Zoology,9-HDA,27,9,1293,1295,2,
Zoology,9-HDA,27,9,1308,1308,0,
Zoology,9-HDA,27,9,1321,1321,0,
Zoology,9-HDA,27,9,1322,1322,0,
Zoology,9-HDA,27,9,1328,1329,1,
Zoology,9-HDA,27,9,1351,1351,0,
Zoology,9-HDA,27,9,1377,1377,0,
Zoology,9-HDA,27,9,1412,1412,0,
Zoology,9-HDA,27,9,1431,1432,1,
Zoology,9-HDA,27,9,1456,1456,0,
Zoology,9-HDA,27,9,1506,1506,0,
Zoology,9-HDA,27,9,1558,1558,0,
Zoology,9-HDA,27,9,1562,1563,1,
Zoology,9-HDA,27,9,1577,1577,0,
Zoology,9-HDA,27,9,1578,1578,0,
Zoology,9-HDA,27,9,1599,1599,0,
Zoology,9-HDA,27,9,1630,1630,0,
Zoology,9-HDA,27,9,1696,1696,0,
Zoology,9-HDA,27,9,1701,1701,0,
Zoology,9-HDA,27,9,1733,1734,1,
Zoology,9-HDA,27,9,1740,1741,1,
Zoology,9-HDA,27,9,1757,1760,3,
Zoology,9-HDA,27,9,1760,1760,0,
Zoology,9-ODA,4,6,2,4,2,bee sort of sniffs from afar
Zoology,9-ODA,4,6,17,20,3,
Zoology,9-ODA,4,6,24,27,3,
Zoology,9-ODA,4,6,234,234,0,
Zoology,9-ODA,4,6,250,254,4,bee sniffs sort of without touching paper not sure if it counts
Zoology,9-ODA,4,6,267,271,4,
Zoology,9-ODA,4,6,274,277,3,
Zoology,9-ODA,4,6,320,333,13,
Zoology,9-ODA,4,6,340,350,10,bee sniffs sort of without touching paper not sure if it counts
Zoology,9-ODA,4,6,344,348,4,bee sort of sniffs from afar
Zoology,9-ODA,4,6,425,429,4,
Zoology,9-ODA,4,6,456,458,2,
Zoology,9-ODA,4,6,494,501,7,
Zoology,9-ODA,4,6,503,507,4,
Zoology,9-ODA,4,6,522,527,5,bee sort of sniffs from afar
Zoology,9-ODA,4,6,532,539,7,bee sort of sniffs from afar
Zoology,9-ODA,4,6,548,570,22,bee sort of sniffs from afar
Zoology,9-ODA,4,6,598,752,154,bee sniffs sort of without touching paper not sure if it counts
Zoology,9-ODA,4,6,749,752,3,
Zoology,9-ODA,4,6,777,792,15,
Zoology,9-ODA,4,6,781,784,3,
Zoology,9-ODA,4,6,796,798,2,
Zoology,9-ODA,4,6,800,801,1,
Zoology,9-ODA,4,6,809,810,1,
Zoology,9-ODA,4,6,836,839,3,
Zoology,9-ODA,4,6,842,843,1,
Zoology,9-ODA,4,6,858,861,3,
Zoology,9-ODA,4,6,864,866,2,
Zoology,9-ODA,4,6,879,881,2,
Zoology,9-ODA,4,6,879,890,11,
Zoology,9-ODA,4,6,893,895,2,
Zoology,9-ODA,4,6,904,905,1,
Zoology,9-ODA,4,6,905,907,2,
Zoology,9-ODA,4,6,1031,1032,1,
Zoology,9-ODA,4,6,1061,1064,3,
Zoology,9-ODA,4,6,1074,1074,0,
Zoology,9-ODA,4,6,1089,1131,42,
Zoology,9-ODA,4,6,1134,1140,6,
Zoology,9-ODA,4,6,1134,1271,137,bee sniffs sort of without touching paper not sure if it counts
Zoology,9-ODA,4,6,1173,1175,2,
Zoology,9-ODA,4,6,1239,1241,2,
Zoology,9-ODA,4,6,1250,1252,2,
Zoology,9-ODA,4,6,1272,1272,0,
Zoology,9-ODA,4,6,1327,1333,6,
Zoology,9-ODA,4,6,1337,1338,1,
Zoology,9-ODA,4,6,1339,1339,0,
Zoology,9-ODA,4,6,1340,1346,6,
Zoology,9-ODA,4,6,1358,1359,1,
Zoology,9-ODA,4,6,1359,1364,5,
Zoology,9-ODA,4,6,1365,1367,2,
Zoology,9-ODA,4,6,1384,1386,2,
Zoology,9-ODA,4,6,1386,1387,1,
Zoology,9-ODA,4,6,1398,1403,5,
Zoology,9-ODA,4,6,1404,1405,1,
Zoology,9-ODA,4,6,1410,1411,1,
Zoology,9-ODA,4,6,1414,1417,3,
Zoology,9-ODA,4,6,1418,1421,3,
Zoology,9-ODA,4,6,1427,1429,2,
Zoology,9-ODA,4,6,1433,1436,3,
Zoology,9-ODA,4,6,1437,1437,0,
Zoology,9-ODA,4,6,1477,1479,2,
Zoology,9-ODA,4,6,1480,1481,1,
Zoology,9-ODA,4,6,1482,1484,2,
Zoology,9-ODA,4,6,1486,1486,0,
Zoology,9-ODA,4,6,1498,1500,2,
Zoology,9-ODA,4,6,1528,1530,2,
Zoology,9-ODA,4,6,1536,1548,12,
Zoology,9-ODA,4,6,1548,1551,3,
Zoology,9-ODA,4,6,1551,1553,2,
Zoology,9-ODA,4,6,1558,1560,2,
Zoology,9-ODA,4,6,1567,1581,14,
Zoology,9-ODA,4,6,1583,1585,2,
Zoology,9-ODA,4,6,1592,1596,4,
Zoology,9-ODA,4,6,1599,1601,2,
Zoology,9-ODA,4,6,1609,1611,2,
Zoology,9-ODA,4,6,1642,1644,2,
Zoology,9-ODA,4,6,1645,1647,2,
Zoology,9-ODA,4,6,1648,1649,1,
Zoology,9-ODA,4,6,1649,1650,1,
Zoology,9-ODA,4,6,1651,1654,3,
Zoology,9-ODA,4,6,1655,1683,28,
Zoology,9-ODA,4,6,1659,1659,0,
Zoology,9-ODA,4,6,1689,1690,1,
Zoology,9-ODA,4,6,1706,1709,3,
Zoology,9-ODA,4,6,1720,1721,1,
Zoology,9-ODA,4,6,1720,1723,3,
Zoology,9-ODA,4,6,1728,1730,2,
Zoology,9-ODA,4,6,1759,1759,0,
Zoology,9-ODA,4,6,1767,1768,1,
Zoology,9-ODA,4,6,1770,1770,0,
Zoology,9-ODA,4,6,1794,1799,5,
Zoology,9-ODA,5,8,7,11,4,
Zoology,9-ODA,5,8,32,34,2,
Zoology,9-ODA,5,8,53,58,5,
Zoology,9-ODA,5,8,102,104,2,
Zoology,9-ODA,5,8,123,124,1,
Zoology,9-ODA,5,8,154,158,4,
Zoology,9-ODA,5,8,203,240,37,
Zoology,9-ODA,5,8,242,243,1,
Zoology,9-ODA,5,8,264,275,11,
Zoology,9-ODA,5,8,275,276,1,
Zoology,9-ODA,5,8,277,285,8,
Zoology,9-ODA,5,8,341,342,1,
Zoology,9-ODA,5,8,403,403,0,
Zoology,9-ODA,5,8,406,408,2,
Zoology,9-ODA,5,8,416,417,1,
Zoology,9-ODA,5,8,419,421,2,
Zoology,9-ODA,5,8,443,443,0,
Zoology,9-ODA,5,8,448,448,0,
Zoology,9-ODA,5,8,476,476,0,
Zoology,9-ODA,5,8,455,550,95,bee sort of sniffing from afar
Zoology,9-ODA,5,8,487,487,0,
Zoology,9-ODA,5,8,509,509,0,
Zoology,9-ODA,5,8,531,532,1,
Zoology,9-ODA,5,8,540,540,0,
Zoology,9-ODA,5,8,552,553,1,
Zoology,9-ODA,5,8,552,554,2,
Zoology,9-ODA,5,8,570,570,0,
Zoology,9-ODA,5,8,571,571,0,
Zoology,9-ODA,5,8,575,575,0,
Zoology,9-ODA,5,8,580,581,1,
Zoology,9-ODA,5,8,593,593,0,
Zoology,9-ODA,5,8,607,608,1,
Zoology,9-ODA,5,8,620,620,0,
Zoology,9-ODA,5,8,635,636,1,
Zoology,9-ODA,5,8,672,673,1,
Zoology,9-ODA,5,8,685,685,0,
Zoology,9-ODA,5,8,712,714,2,
Zoology,9-ODA,5,8,721,724,3,
Zoology,9-ODA,5,8,734,734,0,
Zoology,9-ODA,5,8,743,743,0,
Zoology,9-ODA,5,8,780,784,4,
Zoology,9-ODA,5,8,786,790,4,
Zoology,9-ODA,5,8,799,800,1,
Zoology,9-ODA,5,8,803,803,0,
Zoology,9-ODA,5,8,812,814,2,
Zoology,9-ODA,5,8,812,815,3,
Zoology,9-ODA,5,8,814,815,1,
Zoology,9-ODA,5,8,828,828,0,
Zoology,9-ODA,5,8,832,832,0,
Zoology,9-ODA,5,8,854,855,1,
Zoology,9-ODA,5,8,869,869,0,
Zoology,9-ODA,5,8,923,923,0,
Zoology,9-ODA,5,8,986,986,0,
Zoology,9-ODA,5,8,932,932,0,
Zoology,9-ODA,5,8,935,936,1,maybe sniffing
Zoology,9-ODA,5,8,958,958,0,
Zoology,9-ODA,5,8,968,968,0,
Zoology,9-ODA,5,8,997,997,0,
Zoology,9-ODA,5,8,1019,1019,0,
Zoology,9-ODA,5,8,1021,1039,18,
Zoology,9-ODA,5,8,1033,1044,11,
Zoology,9-ODA,5,8,1036,1036,0,
Zoology,9-ODA,5,8,1049,1051,2,
Zoology,9-ODA,5,8,1065,1065,0,
Zoology,9-ODA,5,8,1089,1089,0,
Zoology,9-ODA,5,8,1092,1155,63,
Zoology,9-ODA,5,8,1096,1105,9,
Zoology,9-ODA,5,8,1111,1112,1,
Zoology,9-ODA,5,8,1123,1123,0,
Zoology,9-ODA,5,8,1137,1137,0,
Zoology,9-ODA,5,8,1262,1271,9,
Zoology,9-ODA,5,8,1284,1298,14,
Zoology,9-ODA,5,8,1285,1285,0,
Zoology,9-ODA,5,8,1341,1341,0,
Zoology,9-ODA,5,8,1374,1375,1,
Zoology,9-ODA,5,8,1427,1427,0,
Zoology,9-ODA,5,8,1433,1443,10,
Zoology,9-ODA,5,8,1452,1452,0,
Zoology,9-ODA,5,8,1473,1473,0,
Zoology,9-ODA,5,8,1476,1482,6,
Zoology,9-ODA,5,8,1495,1495,0,
Zoology,9-ODA,5,8,1563,1563,0,
Zoology,9-ODA,5,8,1563,1570,7,
Zoology,9-ODA,5,8,1568,1568,0,
Zoology,9-ODA,5,8,1587,1589,2,
Zoology,9-ODA,5,8,1613,1613,0,
Zoology,9-ODA,5,8,1618,1622,4,
Zoology,9-ODA,5,8,1627,1627,0,
Zoology,9-ODA,5,8,1765,1765,0,
Zoology,9-ODA,5,8,1766,1766,0,
Zoology,9-ODA,5,8,1770,1771,1,
Zoology,9-ODA,5,8,1775,1776,1,
Zoology,9-ODA,5,8,1788,1789,1,
Zoology,9-ODA,6,11,2,2,0,
Zoology,9-ODA,6,11,2,2,0,
Zoology,9-ODA,6,11,13,14,1,
Zoology,9-ODA,6,11,25,26,1,
Zoology,9-ODA,6,11,112,112,0,
Zoology,9-ODA,6,11,131,131,0,
Zoology,9-ODA,6,11,210,218,8,
Zoology,9-ODA,6,11,215,215,0,
Zoology,9-ODA,6,11,228,230,2,
Zoology,9-ODA,6,11,235,238,3,
Zoology,9-ODA,6,11,293,295,2,
Zoology,9-ODA,6,11,308,308,0,
Zoology,9-ODA,6,11,317,317,0,
Zoology,9-ODA,6,11,331,332,1,
Zoology,9-ODA,6,11,356,356,0,
Zoology,9-ODA,6,11,402,402,0,
Zoology,9-ODA,6,11,417,417,0,
Zoology,9-ODA,6,11,449,449,0,
Zoology,9-ODA,6,11,536,536,0,maybe - seems sort of interrested in paper
Zoology,9-ODA,6,11,557,559,2,
Zoology,9-ODA,6,11,575,575,0,
Zoology,9-ODA,6,11,595,596,1,
Zoology,9-ODA,6,11,651,653,2,
Zoology,9-ODA,6,11,661,662,1,
Zoology,9-ODA,6,11,671,671,0,
Zoology,9-ODA,6,11,714,714,0,
Zoology,9-ODA,6,11,727,728,1,
Zoology,9-ODA,6,11,739,739,0,
Zoology,9-ODA,6,11,761,762,1,
Zoology,9-ODA,6,11,766,767,1,
Zoology,9-ODA,6,11,788,789,1,
Zoology,9-ODA,6,11,797,798,1,
Zoology,9-ODA,6,11,827,828,1,
Zoology,9-ODA,6,11,831,833,2,
Zoology,9-ODA,6,11,857,865,8,
Zoology,9-ODA,6,11,874,876,2,
Zoology,9-ODA,6,11,908,909,1,
Zoology,9-ODA,6,11,923,923,0,
Zoology,9-ODA,6,11,952,952,0,
Zoology,9-ODA,6,11,995,996,1,
Zoology,9-ODA,6,11,1008,1013,5,
Zoology,9-ODA,6,11,1011,1611,600,
Zoology,9-ODA,6,11,1012,1012,0,
Zoology,9-ODA,6,11,1042,1042,0,
Zoology,9-ODA,6,11,1044,1044,0,bumps in to paper as it walks past
Zoology,9-ODA,6,11,1048,1049,1,
Zoology,9-ODA,6,11,1067,1067,0,
Zoology,9-ODA,6,11,1102,1102,0,
Zoology,9-ODA,6,11,1147,1147,0,
Zoology,9-ODA,6,11,1161,1161,0,
Zoology,9-ODA,6,11,1183,1183,0,
Zoology,9-ODA,6,11,1213,1213,0,
Zoology,9-ODA,6,11,1269,1269,0,
Zoology,9-ODA,6,11,1306,1306,0,
Zoology,9-ODA,6,11,1376,1376,0,
Zoology,9-ODA,6,11,1397,1397,0,
Zoology,9-ODA,6,11,1448,1449,1,
Zoology,9-ODA,6,11,1456,1457,1,
Zoology,9-ODA,6,11,1494,1495,1,
Zoology,9-ODA,6,11,1503,1504,1,
Zoology,9-ODA,6,11,1544,1547,3,
Zoology,9-ODA,6,11,1621,1621,0,bee. sort of moves its head towatrds the paper as it brushes past it.
Zoology,9-ODA,6,11,1645,1645,0,
Zoology,9-ODA,6,11,1655,1655,0,bumps in to paper as its turning around
Zoology,9-ODA,6,11,1699,1699,0,
Zoology,9-ODA,6,11,1736,1736,0,
Zoology,9-ODA,6,11,1740,1744,4,
Zoology,9-ODA,6,11,1753,1753,0,
Zoology,9-ODA,6,11,1784,1785,1,
Zoology,9-ODA,7,3,113,117,4,
Zoology,9-ODA,7,3,142,144,2,
Zoology,9-ODA,7,3,163,164,1,
Zoology,9-ODA,7,3,169,171,2,
Zoology,9-ODA,7,3,189,190,1,
Zoology,9-ODA,7,3,330,333,3,
Zoology,9-ODA,7,3,336,337,1,
Zoology,9-ODA,7,3,339,339,0,
Zoology,9-ODA,7,3,356,356,0,
Zoology,9-ODA,7,3,415,415,0,
Zoology,9-ODA,7,3,435,438,3,
Zoology,9-ODA,7,3,462,462,0,
Zoology,9-ODA,7,3,470,475,5,
Zoology,9-ODA,7,3,512,512,0,
Zoology,9-ODA,7,3,638,638,0,
Zoology,9-ODA,7,3,745,745,0,
Zoology,9-ODA,7,3,752,765,13,
Zoology,9-ODA,7,3,785,785,0,
Zoology,9-ODA,7,3,818,818,0,
Zoology,9-ODA,7,3,827,831,4,
Zoology,9-ODA,7,3,828,829,1,
Zoology,9-ODA,7,3,884,890,6,
Zoology,9-ODA,7,3,954,957,3,
Zoology,9-ODA,7,3,979,979,0,
Zoology,9-ODA,7,3,989,990,1,
Zoology,9-ODA,7,3,1014,1014,0,
Zoology,9-ODA,7,3,1049,1049,0,
Zoology,9-ODA,7,3,1072,1072,0,
Zoology,9-ODA,7,3,1100,1106,6,
Zoology,9-ODA,7,3,1107,1112,5,
Zoology,9-ODA,7,3,1374,1375,1,
Zoology,9-ODA,7,3,1450,1451,1,
Zoology,9-ODA,7,3,1453,1454,1,
Zoology,9-ODA,7,3,1653,1654,1,
Zoology,9-ODA,7,3,1790,1790,0,
Zoology,9-ODA,8,5,16,17,1,
Zoology,9-ODA,8,5,28,28,0,
Zoology,9-ODA,8,5,111,112,1,
Zoology,9-ODA,8,5,113,114,1,
Zoology,9-ODA,8,5,141,141,0,
Zoology,9-ODA,8,5,162,166,4,
Zoology,9-ODA,8,5,182,182,0,
Zoology,9-ODA,8,5,203,208,5,"not sure if it is really sniffing, it seems to be interrested. Not actually touching."
Zoology,9-ODA,8,5,220,225,5,
Zoology,9-ODA,8,5,238,238,0,
Zoology,9-ODA,8,5,250,250,0,
Zoology,9-ODA,8,5,288,288,0,
Zoology,9-ODA,8,5,299,318,19,
Zoology,9-ODA,8,5,305,305,0,
Zoology,9-ODA,8,5,310,310,0,
Zoology,9-ODA,8,5,311,311,0,
Zoology,9-ODA,8,5,315,315,0,
Zoology,9-ODA,8,5,318,318,0,
Zoology,9-ODA,8,5,319,319,0,
Zoology,9-ODA,8,5,320,325,5,
Zoology,9-ODA,8,5,326,326,0,
Zoology,9-ODA,8,5,326,327,1,
Zoology,9-ODA,8,5,333,338,5,
Zoology,9-ODA,8,5,356,357,1,
Zoology,9-ODA,8,5,369,373,4,
Zoology,9-ODA,8,5,416,416,0,
Zoology,9-ODA,8,5,472,472,0,
Zoology,9-ODA,8,5,476,476,0,
Zoology,9-ODA,8,5,485,492,7,
Zoology,9-ODA,8,5,511,511,0,
Zoology,9-ODA,8,5,537,537,0,not super sure very fast touch
Zoology,9-ODA,8,5,545,546,1,
Zoology,9-ODA,8,5,561,563,2,
Zoology,9-ODA,8,5,570,570,0,
Zoology,9-ODA,8,5,588,588,0,
Zoology,9-ODA,8,5,638,638,0,
Zoology,9-ODA,8,5,629,633,4,there is a bee sort of interrested. Not completely sure.
Zoology,9-ODA,8,5,668,668,0,
Zoology,9-ODA,8,5,711,712,1,
Zoology,9-ODA,8,5,711,712,1,
Zoology,9-ODA,8,5,714,714,0,
Zoology,9-ODA,8,5,727,732,5,
Zoology,9-ODA,8,5,754,756,2,
Zoology,9-ODA,8,5,778,778,0,
Zoology,9-ODA,8,5,779,779,0,
Zoology,9-ODA,8,5,792,792,0,
Zoology,9-ODA,8,5,836,836,0,
Zoology,9-ODA,8,5,837,837,0,
Zoology,9-ODA,8,5,866,884,18,
Zoology,9-ODA,8,5,910,913,3,
Zoology,9-ODA,8,5,926,936,10,
Zoology,9-ODA,8,5,949,951,2,
Zoology,9-ODA,8,5,993,993,0,
Zoology,9-ODA,8,5,999,999,0,
Zoology,9-ODA,8,5,1042,1043,1,
Zoology,9-ODA,8,5,1173,1174,1,
Zoology,9-ODA,8,5,1216,1216,0,
Zoology,9-ODA,8,5,1229,1231,2,
Zoology,9-ODA,8,5,1234,1234,0,
Zoology,9-ODA,8,5,1333,1333,0,
Zoology,9-ODA,8,5,1471,1471,0,
Zoology,9-ODA,8,5,1504,1504,0,
Zoology,9-ODA,8,5,1541,1542,1,
Zoology,9-ODA,8,5,1576,1577,1,
Zoology,9-ODA,8,5,1578,1579,1,
Zoology,9-ODA,8,5,1597,1597,0,
Zoology,9-ODA,8,5,1701,1703,2,
Zoology,9-ODA,8,5,1705,1705,0,
Zoology,9-ODA,8,5,1794,1795,1,
Zoology,9-ODA,9,8,1,2,1,
Zoology,9-ODA,9,8,4,4,0,
Zoology,9-ODA,9,8,13,13,0,
Zoology,9-ODA,9,8,33,33,0,
Zoology,9-ODA,9,8,40,40,0,
Zoology,9-ODA,9,8,79,81,2,
Zoology,9-ODA,9,8,90,91,1,
Zoology,9-ODA,9,8,106,107,1,
Zoology,9-ODA,9,8,233,235,2,
Zoology,9-ODA,9,8,249,251,2,
Zoology,9-ODA,9,8,263,263,0,
Zoology,9-ODA,9,8,310,311,1,
Zoology,9-ODA,9,8,388,388,0,
Zoology,9-ODA,9,8,489,489,0,
Zoology,9-ODA,9,8,518,518,0,
Zoology,9-ODA,9,8,528,532,4,
Zoology,9-ODA,9,8,537,538,1,
Zoology,9-ODA,9,8,539,539,0,
Zoology,9-ODA,9,8,546,550,4,
Zoology,9-ODA,9,8,563,566,3,
Zoology,9-ODA,9,8,567,567,0,
Zoology,9-ODA,9,8,572,574,2,
Zoology,9-ODA,9,8,594,594,0,
Zoology,9-ODA,9,8,595,599,4,
Zoology,9-ODA,9,8,597,600,3,
Zoology,9-ODA,9,8,601,601,0,
Zoology,9-ODA,9,8,604,604,0,
Zoology,9-ODA,9,8,607,608,1,
Zoology,9-ODA,9,8,611,612,1,
Zoology,9-ODA,9,8,614,615,1,
Zoology,9-ODA,9,8,615,616,1,
Zoology,9-ODA,9,8,656,658,2,maybe - not quite touching
Zoology,9-ODA,9,8,664,666,2,
Zoology,9-ODA,9,8,692,692,0,
Zoology,9-ODA,9,8,709,715,6,not touching but seems interrested - actually touches between 14:05 and 14:12 - stays close until 14:12
Zoology,9-ODA,9,8,769,851,82,"12:57 positions away from the paper a little, 14:05 positions back towards paper 14:11 it turns away."
Zoology,9-ODA,9,8,859,861,2,
Zoology,9-ODA,9,8,865,865,0,
Zoology,9-ODA,9,8,889,897,8,not quite touching but seems interrested
Zoology,9-ODA,9,8,936,938,2,
Zoology,9-ODA,9,8,953,956,3,not touching - seems to be sniffing - really not sure
Zoology,9-ODA,9,8,958,960,2,
Zoology,9-ODA,9,8,991,992,1,
Zoology,9-ODA,9,8,1004,1007,3,
Zoology,9-ODA,9,8,1006,1008,2,
Zoology,9-ODA,9,8,1017,1018,1,
Zoology,9-ODA,9,8,1023,1028,5,
Zoology,9-ODA,9,8,1057,1057,0,
Zoology,9-ODA,9,8,1083,1084,1,
Zoology,9-ODA,9,8,1108,1109,1,
Zoology,9-ODA,9,8,1116,1116,0,
Zoology,9-ODA,9,8,1128,1348,220,bee sits still not quite facing the paper but very close to it
Zoology,9-ODA,9,8,1215,1215,0,
Zoology,9-ODA,9,8,1260,1261,1,
Zoology,9-ODA,9,8,1264,1272,8,
Zoology,9-ODA,9,8,1282,1282,0,
Zoology,9-ODA,9,8,1295,1300,5,
Zoology,9-ODA,9,8,1304,1305,1,
Zoology,9-ODA,9,8,1323,1324,1,
Zoology,9-ODA,9,8,1339,1341,2,
Zoology,9-ODA,9,8,1356,1356,0,
Zoology,9-ODA,9,8,1356,1357,1,
Zoology,9-ODA,9,8,1357,1359,2,
Zoology,9-ODA,9,8,1366,1368,2,
Zoology,9-ODA,9,8,1368,1369,1,
Zoology,9-ODA,9,8,1369,1370,1,
Zoology,9-ODA,9,8,1378,1381,3,
Zoology,9-ODA,9,8,1394,1394,0,
Zoology,9-ODA,9,8,1395,1395,0,
Zoology,9-ODA,9,8,1395,1397,2,
Zoology,9-ODA,9,8,1467,1467,0,
Zoology,9-ODA,9,8,1497,1497,0,
Zoology,9-ODA,9,8,1497,1497,0,
Zoology,9-ODA,9,8,1516,1516,0,not touching but lunges towards paper
Zoology,9-ODA,9,8,1516,1517,1,
Zoology,9-ODA,9,8,1537,1539,2,
Zoology,9-ODA,9,8,1543,1543,0,
Zoology,9-ODA,9,8,1606,1606,0,
Zoology,9-ODA,9,8,1614,1615,1,
Zoology,9-ODA,9,8,1648,1658,10,
Zoology,9-ODA,9,8,1680,1682,2,
Zoology,9-ODA,9,8,1696,1696,0,
Zoology,9-ODA,9,8,1738,1738,0,
Zoology,9-ODA,9,8,1744,1744,0,
Zoology,9-ODA,9,8,1766,1767,1,
Zoology,9-ODA,9,8,1767,1767,0,
Zoology,9-ODA,9,8,1768,1772,4,
Zoology,9-ODA,9,8,1773,1773,0,
Zoology,9-ODA,9,8,1784,1787,3,not quite touching seems to be sniffing
Zoology,9-ODA,9,8,1791,1791,0,
Zoology,9-ODA,11,3,12,12,0,
Zoology,9-ODA,11,3,51,53,2,
Zoology,9-ODA,11,3,91,95,4,
Zoology,9-ODA,11,3,105,106,1,
Zoology,9-ODA,11,3,111,119,8,
Zoology,9-ODA,11,3,121,121,0,
Zoology,9-ODA,11,3,138,141,3,
Zoology,9-ODA,11,3,176,176,0,
Zoology,9-ODA,11,3,193,202,9,
Zoology,9-ODA,11,3,136,197,61,
Zoology,9-ODA,11,3,198,198,0,
Zoology,9-ODA,11,3,196,201,5,
Zoology,9-ODA,11,3,204,275,71,bee sits still facing paper a little distance from it
Zoology,9-ODA,11,3,271,272,1,
Zoology,9-ODA,11,3,277,288,11,bee sits still facing paper a little distance from it
Zoology,9-ODA,11,3,282,283,1,
Zoology,9-ODA,11,3,352,356,4,
Zoology,9-ODA,11,3,363,364,1,
Zoology,9-ODA,11,3,398,398,0,
Zoology,9-ODA,11,3,418,419,1,
Zoology,9-ODA,11,3,439,441,2,
Zoology,9-ODA,11,3,528,528,0,
Zoology,9-ODA,11,3,568,581,13,
Zoology,9-ODA,11,3,578,579,1,
Zoology,9-ODA,11,3,584,589,5,
Zoology,9-ODA,11,3,589,589,0,
Zoology,9-ODA,11,3,595,597,2,
Zoology,9-ODA,11,3,608,622,14,
Zoology,9-ODA,11,3,610,617,7,
Zoology,9-ODA,11,3,620,622,2,
Zoology,9-ODA,11,3,630,633,3,
Zoology,9-ODA,11,3,631,631,0,
Zoology,9-ODA,11,3,638,639,1,
Zoology,9-ODA,11,3,663,668,5,
Zoology,9-ODA,11,3,741,741,0,
Zoology,9-ODA,11,3,750,751,1,
Zoology,9-ODA,11,3,807,814,7,
Zoology,9-ODA,11,3,842,843,1,
Zoology,9-ODA,11,3,857,857,0,
Zoology,9-ODA,11,3,880,880,0,
Zoology,9-ODA,11,3,890,890,0,
Zoology,9-ODA,11,3,892,894,2,
Zoology,9-ODA,11,3,895,896,1,
Zoology,9-ODA,11,3,905,907,2,
Zoology,9-ODA,11,3,943,944,1,
Zoology,9-ODA,11,3,947,947,0,
Zoology,9-ODA,11,3,972,974,2,
Zoology,9-ODA,11,3,992,995,3,
Zoology,9-ODA,11,3,999,1e3,1,
Zoology,9-ODA,11,3,1e3,1e3,0,
Zoology,9-ODA,11,3,1002,1243,241,bee sitting still facing paper
Zoology,9-ODA,11,3,1017,1017,0,
Zoology,9-ODA,11,3,1018,1018,0,
Zoology,9-ODA,11,3,1125,1126,1,
Zoology,9-ODA,11,3,1147,1147,0,
Zoology,9-ODA,11,3,1232,1234,2,
Zoology,9-ODA,11,3,1262,1263,1,
Zoology,9-ODA,11,3,1262,1266,4,
Zoology,9-ODA,11,3,1266,1266,0,
Zoology,9-ODA,11,3,1266,1267,1,
Zoology,9-ODA,11,3,1268,1273,5,
Zoology,9-ODA,11,3,1274,1275,1,
Zoology,9-ODA,11,3,1290,1291,1,
Zoology,9-ODA,11,3,1391,1391,0,
Zoology,9-ODA,11,3,1433,1433,0,
Zoology,9-ODA,11,3,1457,1458,1,
Zoology,9-ODA,11,3,1515,1515,0,
Zoology,9-ODA,11,3,1737,1739,2,sits on paper until 29:03
Zoology,9-ODA,14,8,8,11,3,
Zoology,9-ODA,14,8,129,131,2,
Zoology,9-ODA,14,8,170,171,1,
Zoology,9-ODA,14,8,231,233,2,
Zoology,9-ODA,14,8,241,241,0,think its sniffing
Zoology,9-ODA,14,8,264,268,4,
Zoology,9-ODA,14,8,288,290,2,
Zoology,9-ODA,14,8,304,308,4,
Zoology,9-ODA,14,8,305,307,2,
Zoology,9-ODA,14,8,310,313,3,
Zoology,9-ODA,14,8,350,352,2,
Zoology,9-ODA,14,8,351,351,0,
Zoology,9-ODA,14,8,356,356,0,
Zoology,9-ODA,14,8,394,395,1,
Zoology,9-ODA,14,8,433,433,0,
Zoology,9-ODA,14,8,440,442,2,
Zoology,9-ODA,14,8,492,494,2,
Zoology,9-ODA,14,8,555,556,1,
Zoology,9-ODA,14,8,561,561,0,
Zoology,9-ODA,14,8,624,625,1,
Zoology,9-ODA,14,8,649,656,7,
Zoology,9-ODA,14,8,657,657,0,
Zoology,9-ODA,14,8,683,683,0,maybe
Zoology,9-ODA,14,8,750,750,0,
Zoology,9-ODA,14,8,782,783,1,
Zoology,9-ODA,14,8,812,816,4,
Zoology,9-ODA,14,8,798,798,0,maybe
Zoology,9-ODA,14,8,874,875,1,
Zoology,9-ODA,14,8,890,893,3,
Zoology,9-ODA,14,8,957,958,1,
Zoology,9-ODA,14,8,977,980,3,
Zoology,9-ODA,14,8,1001,1001,0,
Zoology,9-ODA,14,8,1030,1034,4,
Zoology,9-ODA,14,8,1038,1038,0,
Zoology,9-ODA,14,8,1072,1074,2,
Zoology,9-ODA,14,8,1226,1231,5,
Zoology,9-ODA,14,8,1243,1246,3,
Zoology,9-ODA,14,8,1246,1249,3,
Zoology,9-ODA,14,8,1260,1260,0,
Zoology,9-ODA,14,8,1268,1269,1,
Zoology,9-ODA,14,8,1298,1299,1,maybe - seems interrested
Zoology,9-ODA,14,8,1428,1428,0,
Zoology,9-ODA,14,8,1444,1446,2,
Zoology,9-ODA,14,8,1448,1449,1,
Zoology,9-ODA,14,8,1455,1455,0,
Zoology,9-ODA,14,8,1507,1507,0,
Zoology,9-ODA,14,8,1544,1545,1,
Zoology,9-ODA,14,8,1608,1608,0,
Zoology,9-ODA,14,8,1655,1655,0,
Zoology,9-ODA,14,8,1737,1739,2,
Zoology,9-ODA,14,8,1748,1748,0,
Zoology,9-ODA,14,8,1768,1770,2,
Zoology,9-ODA,18,11,39,50,11,
Zoology,9-ODA,18,11,88,90,2,
Zoology,9-ODA,18,11,92,93,1,
Zoology,9-ODA,18,11,167,169,2,
Zoology,9-ODA,18,11,181,182,1,
Zoology,9-ODA,18,11,235,238,3,
Zoology,9-ODA,18,11,297,297,0,
Zoology,9-ODA,18,11,382,382,0,
Zoology,9-ODA,18,11,616,618,2,
Zoology,9-ODA,18,11,705,706,1,
Zoology,9-ODA,18,11,1102,1103,1,
Zoology,9-ODA,18,11,1113,1115,2,
Zoology,9-ODA,18,11,1117,1121,4,
Zoology,9-ODA,18,11,1157,1158,1,
Zoology,9-ODA,18,11,1267,1269,2,
Zoology,9-ODA,18,11,1294,1298,4,bee walks over part of the paper
Zoology,9-ODA,18,11,1359,1362,3,
Zoology,9-ODA,18,11,1362,1369,7,
Zoology,9-ODA,18,11,1439,1442,3,
Zoology,9-ODA,18,11,1448,1448,0,
Zoology,9-ODA,18,11,1627,1632,5,
Zoology,9-ODA,18,11,1646,1650,4,
Zoology,9-ODA,18,11,1662,1664,2,
Zoology,9-ODA,18,11,1716,1720,4,
Zoology,9-ODA,18,11,1748,1750,2,
Zoology,9-ODA,18,11,1791,1793,2,
Zoology,9-ODA,19,4,15,15,0,
Zoology,9-ODA,19,4,16,16,0,
Zoology,9-ODA,19,4,56,56,0,
Zoology,9-ODA,19,4,79,79,0,
Zoology,9-ODA,19,4,308,310,2,
Zoology,9-ODA,19,4,341,341,0,
Zoology,9-ODA,19,4,464,464,0,
Zoology,9-ODA,19,4,476,476,0,
Zoology,9-ODA,19,4,490,490,0,
Zoology,9-ODA,19,4,537,537,0,
Zoology,9-ODA,19,4,559,559,0,
Zoology,9-ODA,19,4,635,635,0,
Zoology,9-ODA,19,4,641,643,2,
Zoology,9-ODA,19,4,648,651,3,
Zoology,9-ODA,19,4,658,660,2,
Zoology,9-ODA,19,4,715,715,0,
Zoology,9-ODA,19,4,762,762,0,not touching paper but very interested
Zoology,9-ODA,19,4,815,816,1,
Zoology,9-ODA,19,4,915,916,1,
Zoology,9-ODA,19,4,936,936,0,
Zoology,9-ODA,19,4,1051,1051,0,
Zoology,9-ODA,19,4,1062,1062,0,
Zoology,9-ODA,19,4,1101,1105,4,
Zoology,9-ODA,19,4,1198,1198,0,
Zoology,9-ODA,19,4,1208,1208,0,
Zoology,9-ODA,23,4,1,3,2,
Zoology,9-ODA,23,4,7,11,4,
Zoology,9-ODA,23,4,9,9,0,
Zoology,9-ODA,23,4,20,21,1,
Zoology,9-ODA,23,4,21,23,2,
Zoology,9-ODA,23,4,23,30,7,
Zoology,9-ODA,23,4,32,32,0,
Zoology,9-ODA,23,4,32,39,7,
Zoology,9-ODA,23,4,62,64,2,
Zoology,9-ODA,23,4,69,70,1,
Zoology,9-ODA,23,4,71,73,2,
Zoology,9-ODA,23,4,73,73,0,
Zoology,9-ODA,23,4,109,109,0,
Zoology,9-ODA,23,4,115,117,2,
Zoology,9-ODA,23,4,117,119,2,
Zoology,9-ODA,23,4,172,174,2,
Zoology,9-ODA,23,4,191,194,3,
Zoology,9-ODA,23,4,197,198,1,
Zoology,9-ODA,23,4,210,210,0,
Zoology,9-ODA,23,4,279,290,11,
Zoology,9-ODA,23,4,290,290,0,
Zoology,9-ODA,23,4,298,311,13,
Zoology,9-ODA,23,4,326,338,12,
Zoology,9-ODA,23,4,350,350,0,
Zoology,9-ODA,23,4,350,355,5,
Zoology,9-ODA,23,4,356,356,0,
Zoology,9-ODA,23,4,366,392,26,
Zoology,9-ODA,23,4,395,395,0,
Zoology,9-ODA,23,4,423,423,0,
Zoology,9-ODA,23,4,434,434,0,
Zoology,9-ODA,23,4,440,442,2,
Zoology,9-ODA,23,4,453,457,4,
Zoology,9-ODA,23,4,461,464,3,
Zoology,9-ODA,23,4,482,482,0,
Zoology,9-ODA,23,4,501,511,10,
Zoology,9-ODA,23,4,516,522,6,bee sitting real close
Zoology,9-ODA,23,4,684,684,0,
Zoology,9-ODA,23,4,701,701,0,
Zoology,9-ODA,23,4,706,706,0,
Zoology,9-ODA,23,4,737,738,1,
Zoology,9-ODA,23,4,785,785,0,
Zoology,9-ODA,23,4,788,888,100,bee sits motionless facing the paper very close to it
Zoology,9-ODA,23,4,826,826,0,
Zoology,9-ODA,23,4,833,840,7,
Zoology,9-ODA,23,4,847,856,9,
Zoology,9-ODA,23,4,876,878,2,
Zoology,9-ODA,23,4,878,882,4,
Zoology,9-ODA,23,4,1181,1182,1,
Zoology,9-ODA,23,4,1214,1216,2,
Zoology,9-ODA,23,4,1250,1253,3,
Zoology,9-ODA,23,4,1271,1291,20,ehrfbhurbh
Zoology,9-ODA,23,4,1297,1298,1,
Zoology,9-ODA,23,4,1301,1308,7,
Zoology,9-ODA,23,4,1307,1310,3,
Zoology,9-ODA,23,4,1310,1313,3,
Zoology,9-ODA,23,4,1323,1324,1,
Zoology,9-ODA,23,4,1327,1342,15,
Zoology,9-ODA,23,4,1338,1343,5,
Zoology,9-ODA,23,4,1336,1345,9,
Zoology,9-ODA,23,4,1349,1352,3,
Zoology,9-ODA,23,4,1404,1405,1,
Zoology,9-ODA,23,4,1478,1478,0,
Zoology,9-ODA,23,4,1484,1495,11,
Zoology,9-ODA,23,4,1513,1519,6,
Zoology,9-ODA,23,4,1576,1579,3,
Zoology,9-ODA,23,4,1617,1618,1,
Zoology,9-ODA,23,4,1648,1648,0,
Zoology,9-ODA,23,4,1699,1702,3,
Zoology,9-ODA,23,4,1734,1736,2,
Zoology,9-ODA,23,4,1739,1739,0,
Zoology,9-ODA,23,4,1739,1743,4,
Zoology,9-ODA,23,4,1749,1751,2,
Zoology,9-ODA,27,5,70,72,2,
Zoology,9-ODA,27,5,77,77,0,
Zoology,9-ODA,27,5,111,112,1,
Zoology,9-ODA,27,5,129,129,0,
Zoology,9-ODA,27,5,131,136,5,
Zoology,9-ODA,27,5,162,165,3,
Zoology,9-ODA,27,5,468,470,2,
Zoology,9-ODA,27,5,527,527,0,
Zoology,9-ODA,27,5,543,544,1,
Zoology,9-ODA,27,5,554,554,0,
Zoology,9-ODA,27,5,763,764,1,
Zoology,9-ODA,27,5,775,775,0,
Zoology,9-ODA,27,5,812,813,1,
Zoology,9-ODA,27,5,838,838,0,
Zoology,9-ODA,27,5,839,839,0,
Zoology,9-ODA,27,5,846,847,1,
Zoology,9-ODA,27,5,852,855,3,
Zoology,9-ODA,27,5,861,862,1,
Zoology,9-ODA,27,5,866,866,0,
Zoology,9-ODA,27,5,867,868,1,
Zoology,9-ODA,27,5,881,881,0,
Zoology,9-ODA,27,5,892,892,0,
Zoology,9-ODA,27,5,909,910,1,
Zoology,9-ODA,27,5,917,920,3,
Zoology,9-ODA,27,5,929,929,0,
Zoology,9-ODA,27,5,949,949,0,
Zoology,9-ODA,27,5,1035,1036,1,
Zoology,9-ODA,27,5,1084,1085,1,
Zoology,9-ODA,27,5,1110,1110,0,
Zoology,9-ODA,27,5,1171,1171,0,
Zoology,9-ODA,27,5,1177,1178,1,
Zoology,9-ODA,27,5,1208,1208,0,
Zoology,9-ODA,27,5,1215,1215,0,
Zoology,9-ODA,27,5,1251,1252,1,
Zoology,9-ODA,27,5,1270,1270,0,
Zoology,9-ODA,27,5,1270,1274,4,
Zoology,9-ODA,27,5,1278,1280,2,
Zoology,9-ODA,27,5,1304,1304,0,
Zoology,9-ODA,27,5,1310,1310,0,
Zoology,9-ODA,27,5,1364,1364,0,
Zoology,9-ODA,27,5,1366,1366,0,
Zoology,9-ODA,27,5,1410,1410,0,
Zoology,9-ODA,27,5,1499,1502,3,
Zoology,9-ODA,27,5,1566,1569,3,bee walks over paper
Zoology,9-ODA,27,5,1575,1578,3,
Zoology,9-ODA,27,5,1689,1691,2,
Zoology,9-ODA,27,5,1689,1691,2,
Zoology,9-ODA,27,5,1713,1713,0,
Zoology,9-ODA,27,5,1790,1790,0,
Zoology,9-ODA,27,5,1791,1793,2,bee walks over paper but also seems interrested in it
Zoology,9-ODA,27,5,1794,1794,0,
Zoology,9-ODA,32,11,6,7,1,
Zoology,9-ODA,32,11,73,74,1,
Zoology,9-ODA,32,11,86,86,0,
Zoology,9-ODA,32,11,137,137,0,
Zoology,9-ODA,32,11,178,178,0,
Zoology,9-ODA,32,11,192,193,1,
Zoology,9-ODA,32,11,196,198,2,
Zoology,9-ODA,32,11,201,203,2,
Zoology,9-ODA,32,11,206,218,12,
Zoology,9-ODA,32,11,218,222,4,
Zoology,9-ODA,32,11,244,244,0,
Zoology,9-ODA,32,11,259,260,1,
Zoology,9-ODA,32,11,290,290,0,
Zoology,9-ODA,32,11,303,303,0,
Zoology,9-ODA,32,11,374,374,0,
Zoology,9-ODA,32,11,402,402,0,
Zoology,9-ODA,32,11,481,489,8,
Zoology,9-ODA,32,11,498,499,1,
Zoology,9-ODA,32,11,510,510,0,
Zoology,9-ODA,32,11,560,562,2,
Zoology,9-ODA,32,11,563,563,0,
Zoology,9-ODA,32,11,626,626,0,
Zoology,9-ODA,32,11,628,629,1,
Zoology,9-ODA,32,11,665,665,0,
Zoology,9-ODA,32,11,710,714,4,
Zoology,9-ODA,32,11,717,717,0,
Zoology,9-ODA,32,11,733,735,2,
Zoology,9-ODA,32,11,734,737,3,
Zoology,9-ODA,32,11,735,735,0,
Zoology,9-ODA,32,11,749,749,0,
Zoology,9-ODA,32,11,755,755,0,
Zoology,9-ODA,32,11,761,761,0,
Zoology,9-ODA,32,11,805,807,2,
Zoology,9-ODA,32,11,842,843,1,
Zoology,9-ODA,32,11,860,860,0,
Zoology,9-ODA,32,11,870,870,0,
Zoology,9-ODA,32,11,875,876,1,
Zoology,9-ODA,32,11,898,898,0,
Zoology,9-ODA,32,11,901,903,2,
Zoology,9-ODA,32,11,902,903,1,
Zoology,9-ODA,32,11,922,922,0,
Zoology,9-ODA,32,11,937,937,0,
Zoology,9-ODA,32,11,945,945,0,
Zoology,9-ODA,32,11,955,955,0,
Zoology,9-ODA,32,11,959,959,0,
Zoology,9-ODA,32,11,986,986,0,
Zoology,9-ODA,32,11,989,989,0,
Zoology,9-ODA,32,11,1016,1016,0,
Zoology,9-ODA,32,11,1038,1040,2,
Zoology,9-ODA,32,11,1121,1121,0,
Zoology,9-ODA,32,11,1158,1158,0,
Zoology,9-ODA,32,11,1174,1174,0,
Zoology,9-ODA,32,11,1183,1186,3,
Zoology,9-ODA,32,11,1225,1226,1,
Zoology,9-ODA,32,11,1240,1240,0,
Zoology,9-ODA,32,11,1288,1290,2,
Zoology,9-ODA,32,11,1510,1510,0,
Zoology,9-ODA,32,11,1568,1568,0,
Zoology,9-ODA,32,11,1675,1675,0,
Zoology,9-ODA,32,11,1713,1719,6,
Zoology,HOB and HVA,4,8,28,33,5,
Zoology,HOB and HVA,4,8,51,58,7,
Zoology,HOB and HVA,4,8,117,120,3,
Zoology,HOB and HVA,4,8,156,157,1,
Zoology,HOB and HVA,4,8,157,158,1,
Zoology,HOB and HVA,4,8,179,182,3,
Zoology,HOB and HVA,4,8,204,205,1,
Zoology,HOB and HVA,4,8,205,209,4,
Zoology,HOB and HVA,4,8,231,353,122,
Zoology,HOB and HVA,4,8,265,266,1,
Zoology,HOB and HVA,4,8,268,268,0,
Zoology,HOB and HVA,4,8,270,270,0,
Zoology,HOB and HVA,4,8,279,279,0,
Zoology,HOB and HVA,4,8,292,292,0,
Zoology,HOB and HVA,4,8,322,324,2,
Zoology,HOB and HVA,4,8,344,345,1,
Zoology,HOB and HVA,4,8,492,492,0,
Zoology,HOB and HVA,4,8,496,499,3,
Zoology,HOB and HVA,4,8,600,602,2,
Zoology,HOB and HVA,4,8,604,606,2,
Zoology,HOB and HVA,4,8,615,617,2,
Zoology,HOB and HVA,4,8,867,869,2,
Zoology,HOB and HVA,4,8,875,879,4,
Zoology,HOB and HVA,4,8,961,961,0,
Zoology,HOB and HVA,4,8,1019,1020,1,
Zoology,HOB and HVA,4,8,1019,1020,1,
Zoology,HOB and HVA,4,8,1035,1036,1,
Zoology,HOB and HVA,4,8,1056,1057,1,
Zoology,HOB and HVA,4,8,1081,1081,0,
Zoology,HOB and HVA,4,8,1103,1104,1,
Zoology,HOB and HVA,4,8,1153,1154,1,
Zoology,HOB and HVA,4,8,1163,1164,1,
Zoology,HOB and HVA,4,8,1173,1187,14,
Zoology,HOB and HVA,4,8,1175,1176,1,
Zoology,HOB and HVA,4,8,1178,1181,3,
Zoology,HOB and HVA,4,8,1210,1216,6,
Zoology,HOB and HVA,4,8,1216,1218,2,
Zoology,HOB and HVA,4,8,1229,1229,0,
Zoology,HOB and HVA,4,8,1242,1243,1,
Zoology,HOB and HVA,4,8,1255,1256,1,
Zoology,HOB and HVA,4,8,1273,1273,0,
Zoology,HOB and HVA,4,8,1292,1295,3,
Zoology,HOB and HVA,4,8,1302,1302,0,
Zoology,HOB and HVA,4,8,1362,1368,6,
Zoology,HOB and HVA,4,8,1375,1380,5,
Zoology,HOB and HVA,4,8,1400,1403,3,
Zoology,HOB and HVA,4,8,1405,1405,0,
Zoology,HOB and HVA,4,8,1417,1421,4,
Zoology,HOB and HVA,4,8,1435,1435,0,
Zoology,HOB and HVA,4,8,1443,1444,1,
Zoology,HOB and HVA,4,8,1470,1472,2,
Zoology,HOB and HVA,4,8,1492,1498,6,maybe sniffing
Zoology,HOB and HVA,4,8,1503,1505,2,
Zoology,HOB and HVA,4,8,1531,1532,1,
Zoology,HOB and HVA,4,8,1541,1542,1,
Zoology,HOB and HVA,4,8,1543,1544,1,
Zoology,HOB and HVA,4,8,1550,1567,17,
Zoology,HOB and HVA,4,8,1564,1564,0,
Zoology,HOB and HVA,4,8,1565,1566,1,
Zoology,HOB and HVA,4,8,1567,1567,0,
Zoology,HOB and HVA,4,8,1588,1588,0,
Zoology,HOB and HVA,4,8,1605,1609,4,
Zoology,HOB and HVA,4,8,1620,1620,0,
Zoology,HOB and HVA,4,8,1636,1637,1,
Zoology,HOB and HVA,4,8,1644,1645,1,
Zoology,HOB and HVA,4,8,1658,1708,50,
Zoology,HOB and HVA,4,8,1664,1664,0,
Zoology,HOB and HVA,4,8,1685,1688,3,
Zoology,HOB and HVA,4,8,1709,1711,2,
Zoology,HOB and HVA,4,8,1779,1780,1,
Zoology,HOB and HVA,5,3,8,8,0,
Zoology,HOB and HVA,5,3,52,53,1,
Zoology,HOB and HVA,5,3,104,105,1,
Zoology,HOB and HVA,5,3,152,154,2,
Zoology,HOB and HVA,5,3,195,195,0,
Zoology,HOB and HVA,5,3,267,271,4,
Zoology,HOB and HVA,5,3,342,342,0,
Zoology,HOB and HVA,5,3,368,368,0,
Zoology,HOB and HVA,5,3,371,372,1,
Zoology,HOB and HVA,5,3,389,389,0,
Zoology,HOB and HVA,5,3,473,473,0,
Zoology,HOB and HVA,5,3,491,491,0,
Zoology,HOB and HVA,5,3,540,542,2,
Zoology,HOB and HVA,5,3,659,661,2,
Zoology,HOB and HVA,5,3,690,692,2,
Zoology,HOB and HVA,5,3,699,699,0,
Zoology,HOB and HVA,5,3,707,707,0,
Zoology,HOB and HVA,5,3,710,710,0,
Zoology,HOB and HVA,5,3,765,767,2,
Zoology,HOB and HVA,5,3,830,830,0,
Zoology,HOB and HVA,5,3,860,861,1,
Zoology,HOB and HVA,5,3,906,907,1,
Zoology,HOB and HVA,5,3,928,928,0,
Zoology,HOB and HVA,5,3,1038,1038,0,
Zoology,HOB and HVA,5,3,1052,1054,2,
Zoology,HOB and HVA,5,3,1057,1057,0,
Zoology,HOB and HVA,5,3,1095,1096,1,
Zoology,HOB and HVA,5,3,1154,1154,0,
Zoology,HOB and HVA,5,3,1158,1159,1,
Zoology,HOB and HVA,5,3,1175,1175,0,
Zoology,HOB and HVA,5,3,1247,1248,1,
Zoology,HOB and HVA,5,3,1261,1264,3,
Zoology,HOB and HVA,5,3,1351,1352,1,
Zoology,HOB and HVA,5,3,1382,1383,1,
Zoology,HOB and HVA,5,3,1455,1456,1,
Zoology,HOB and HVA,5,3,1466,1467,1,
Zoology,HOB and HVA,5,3,1512,1512,0,
Zoology,HOB and HVA,5,3,1527,1528,1,
Zoology,HOB and HVA,5,3,1530,1531,1,
Zoology,HOB and HVA,5,3,1546,1549,3,
Zoology,HOB and HVA,5,3,1591,1591,0,
Zoology,HOB and HVA,5,3,1674,1685,11,
Zoology,HOB and HVA,5,3,1702,1703,1,
Zoology,HOB and HVA,5,3,1705,1705,0,
Zoology,HOB and HVA,5,3,1752,1753,1,
Zoology,HOB and HVA,5,3,1764,1765,1,
Zoology,HOB and HVA,6,9,43,50,7,
Zoology,HOB and HVA,6,9,104,104,0,
Zoology,HOB and HVA,6,9,154,154,0,
Zoology,HOB and HVA,6,9,161,162,1,
Zoology,HOB and HVA,6,9,166,167,1,
Zoology,HOB and HVA,6,9,183,184,1,
Zoology,HOB and HVA,6,9,193,194,1,
Zoology,HOB and HVA,6,9,206,207,1,
Zoology,HOB and HVA,6,9,249,251,2,
Zoology,HOB and HVA,6,9,291,295,4,
Zoology,HOB and HVA,6,9,294,294,0,
Zoology,HOB and HVA,6,9,298,299,1,
Zoology,HOB and HVA,6,9,367,382,15,
Zoology,HOB and HVA,6,9,386,387,1,
Zoology,HOB and HVA,6,9,397,398,1,
Zoology,HOB and HVA,6,9,418,424,6,
Zoology,HOB and HVA,6,9,432,432,0,maybe
Zoology,HOB and HVA,6,9,434,434,0,maybe
Zoology,HOB and HVA,6,9,439,440,1,
Zoology,HOB and HVA,6,9,478,478,0,
Zoology,HOB and HVA,6,9,502,502,0,
Zoology,HOB and HVA,6,9,576,581,5,
Zoology,HOB and HVA,6,9,625,627,2,
Zoology,HOB and HVA,6,9,640,645,5,
Zoology,HOB and HVA,6,9,652,654,2,
Zoology,HOB and HVA,6,9,668,671,3,
Zoology,HOB and HVA,6,9,710,716,6,
Zoology,HOB and HVA,6,9,711,712,1,
Zoology,HOB and HVA,6,9,725,726,1,
Zoology,HOB and HVA,6,9,765,765,0,
Zoology,HOB and HVA,6,9,803,804,1,bee walks in to the paper
Zoology,HOB and HVA,6,9,822,823,1,
Zoology,HOB and HVA,6,9,886,889,3,
Zoology,HOB and HVA,6,9,898,898,0,
Zoology,HOB and HVA,6,9,983,992,9,
Zoology,HOB and HVA,6,9,1027,1028,1,
Zoology,HOB and HVA,6,9,1032,1032,0,quick bump
Zoology,HOB and HVA,6,9,1056,1057,1,
Zoology,HOB and HVA,6,9,1091,1092,1,
Zoology,HOB and HVA,6,9,1109,1110,1,
Zoology,HOB and HVA,6,9,1121,1126,5,
Zoology,HOB and HVA,6,9,1125,1125,0,
Zoology,HOB and HVA,6,9,1141,1142,1,
Zoology,HOB and HVA,6,9,1169,1169,0,
Zoology,HOB and HVA,6,9,1176,1199,23,
Zoology,HOB and HVA,6,9,1205,1205,0,
Zoology,HOB and HVA,6,9,1219,1220,1,
Zoology,HOB and HVA,6,9,1242,1243,1,
Zoology,HOB and HVA,6,9,1265,1265,0,
Zoology,HOB and HVA,6,9,1301,1303,2,
Zoology,HOB and HVA,6,9,1309,1309,0,
Zoology,HOB and HVA,6,9,1350,1350,0,
Zoology,HOB and HVA,6,9,1409,1411,2,
Zoology,HOB and HVA,6,9,1419,1421,2,
Zoology,HOB and HVA,6,9,1437,1438,1,
Zoology,HOB and HVA,6,9,1477,1478,1,
Zoology,HOB and HVA,6,9,1479,1484,5,
Zoology,HOB and HVA,6,9,1519,1521,2,
Zoology,HOB and HVA,6,9,1614,1615,1,
Zoology,HOB and HVA,6,9,1675,1676,1,
Zoology,HOB and HVA,6,9,1683,1685,2,
Zoology,HOB and HVA,6,9,1733,1734,1,
Zoology,HOB and HVA,7,9,6,8,2,
Zoology,HOB and HVA,7,9,23,25,2,
Zoology,HOB and HVA,7,9,26,27,1,
Zoology,HOB and HVA,7,9,51,53,2,bee walks over paper
Zoology,HOB and HVA,7,9,65,67,2,bee walks over paper
Zoology,HOB and HVA,7,9,91,93,2,
Zoology,HOB and HVA,7,9,94,95,1,
Zoology,HOB and HVA,7,9,101,101,0,
Zoology,HOB and HVA,7,9,103,103,0,
Zoology,HOB and HVA,7,9,107,108,1,
Zoology,HOB and HVA,7,9,111,114,3,
Zoology,HOB and HVA,7,9,154,168,14,
Zoology,HOB and HVA,7,9,173,174,1,
Zoology,HOB and HVA,7,9,185,187,2,
Zoology,HOB and HVA,7,9,188,190,2,
Zoology,HOB and HVA,7,9,199,199,0,
Zoology,HOB and HVA,7,9,209,209,0,
Zoology,HOB and HVA,7,9,232,233,1,bee walks over paper
Zoology,HOB and HVA,7,9,238,239,1,
Zoology,HOB and HVA,7,9,259,259,0,
Zoology,HOB and HVA,7,9,261,262,1,
Zoology,HOB and HVA,7,9,270,271,1,
Zoology,HOB and HVA,7,9,329,330,1,
Zoology,HOB and HVA,7,9,334,340,6,
Zoology,HOB and HVA,7,9,340,341,1,
Zoology,HOB and HVA,7,9,357,365,8,
Zoology,HOB and HVA,7,9,367,369,2,
Zoology,HOB and HVA,7,9,401,402,1,
Zoology,HOB and HVA,7,9,404,405,1,
Zoology,HOB and HVA,7,9,416,417,1,
Zoology,HOB and HVA,7,9,417,418,1,
Zoology,HOB and HVA,7,9,429,439,10,
Zoology,HOB and HVA,7,9,447,448,1,
Zoology,HOB and HVA,7,9,452,453,1,
Zoology,HOB and HVA,7,9,473,474,1,
Zoology,HOB and HVA,7,9,475,477,2,
Zoology,HOB and HVA,7,9,494,495,1,
Zoology,HOB and HVA,7,9,498,500,2,
Zoology,HOB and HVA,7,9,508,508,0,bee walks in to paper
Zoology,HOB and HVA,7,9,511,511,0,
Zoology,HOB and HVA,7,9,515,516,1,
Zoology,HOB and HVA,7,9,518,521,3,
Zoology,HOB and HVA,7,9,522,522,0,
Zoology,HOB and HVA,7,9,524,527,3,
Zoology,HOB and HVA,7,9,539,546,7,
Zoology,HOB and HVA,7,9,545,545,0,
Zoology,HOB and HVA,7,9,547,547,0,
Zoology,HOB and HVA,7,9,549,549,0,
Zoology,HOB and HVA,7,9,552,556,4,
Zoology,HOB and HVA,7,9,556,557,1,
Zoology,HOB and HVA,7,9,568,569,1,
Zoology,HOB and HVA,7,9,577,582,5,
Zoology,HOB and HVA,7,9,571,572,1,
Zoology,HOB and HVA,7,9,574,574,0,
Zoology,HOB and HVA,7,9,572,572,0,
Zoology,HOB and HVA,7,9,580,587,7,
Zoology,HOB and HVA,7,9,590,591,1,
Zoology,HOB and HVA,7,9,631,631,0,
Zoology,HOB and HVA,7,9,636,636,0,
Zoology,HOB and HVA,7,9,639,639,0,
Zoology,HOB and HVA,7,9,648,649,1,
Zoology,HOB and HVA,7,9,663,664,1,
Zoology,HOB and HVA,7,9,686,688,2,
Zoology,HOB and HVA,7,9,691,693,2,
Zoology,HOB and HVA,7,9,697,698,1,
Zoology,HOB and HVA,7,9,723,724,1,
Zoology,HOB and HVA,7,9,759,759,0,
Zoology,HOB and HVA,7,9,761,761,0,
Zoology,HOB and HVA,7,9,763,763,0,
Zoology,HOB and HVA,7,9,806,814,8,
Zoology,HOB and HVA,7,9,811,812,1,
Zoology,HOB and HVA,7,9,816,818,2,
Zoology,HOB and HVA,7,9,823,825,2,
Zoology,HOB and HVA,7,9,835,835,0,
Zoology,HOB and HVA,7,9,851,853,2,
Zoology,HOB and HVA,7,9,878,878,0,
Zoology,HOB and HVA,7,9,895,895,0,
Zoology,HOB and HVA,7,9,966,973,7,
Zoology,HOB and HVA,7,9,978,979,1,
Zoology,HOB and HVA,7,9,989,996,7,
Zoology,HOB and HVA,7,9,995,997,2,
Zoology,HOB and HVA,7,9,998,1e3,2,
Zoology,HOB and HVA,7,9,1001,1001,0,
Zoology,HOB and HVA,7,9,1011,1013,2,
Zoology,HOB and HVA,7,9,1011,1017,6,
Zoology,HOB and HVA,7,9,1019,1022,3,
Zoology,HOB and HVA,7,9,1019,1020,1,
Zoology,HOB and HVA,7,9,1022,1023,1,
Zoology,HOB and HVA,7,9,1030,1031,1,
Zoology,HOB and HVA,7,9,1057,1058,1,
Zoology,HOB and HVA,7,9,1120,1136,16,
Zoology,HOB and HVA,7,9,1137,1139,2,
Zoology,HOB and HVA,7,9,1139,1139,0,
Zoology,HOB and HVA,7,9,1139,1143,4,
Zoology,HOB and HVA,7,9,1157,1157,0,
Zoology,HOB and HVA,7,9,1171,1173,2,
Zoology,HOB and HVA,7,9,1199,1199,0,
Zoology,HOB and HVA,7,9,1206,1206,0,
Zoology,HOB and HVA,7,9,1220,1220,0,sort of bumps in to paper
Zoology,HOB and HVA,7,9,1228,1229,1,
Zoology,HOB and HVA,7,9,1231,1232,1,
Zoology,HOB and HVA,7,9,1259,1265,6,
Zoology,HOB and HVA,7,9,1268,1269,1,
Zoology,HOB and HVA,7,9,1298,1299,1,
Zoology,HOB and HVA,7,9,1304,1304,0,
Zoology,HOB and HVA,7,9,1335,1335,0,
Zoology,HOB and HVA,7,9,1336,1341,5,
Zoology,HOB and HVA,7,9,1350,1350,0,
Zoology,HOB and HVA,7,9,1375,1375,0,
Zoology,HOB and HVA,7,9,1378,1381,3,
Zoology,HOB and HVA,7,9,1388,1388,0,
Zoology,HOB and HVA,7,9,1391,1395,4,
Zoology,HOB and HVA,7,9,1393,1393,0,
Zoology,HOB and HVA,7,9,1402,1402,0,
Zoology,HOB and HVA,7,9,1404,1407,3,
Zoology,HOB and HVA,7,9,1409,1409,0,
Zoology,HOB and HVA,7,9,1411,1412,1,
Zoology,HOB and HVA,7,9,1413,1413,0,
Zoology,HOB and HVA,7,9,1424,1430,6,
Zoology,HOB and HVA,7,9,1454,1454,0,
Zoology,HOB and HVA,7,9,1467,1469,2,
Zoology,HOB and HVA,7,9,1511,1512,1,
Zoology,HOB and HVA,7,9,1521,1521,0,
Zoology,HOB and HVA,7,9,1527,1527,0,
Zoology,HOB and HVA,7,9,1530,1537,7,
Zoology,HOB and HVA,7,9,1547,1561,14,bee sits still next to paper
Zoology,HOB and HVA,7,9,1566,1567,1,
Zoology,HOB and HVA,7,9,1564,1588,24,
Zoology,HOB and HVA,7,9,1596,1597,1,
Zoology,HOB and HVA,7,9,1610,1613,3,
Zoology,HOB and HVA,7,9,1645,1645,0,
Zoology,HOB and HVA,7,9,1671,1687,16,bee sits still near paper
Zoology,HOB and HVA,7,9,1717,1722,5,
Zoology,HOB and HVA,7,9,1735,1735,0,
Zoology,HOB and HVA,7,9,1740,1742,2,
Zoology,HOB and HVA,7,9,1740,1744,4,
Zoology,HOB and HVA,7,9,1746,1748,2,
Zoology,HOB and HVA,7,9,1777,1778,1,
Zoology,HOB and HVA,8,2,4,4,0,
Zoology,HOB and HVA,8,2,15,15,0,
Zoology,HOB and HVA,8,2,30,31,1,
Zoology,HOB and HVA,8,2,125,126,1,
Zoology,HOB and HVA,8,2,163,163,0,
Zoology,HOB and HVA,8,2,192,192,0,Not very sure - quick touch
Zoology,HOB and HVA,8,2,319,325,6,
Zoology,HOB and HVA,8,2,331,353,22,
Zoology,HOB and HVA,8,2,348,349,1,
Zoology,HOB and HVA,8,2,371,372,1,
Zoology,HOB and HVA,8,2,387,387,0,
Zoology,HOB and HVA,8,2,405,406,1,
Zoology,HOB and HVA,8,2,408,409,1,
Zoology,HOB and HVA,8,2,426,426,0,
Zoology,HOB and HVA,8,2,429,429,0,
Zoology,HOB and HVA,8,2,486,487,1,
Zoology,HOB and HVA,8,2,490,494,4,
Zoology,HOB and HVA,8,2,514,514,0,
Zoology,HOB and HVA,8,2,635,635,0,
Zoology,HOB and HVA,8,2,649,651,2,
Zoology,HOB and HVA,8,2,666,666,0,
Zoology,HOB and HVA,8,2,724,724,0,
Zoology,HOB and HVA,8,2,735,736,1,
Zoology,HOB and HVA,8,2,744,744,0,
Zoology,HOB and HVA,8,2,755,755,0,
Zoology,HOB and HVA,8,2,759,759,0,
Zoology,HOB and HVA,8,2,770,770,0,maybe fast touch
Zoology,HOB and HVA,8,2,793,793,0,
Zoology,HOB and HVA,8,2,802,803,1,
Zoology,HOB and HVA,8,2,828,838,10,
Zoology,HOB and HVA,8,2,868,868,0,
Zoology,HOB and HVA,8,2,868,868,0,
Zoology,HOB and HVA,8,2,868,878,10,
Zoology,HOB and HVA,8,2,904,906,2,
Zoology,HOB and HVA,8,2,908,912,4,
Zoology,HOB and HVA,8,2,914,914,0,
Zoology,HOB and HVA,8,2,932,936,4,bee brushes against paper - not really sniffing
Zoology,HOB and HVA,8,2,983,983,0,
Zoology,HOB and HVA,8,2,1024,1024,0,
Zoology,HOB and HVA,8,2,1044,1045,1,
Zoology,HOB and HVA,8,2,1047,1047,0,
Zoology,HOB and HVA,8,2,1056,1057,1,
Zoology,HOB and HVA,8,2,1075,1075,0,maybe not really sniffing but does touch paper
Zoology,HOB and HVA,8,2,1117,1117,0,
Zoology,HOB and HVA,8,2,1129,1130,1,
Zoology,HOB and HVA,8,2,1146,1146,0,
Zoology,HOB and HVA,8,2,1187,1189,2,
Zoology,HOB and HVA,8,2,1197,1199,2,
Zoology,HOB and HVA,8,2,1200,1204,4,
Zoology,HOB and HVA,8,2,1211,1211,0,
Zoology,HOB and HVA,8,2,1298,1298,0,maybe quick sniff as it walks by
Zoology,HOB and HVA,8,2,1311,1312,1,
Zoology,HOB and HVA,8,2,1322,1322,0,
Zoology,HOB and HVA,8,2,1343,1344,1,
Zoology,HOB and HVA,8,2,1343,1345,2,
Zoology,HOB and HVA,8,2,1369,1369,0,
Zoology,HOB and HVA,8,2,1447,1448,1,
Zoology,HOB and HVA,8,2,1516,1516,0,
Zoology,HOB and HVA,8,2,1517,1519,2,
Zoology,HOB and HVA,8,2,1538,1538,0,
Zoology,HOB and HVA,8,2,1538,1538,0,
Zoology,HOB and HVA,8,2,1541,1541,0,
Zoology,HOB and HVA,8,2,1635,1635,0,maybe - not quite touching
Zoology,HOB and HVA,8,2,1669,1670,1,
Zoology,HOB and HVA,8,2,1676,1677,1,
Zoology,HOB and HVA,8,2,1683,1685,2,
Zoology,HOB and HVA,8,2,1701,1701,0,maybe - not really sniffing but it does bump in to paper
Zoology,HOB and HVA,8,2,1736,1738,2,
Zoology,HOB and HVA,8,2,1788,1789,1,
Zoology,HOB and HVA,9,3,21,21,0,
Zoology,HOB and HVA,9,3,63,64,1,
Zoology,HOB and HVA,9,3,70,73,3,
Zoology,HOB and HVA,9,3,78,79,1,
Zoology,HOB and HVA,9,3,100,105,5,
Zoology,HOB and HVA,9,3,177,177,0,
Zoology,HOB and HVA,9,3,197,197,0,
Zoology,HOB and HVA,9,3,215,216,1,
Zoology,HOB and HVA,9,3,284,284,0,
Zoology,HOB and HVA,9,3,309,312,3,
Zoology,HOB and HVA,9,3,322,326,4,
Zoology,HOB and HVA,9,3,336,336,0,very fast touch - maybe doesn't count
Zoology,HOB and HVA,9,3,355,356,1,
Zoology,HOB and HVA,9,3,374,374,0,
Zoology,HOB and HVA,9,3,490,494,4,
Zoology,HOB and HVA,9,3,492,493,1,
Zoology,HOB and HVA,9,3,542,542,0,
Zoology,HOB and HVA,9,3,683,683,0,
Zoology,HOB and HVA,9,3,746,746,0,
Zoology,HOB and HVA,9,3,763,765,2,
Zoology,HOB and HVA,9,3,782,782,0,
Zoology,HOB and HVA,9,3,793,794,1,
Zoology,HOB and HVA,9,3,821,821,0,very fast touch - maybe doesn't count
Zoology,HOB and HVA,9,3,1026,1030,4,
Zoology,HOB and HVA,9,3,1036,1037,1,
Zoology,HOB and HVA,9,3,1122,1125,3,
Zoology,HOB and HVA,9,3,1127,1129,2,
Zoology,HOB and HVA,9,3,1174,1175,1,
Zoology,HOB and HVA,9,3,1291,1292,1,
Zoology,HOB and HVA,9,3,1294,1295,1,
Zoology,HOB and HVA,9,3,1378,1378,0,
Zoology,HOB and HVA,9,3,1388,1388,0,
Zoology,HOB and HVA,9,3,1467,1467,0,
Zoology,HOB and HVA,9,3,1504,1504,0,very fast touch - maybe doesn't count
Zoology,HOB and HVA,9,3,1558,1558,0,
Zoology,HOB and HVA,9,3,1562,1562,0,
Zoology,HOB and HVA,9,3,1756,1758,2,
Zoology,HOB and HVA,11,1,72,73,1,
Zoology,HOB and HVA,11,1,79,79,0,
Zoology,HOB and HVA,11,1,95,97,2,
Zoology,HOB and HVA,11,1,148,148,0,
Zoology,HOB and HVA,11,1,165,166,1,
Zoology,HOB and HVA,11,1,183,185,2,
Zoology,HOB and HVA,11,1,196,200,4,
Zoology,HOB and HVA,11,1,203,203,0,
Zoology,HOB and HVA,11,1,205,209,4,
Zoology,HOB and HVA,11,1,211,212,1,
Zoology,HOB and HVA,11,1,340,340,0,
Zoology,HOB and HVA,11,1,342,343,1,
Zoology,HOB and HVA,11,1,355,357,2,
Zoology,HOB and HVA,11,1,430,430,0,
Zoology,HOB and HVA,11,1,456,456,0,
Zoology,HOB and HVA,11,1,474,474,0,
Zoology,HOB and HVA,11,1,478,478,0,
Zoology,HOB and HVA,11,1,479,481,2,
Zoology,HOB and HVA,11,1,547,552,5,
Zoology,HOB and HVA,11,1,553,557,4,
Zoology,HOB and HVA,11,1,574,574,0,"maybe, not really touching just interrested"
Zoology,HOB and HVA,11,1,587,588,1,
Zoology,HOB and HVA,11,1,652,666,14,
Zoology,HOB and HVA,11,1,678,678,0,"maybe, not really touching just interrested"
Zoology,HOB and HVA,11,1,733,733,0,
Zoology,HOB and HVA,11,1,741,742,1,
Zoology,HOB and HVA,11,1,743,745,2,
Zoology,HOB and HVA,11,1,787,789,2,
Zoology,HOB and HVA,11,1,800,800,0,
Zoology,HOB and HVA,11,1,809,811,2,
Zoology,HOB and HVA,11,1,835,835,0,
Zoology,HOB and HVA,11,1,848,849,1,
Zoology,HOB and HVA,11,1,850,852,2,
Zoology,HOB and HVA,11,1,863,863,0,
Zoology,HOB and HVA,11,1,959,961,2,
Zoology,HOB and HVA,11,1,964,965,1,
Zoology,HOB and HVA,11,1,968,968,0,
Zoology,HOB and HVA,11,1,975,975,0,
Zoology,HOB and HVA,11,1,997,997,0,
Zoology,HOB and HVA,11,1,1010,1011,1,
Zoology,HOB and HVA,11,1,1053,1053,0,
Zoology,HOB and HVA,11,1,1052,1052,0,
Zoology,HOB and HVA,11,1,1070,1070,0,
Zoology,HOB and HVA,11,1,1079,1079,0,
Zoology,HOB and HVA,11,1,1083,1083,0,
Zoology,HOB and HVA,11,1,1091,1092,1,bee gets pushed in to paper
Zoology,HOB and HVA,11,1,1098,1098,0,
Zoology,HOB and HVA,11,1,1102,1114,12,be sniffs then sits on paper (18:25 - end of sniff)
Zoology,HOB and HVA,11,1,1121,1122,1,
Zoology,HOB and HVA,11,1,1184,1195,11,
Zoology,HOB and HVA,11,1,1190,1190,0,
Zoology,HOB and HVA,11,1,1199,1200,1,
Zoology,HOB and HVA,11,1,1415,1415,0,
Zoology,HOB and HVA,11,1,1440,1440,0,
Zoology,HOB and HVA,11,1,1484,1485,1,
Zoology,HOB and HVA,11,1,1494,1494,0,
Zoology,HOB and HVA,11,1,1503,1504,1,
Zoology,HOB and HVA,11,1,1514,1514,0,
Zoology,HOB and HVA,11,1,1522,1523,1,
Zoology,HOB and HVA,11,1,1537,1538,1,
Zoology,HOB and HVA,11,1,1558,1558,0,
Zoology,HOB and HVA,11,1,1568,1569,1,
Zoology,HOB and HVA,11,1,1575,1577,2,
Zoology,HOB and HVA,11,1,1588,1588,0,
Zoology,HOB and HVA,11,1,1594,1595,1,
Zoology,HOB and HVA,11,1,1599,1599,0,
Zoology,HOB and HVA,11,1,1610,1611,1,
Zoology,HOB and HVA,11,1,1629,1631,2,
Zoology,HOB and HVA,11,1,1666,1668,2,
Zoology,HOB and HVA,11,1,1668,1669,1,
Zoology,HOB and HVA,11,1,1740,1740,0,
Zoology,HOB and HVA,11,1,1772,1772,0,
Zoology,HOB and HVA,14,12,9,9,0,bee sort of very quickly touches as it walks past
Zoology,HOB and HVA,14,12,71,73,2,
Zoology,HOB and HVA,14,12,126,127,1,
Zoology,HOB and HVA,14,12,138,138,0,
Zoology,HOB and HVA,14,12,167,170,3,
Zoology,HOB and HVA,14,12,246,246,0,
Zoology,HOB and HVA,14,12,255,256,1,
Zoology,HOB and HVA,14,12,277,277,0,
Zoology,HOB and HVA,14,12,278,280,2,
Zoology,HOB and HVA,14,12,371,371,0,
Zoology,HOB and HVA,14,12,391,392,1,
Zoology,HOB and HVA,14,12,432,434,2,
Zoology,HOB and HVA,14,12,455,456,1,
Zoology,HOB and HVA,14,12,479,480,1,
Zoology,HOB and HVA,14,12,560,562,2,
Zoology,HOB and HVA,14,12,841,841,0,
Zoology,HOB and HVA,14,12,893,895,2,
Zoology,HOB and HVA,14,12,998,998,0,
Zoology,HOB and HVA,14,12,1040,1040,0,
Zoology,HOB and HVA,14,12,1048,1048,0,
Zoology,HOB and HVA,14,12,1067,1068,1,
Zoology,HOB and HVA,14,12,1102,1104,2,
Zoology,HOB and HVA,14,12,1371,1373,2,
Zoology,HOB and HVA,14,12,1378,1380,2,
Zoology,HOB and HVA,14,12,1399,1399,0,
Zoology,HOB and HVA,14,12,1412,1414,2,
Zoology,HOB and HVA,14,12,1415,1416,1,bee brushes up against paper
Zoology,HOB and HVA,14,12,1458,1460,2,
Zoology,HOB and HVA,14,12,1557,1562,5,
Zoology,HOB and HVA,14,12,1627,1631,4,
Zoology,HOB and HVA,18,7,22,24,2,
Zoology,HOB and HVA,18,7,33,36,3,
Zoology,HOB and HVA,18,7,49,50,1,
Zoology,HOB and HVA,18,7,110,118,8,
Zoology,HOB and HVA,18,7,123,126,3,
Zoology,HOB and HVA,18,7,135,135,0,
Zoology,HOB and HVA,18,7,250,252,2,
Zoology,HOB and HVA,18,7,335,336,1,
Zoology,HOB and HVA,18,7,416,417,1,
Zoology,HOB and HVA,18,7,420,421,1,
Zoology,HOB and HVA,18,7,573,574,1,
Zoology,HOB and HVA,18,7,686,689,3,
Zoology,HOB and HVA,18,7,884,886,2,
Zoology,HOB and HVA,18,7,910,911,1,
Zoology,HOB and HVA,18,7,962,964,2,
Zoology,HOB and HVA,18,7,972,973,1,
Zoology,HOB and HVA,18,7,1072,1075,3,
Zoology,HOB and HVA,18,7,1108,1111,3,
Zoology,HOB and HVA,18,7,1139,1140,1,
Zoology,HOB and HVA,18,7,1226,1232,6,
Zoology,HOB and HVA,18,7,1310,1312,2,
Zoology,HOB and HVA,18,7,1325,1326,1,
Zoology,HOB and HVA,18,7,1386,1388,2,
Zoology,HOB and HVA,18,7,1481,1482,1,not sure
Zoology,HOB and HVA,18,7,1521,1521,0,
Zoology,HOB and HVA,18,7,1633,1636,3,
Zoology,HOB and HVA,19,1,6,7,1,
Zoology,HOB and HVA,19,1,34,34,0,
Zoology,HOB and HVA,19,1,106,106,0,
Zoology,HOB and HVA,19,1,111,120,9,
Zoology,HOB and HVA,19,1,123,130,7,
Zoology,HOB and HVA,19,1,150,156,6,
Zoology,HOB and HVA,19,1,159,161,2,
Zoology,HOB and HVA,19,1,167,173,6,
Zoology,HOB and HVA,19,1,178,180,2,
Zoology,HOB and HVA,19,1,207,249,42,
Zoology,HOB and HVA,19,1,230,232,2,
Zoology,HOB and HVA,19,1,240,243,3,
Zoology,HOB and HVA,19,1,243,259,16,
Zoology,HOB and HVA,19,1,291,294,3,
Zoology,HOB and HVA,19,1,317,319,2,
Zoology,HOB and HVA,19,1,319,320,1,
Zoology,HOB and HVA,19,1,348,348,0,
Zoology,HOB and HVA,19,1,392,395,3,
Zoology,HOB and HVA,19,1,450,453,3,
Zoology,HOB and HVA,19,1,479,481,2,
Zoology,HOB and HVA,19,1,526,530,4,
Zoology,HOB and HVA,19,1,532,534,2,
Zoology,HOB and HVA,19,1,544,545,1,
Zoology,HOB and HVA,19,1,548,551,3,
Zoology,HOB and HVA,19,1,548,593,45,bee sniffs occasionally whist sitting very still next to the paper. Not quite angled at the paper
Zoology,HOB and HVA,19,1,559,563,4,
Zoology,HOB and HVA,19,1,582,584,2,
Zoology,HOB and HVA,19,1,632,632,0,
Zoology,HOB and HVA,19,1,633,634,1,
Zoology,HOB and HVA,19,1,638,639,1,
Zoology,HOB and HVA,19,1,673,673,0,
Zoology,HOB and HVA,19,1,714,718,4,
Zoology,HOB and HVA,19,1,720,722,2,
Zoology,HOB and HVA,19,1,722,726,4,
Zoology,HOB and HVA,19,1,734,745,11,
Zoology,HOB and HVA,19,1,745,753,8,
Zoology,HOB and HVA,19,1,759,765,6,
Zoology,HOB and HVA,19,1,767,767,0,
Zoology,HOB and HVA,19,1,774,777,3,
Zoology,HOB and HVA,19,1,823,826,3,
Zoology,HOB and HVA,19,1,841,845,4,
Zoology,HOB and HVA,19,1,869,871,2,
Zoology,HOB and HVA,19,1,920,922,2,
Zoology,HOB and HVA,19,1,943,943,0,
Zoology,HOB and HVA,19,1,955,959,4,
Zoology,HOB and HVA,19,1,1013,1015,2,
Zoology,HOB and HVA,19,1,1037,1041,4,
Zoology,HOB and HVA,19,1,1069,1070,1,
Zoology,HOB and HVA,19,1,1008,1061,53,bee lying motionless really close to the paper
Zoology,HOB and HVA,19,1,1069,1070,1,
Zoology,HOB and HVA,19,1,1079,1080,1,
Zoology,HOB and HVA,19,1,1083,1084,1,
Zoology,HOB and HVA,19,1,1135,1146,11,
Zoology,HOB and HVA,19,1,1148,1150,2,
Zoology,HOB and HVA,19,1,1149,1149,0,
Zoology,HOB and HVA,19,1,1150,1151,1,
Zoology,HOB and HVA,19,1,1187,1187,0,
Zoology,HOB and HVA,19,1,1189,1190,1,
Zoology,HOB and HVA,19,1,1222,1242,20,
Zoology,HOB and HVA,19,1,1235,1238,3,
Zoology,HOB and HVA,19,1,1246,1251,5,
Zoology,HOB and HVA,19,1,1257,1290,33,bee mucking around really close to paper - i'm pretty sure it counts
Zoology,HOB and HVA,19,1,1321,1322,1,
Zoology,HOB and HVA,19,1,1331,1333,2,
Zoology,HOB and HVA,19,1,1348,1351,3,
Zoology,HOB and HVA,19,1,1348,1350,2,
Zoology,HOB and HVA,19,1,1363,1364,1,
Zoology,HOB and HVA,19,1,1387,1390,3,
Zoology,HOB and HVA,19,1,1420,1423,3,
Zoology,HOB and HVA,19,1,1464,1536,72,bee was really close to paper - I think it counts
Zoology,HOB and HVA,19,1,1480,1480,0,
Zoology,HOB and HVA,19,1,1483,1483,0,
Zoology,HOB and HVA,19,1,1501,1504,3,
Zoology,HOB and HVA,19,1,1542,1542,0,
Zoology,HOB and HVA,19,1,1553,1554,1,
Zoology,HOB and HVA,19,1,1591,1593,2,
Zoology,HOB and HVA,19,1,1611,1613,2,
Zoology,HOB and HVA,19,1,1618,1620,2,
Zoology,HOB and HVA,19,1,1621,1621,0,
Zoology,HOB and HVA,19,1,1630,1630,0,
Zoology,HOB and HVA,19,1,1644,1644,0,
Zoology,HOB and HVA,19,1,1701,1712,11,
Zoology,HOB and HVA,23,11,3,3,0,
Zoology,HOB and HVA,23,11,31,31,0,
Zoology,HOB and HVA,23,11,31,31,0,
Zoology,HOB and HVA,23,11,57,61,4,
Zoology,HOB and HVA,23,11,93,93,0,
Zoology,HOB and HVA,23,11,96,99,3,
Zoology,HOB and HVA,23,11,102,102,0,
Zoology,HOB and HVA,23,11,148,148,0,
Zoology,HOB and HVA,23,11,189,191,2,
Zoology,HOB and HVA,23,11,226,226,0,
Zoology,HOB and HVA,23,11,233,234,1,
Zoology,HOB and HVA,23,11,236,236,0,
Zoology,HOB and HVA,23,11,239,245,6,
Zoology,HOB and HVA,23,11,253,258,5,bee being wierd on top of paper
Zoology,HOB and HVA,23,11,255,258,3,
Zoology,HOB and HVA,23,11,260,260,0,
Zoology,HOB and HVA,23,11,271,273,2,
Zoology,HOB and HVA,23,11,314,315,1,
Zoology,HOB and HVA,23,11,354,356,2,
Zoology,HOB and HVA,23,11,357,358,1,
Zoology,HOB and HVA,23,11,385,385,0,
Zoology,HOB and HVA,23,11,387,397,10,
Zoology,HOB and HVA,23,11,406,418,12,
Zoology,HOB and HVA,23,11,356,417,61,
Zoology,HOB and HVA,23,11,486,487,1,
Zoology,HOB and HVA,23,11,490,532,42,
Zoology,HOB and HVA,23,11,508,509,1,
Zoology,HOB and HVA,23,11,534,539,5,
Zoology,HOB and HVA,23,11,554,592,38,
Zoology,HOB and HVA,23,11,587,589,2,
Zoology,HOB and HVA,23,11,601,606,5,
Zoology,HOB and HVA,23,11,613,617,4,
Zoology,HOB and HVA,23,11,625,689,64,"bee real close, not qiote facing the paper, periodically sniffs it"
Zoology,HOB and HVA,23,11,677,677,0,
Zoology,HOB and HVA,23,11,684,686,2,
Zoology,HOB and HVA,23,11,687,687,0,
Zoology,HOB and HVA,23,11,771,772,1,
Zoology,HOB and HVA,23,11,814,816,2,
Zoology,HOB and HVA,23,11,1040,1040,0,
Zoology,HOB and HVA,23,11,1140,1140,0,
Zoology,HOB and HVA,23,11,1321,1323,2,
Zoology,HOB and HVA,23,11,1376,1376,0,
Zoology,HOB and HVA,23,11,1411,1411,0,
Zoology,HOB and HVA,23,11,1420,1422,2,
Zoology,HOB and HVA,23,11,1476,1476,0,
Zoology,HOB and HVA,23,11,1513,1515,2,
Zoology,HOB and HVA,23,11,1544,1546,2,
Zoology,HOB and HVA,23,11,1603,1604,1,
Zoology,HOB and HVA,32,12,17,22,5,
Zoology,HOB and HVA,32,12,27,27,0,
Zoology,HOB and HVA,32,12,45,45,0,
Zoology,HOB and HVA,32,12,126,129,3,bee walks over it
Zoology,HOB and HVA,32,12,136,137,1,bee walks over it
Zoology,HOB and HVA,32,12,186,186,0,bee walks on it
Zoology,HOB and HVA,32,12,288,288,0,
Zoology,HOB and HVA,32,12,316,316,0,
Zoology,HOB and HVA,32,12,492,492,0,
Zoology,HOB and HVA,32,12,581,581,0,
Zoology,HOB and HVA,32,12,1033,1040,7,
Zoology,HOB and HVA,32,12,1092,1092,0,
Zoology,HOB and HVA,32,12,1117,1119,2,
Zoology,HOB and HVA,32,12,1126,1127,1,
Zoology,HOB and HVA,32,12,1183,1183,0,
Zoology,HOB and HVA,32,12,1324,1324,0,
Zoology,HOB and HVA,32,12,1418,1418,0,
Zoology,HOB and HVA,32,12,1483,1484,1,
Zoology,HOB and HVA,32,12,1564,1564,0,
Zoology,HOB and HVA,32,12,1617,1617,0,
Zoology,HOB and HVA,32,12,1788,1800,12,
Zoology,9-HDA and HOB,4,2,170,171,1,
Zoology,9-HDA and HOB,4,2,193,197,4,
Zoology,9-HDA and HOB,4,2,291,294,3,
Zoology,9-HDA and HOB,4,2,938,943,5,
Zoology,9-HDA and HOB,5,7,160,161,1,
Zoology,9-HDA and HOB,5,7,179,184,5,
Zoology,9-HDA and HOB,5,7,181,181,0,
Zoology,9-HDA and HOB,5,7,144,150,6,
Zoology,9-HDA and HOB,5,7,491,492,1,
Zoology,9-HDA and HOB,5,7,710,711,1,
Zoology,9-HDA and HOB,5,7,720,722,2,
Zoology,9-HDA and HOB,5,7,727,734,7,
Zoology,9-HDA and HOB,5,7,733,734,1,
Zoology,9-HDA and HOB,5,7,747,747,0,
Zoology,9-HDA and HOB,5,7,748,748,0,
Zoology,9-HDA and HOB,5,7,750,750,0,
Zoology,9-HDA and HOB,5,7,768,889,121,
Zoology,9-HDA and HOB,5,7,860,861,1,
Zoology,9-HDA and HOB,5,7,929,930,1,
Zoology,9-HDA and HOB,5,7,937,939,2,maybe - quick sniff from afar
Zoology,9-HDA and HOB,5,7,943,986,43,
Zoology,9-HDA and HOB,5,7,961,963,2,
Zoology,9-HDA and HOB,5,7,986,994,8,maybe - quick sniff from afar
Zoology,9-HDA and HOB,5,7,1024,1025,1,
Zoology,9-HDA and HOB,5,7,1027,1031,4,
Zoology,9-HDA and HOB,5,7,1037,1038,1,
Zoology,9-HDA and HOB,5,7,1080,1081,1,
Zoology,9-HDA and HOB,5,7,1093,1095,2,
Zoology,9-HDA and HOB,5,7,1131,1133,2,
Zoology,9-HDA and HOB,5,7,1137,1139,2,
Zoology,9-HDA and HOB,5,7,1176,1176,0,
Zoology,9-HDA and HOB,5,7,1186,1186,0,
Zoology,9-HDA and HOB,5,7,1193,1198,5,
Zoology,9-HDA and HOB,5,7,1209,1209,0,
Zoology,9-HDA and HOB,5,7,1222,1224,2,
Zoology,9-HDA and HOB,5,7,1234,1235,1,
Zoology,9-HDA and HOB,5,7,1236,1236,0,
Zoology,9-HDA and HOB,5,7,1286,1286,0,
Zoology,9-HDA and HOB,5,7,1291,1291,0,
Zoology,9-HDA and HOB,5,7,1300,1301,1,
Zoology,9-HDA and HOB,5,7,1312,1313,1,
Zoology,9-HDA and HOB,5,7,1359,1359,0,
Zoology,9-HDA and HOB,5,7,1373,1373,0,
Zoology,9-HDA and HOB,5,7,1446,1446,0,
Zoology,9-HDA and HOB,5,7,1448,1448,0,
Zoology,9-HDA and HOB,5,7,1449,1449,0,
Zoology,9-HDA and HOB,5,7,1455,1455,0,
Zoology,9-HDA and HOB,5,7,1502,1505,3,
Zoology,9-HDA and HOB,5,7,1519,1519,0,
Zoology,9-HDA and HOB,5,7,1553,1554,1,
Zoology,9-HDA and HOB,5,7,1604,1606,2,
Zoology,9-HDA and HOB,5,7,1719,1720,1,
Zoology,9-HDA and HOB,5,7,1763,1767,4,
Zoology,9-HDA and HOB,6,7,0,13,13,
Zoology,9-HDA and HOB,6,7,19,38,19,
Zoology,9-HDA and HOB,6,7,25,28,3,
Zoology,9-HDA and HOB,6,7,50,91,41,
Zoology,9-HDA and HOB,6,7,99,101,2,
Zoology,9-HDA and HOB,6,7,111,182,71,
Zoology,9-HDA and HOB,6,7,138,138,0,
Zoology,9-HDA and HOB,6,7,186,186,0,
Zoology,9-HDA and HOB,6,7,191,194,3,be sniffs and walks very close to paper
Zoology,9-HDA and HOB,6,7,199,199,0,
Zoology,9-HDA and HOB,6,7,201,223,22,
Zoology,9-HDA and HOB,6,7,211,211,0,
Zoology,9-HDA and HOB,6,7,227,228,1,
Zoology,9-HDA and HOB,6,7,229,230,1,
Zoology,9-HDA and HOB,6,7,244,250,6,
Zoology,9-HDA and HOB,6,7,264,265,1,
Zoology,9-HDA and HOB,6,7,267,270,3,
Zoology,9-HDA and HOB,6,7,281,282,1,
Zoology,9-HDA and HOB,6,7,336,340,4,
Zoology,9-HDA and HOB,6,7,341,342,1,
Zoology,9-HDA and HOB,6,7,368,375,7,
Zoology,9-HDA and HOB,6,7,372,372,0,
Zoology,9-HDA and HOB,6,7,374,377,3,
Zoology,9-HDA and HOB,6,7,422,423,1,
Zoology,9-HDA and HOB,6,7,441,441,0,
Zoology,9-HDA and HOB,6,7,465,467,2,
Zoology,9-HDA and HOB,6,7,543,581,38,
Zoology,9-HDA and HOB,6,7,585,667,82,
Zoology,9-HDA and HOB,6,7,649,650,1,
Zoology,9-HDA and HOB,6,7,679,718,39,
Zoology,9-HDA and HOB,6,7,728,730,2,
Zoology,9-HDA and HOB,6,7,745,746,1,
Zoology,9-HDA and HOB,6,7,748,792,44,
Zoology,9-HDA and HOB,6,7,772,778,6,
Zoology,9-HDA and HOB,6,7,784,784,0,
Zoology,9-HDA and HOB,6,7,813,818,5,
Zoology,9-HDA and HOB,6,7,814,815,1,
Zoology,9-HDA and HOB,6,7,856,858,2,
Zoology,9-HDA and HOB,6,7,879,880,1,
Zoology,9-HDA and HOB,6,7,904,907,3,
Zoology,9-HDA and HOB,6,7,926,926,0,
Zoology,9-HDA and HOB,6,7,930,930,0,
Zoology,9-HDA and HOB,6,7,969,969,0,
Zoology,9-HDA and HOB,6,7,1049,1049,0,
Zoology,9-HDA and HOB,6,7,1191,1191,0,
Zoology,9-HDA and HOB,6,7,1241,1243,2,
Zoology,9-HDA and HOB,6,7,1273,1273,0,be sniffs as it walks past maybe
Zoology,9-HDA and HOB,6,7,1293,1295,2,
Zoology,9-HDA and HOB,6,7,1296,1297,1,
Zoology,9-HDA and HOB,6,7,1330,1331,1,
Zoology,9-HDA and HOB,6,7,1334,1342,8,
Zoology,9-HDA and HOB,6,7,1346,1347,1,
Zoology,9-HDA and HOB,6,7,1359,1363,4,
Zoology,9-HDA and HOB,6,7,1383,1383,0,
Zoology,9-HDA and HOB,6,7,1433,1435,2,
Zoology,9-HDA and HOB,6,7,1474,1479,5,
Zoology,9-HDA and HOB,6,7,1516,1518,2,
Zoology,9-HDA and HOB,6,7,1550,1551,1,
Zoology,9-HDA and HOB,6,7,1555,1571,16,
Zoology,9-HDA and HOB,6,7,1579,1579,0,
Zoology,9-HDA and HOB,6,7,1583,1584,1,
Zoology,9-HDA and HOB,6,7,1587,1588,1,
Zoology,9-HDA and HOB,6,7,1666,1666,0,
Zoology,9-HDA and HOB,6,7,1682,1683,1,
Zoology,9-HDA and HOB,6,7,1705,1705,0,
Zoology,9-HDA and HOB,6,7,1724,1724,0,
Zoology,9-HDA and HOB,6,7,1731,1732,1,
Zoology,9-HDA and HOB,7,1,24,24,0,
Zoology,9-HDA and HOB,7,1,100,101,1,
Zoology,9-HDA and HOB,7,1,173,178,5,
Zoology,9-HDA and HOB,7,1,203,203,0,
Zoology,9-HDA and HOB,7,1,225,228,3,
Zoology,9-HDA and HOB,7,1,232,232,0,
Zoology,9-HDA and HOB,7,1,268,269,1,
Zoology,9-HDA and HOB,7,1,281,285,4,
Zoology,9-HDA and HOB,7,1,329,330,1,
Zoology,9-HDA and HOB,7,1,355,355,0,
Zoology,9-HDA and HOB,7,1,385,388,3,
Zoology,9-HDA and HOB,7,1,402,402,0,
Zoology,9-HDA and HOB,7,1,458,461,3,
Zoology,9-HDA and HOB,7,1,466,466,0,
Zoology,9-HDA and HOB,7,1,471,476,5,
Zoology,9-HDA and HOB,7,1,490,490,0,
Zoology,9-HDA and HOB,7,1,498,507,9,
Zoology,9-HDA and HOB,7,1,512,521,9,
Zoology,9-HDA and HOB,7,1,514,517,3,
Zoology,9-HDA and HOB,7,1,518,520,2,
Zoology,9-HDA and HOB,7,1,543,550,7,
Zoology,9-HDA and HOB,7,1,623,623,0,
Zoology,9-HDA and HOB,7,1,636,640,4,
Zoology,9-HDA and HOB,7,1,646,647,1,
Zoology,9-HDA and HOB,7,1,655,657,2,
Zoology,9-HDA and HOB,7,1,692,694,2,
Zoology,9-HDA and HOB,7,1,724,725,1,
Zoology,9-HDA and HOB,7,1,734,734,0,
Zoology,9-HDA and HOB,7,1,757,757,0,
Zoology,9-HDA and HOB,7,1,759,759,0,
Zoology,9-HDA and HOB,7,1,775,775,0,
Zoology,9-HDA and HOB,7,1,785,785,0,
Zoology,9-HDA and HOB,7,1,801,802,1,
Zoology,9-HDA and HOB,7,1,803,803,0,
Zoology,9-HDA and HOB,7,1,805,805,0,
Zoology,9-HDA and HOB,7,1,846,846,0,
Zoology,9-HDA and HOB,7,1,857,857,0,
Zoology,9-HDA and HOB,7,1,883,883,0,
Zoology,9-HDA and HOB,7,1,896,897,1,
Zoology,9-HDA and HOB,7,1,898,898,0,
Zoology,9-HDA and HOB,7,1,928,928,0,
Zoology,9-HDA and HOB,7,1,1015,1016,1,
Zoology,9-HDA and HOB,7,1,1029,1030,1,
Zoology,9-HDA and HOB,7,1,1038,1041,3,
Zoology,9-HDA and HOB,7,1,1101,1101,0,
Zoology,9-HDA and HOB,7,1,1130,1136,6,
Zoology,9-HDA and HOB,7,1,1140,1140,0,
Zoology,9-HDA and HOB,7,1,1209,1209,0,
Zoology,9-HDA and HOB,7,1,1244,1247,3,
Zoology,9-HDA and HOB,7,1,1249,1250,1,
Zoology,9-HDA and HOB,7,1,1251,1252,1,
Zoology,9-HDA and HOB,7,1,1254,1255,1,
Zoology,9-HDA and HOB,7,1,1255,1256,1,
Zoology,9-HDA and HOB,7,1,1272,1272,0,
Zoology,9-HDA and HOB,7,1,1277,1277,0,
Zoology,9-HDA and HOB,7,1,1307,1308,1,
Zoology,9-HDA and HOB,7,1,1314,1315,1,
Zoology,9-HDA and HOB,7,1,1316,1331,15,
Zoology,9-HDA and HOB,7,1,1325,1332,7,
Zoology,9-HDA and HOB,7,1,1362,1368,6,
Zoology,9-HDA and HOB,7,1,1373,1413,40,
Zoology,9-HDA and HOB,7,1,1374,1376,2,
Zoology,9-HDA and HOB,7,1,1396,1396,0,
Zoology,9-HDA and HOB,7,1,1425,1425,0,
Zoology,9-HDA and HOB,7,1,1431,1437,6,
Zoology,9-HDA and HOB,7,1,1479,1480,1,
Zoology,9-HDA and HOB,7,1,1497,1498,1,
Zoology,9-HDA and HOB,7,1,1500,1500,0,
Zoology,9-HDA and HOB,7,1,1528,1528,0,
Zoology,9-HDA and HOB,7,1,1537,1537,0,
Zoology,9-HDA and HOB,7,1,1579,1582,3,
Zoology,9-HDA and HOB,7,1,1581,1581,0,
Zoology,9-HDA and HOB,7,1,1600,1600,0,
Zoology,9-HDA and HOB,7,1,1607,1608,1,
Zoology,9-HDA and HOB,7,1,1681,1682,1,
Zoology,9-HDA and HOB,7,1,1691,1691,0,
Zoology,9-HDA and HOB,7,1,1691,1692,1,
Zoology,9-HDA and HOB,7,1,1749,1750,1,
Zoology,9-HDA and HOB,7,1,1774,1778,4,
Zoology,9-HDA and HOB,7,1,1782,1786,4,
Zoology,9-HDA and HOB,7,1,1792,1792,0,
Zoology,9-HDA and HOB,8,10,7,10,3,
Zoology,9-HDA and HOB,8,10,39,41,2,
Zoology,9-HDA and HOB,8,10,71,72,1,
Zoology,9-HDA and HOB,8,10,124,124,0,
Zoology,9-HDA and HOB,8,10,254,254,0,
Zoology,9-HDA and HOB,8,10,280,281,1,
Zoology,9-HDA and HOB,8,10,283,283,0,
Zoology,9-HDA and HOB,8,10,313,313,0,
Zoology,9-HDA and HOB,8,10,334,336,2,
Zoology,9-HDA and HOB,8,10,359,359,0,fast touch as bee walks
Zoology,9-HDA and HOB,8,10,209,217,8,
Zoology,9-HDA and HOB,8,10,216,216,0,
Zoology,9-HDA and HOB,8,10,401,422,21,
Zoology,9-HDA and HOB,8,10,411,411,0,
Zoology,9-HDA and HOB,8,10,430,431,1,
Zoology,9-HDA and HOB,8,10,434,437,3,
Zoology,9-HDA and HOB,8,10,438,439,1,
Zoology,9-HDA and HOB,8,10,443,443,0,
Zoology,9-HDA and HOB,8,10,445,445,0,
Zoology,9-HDA and HOB,8,10,449,451,2,
Zoology,9-HDA and HOB,8,10,453,453,0,
Zoology,9-HDA and HOB,8,10,456,456,0,
Zoology,9-HDA and HOB,8,10,460,460,0,
Zoology,9-HDA and HOB,8,10,472,474,2,
Zoology,9-HDA and HOB,8,10,483,483,0,
Zoology,9-HDA and HOB,8,10,489,490,1,
Zoology,9-HDA and HOB,8,10,492,493,1,
Zoology,9-HDA and HOB,8,10,502,504,2,
Zoology,9-HDA and HOB,8,10,507,509,2,
Zoology,9-HDA and HOB,8,10,525,525,0,
Zoology,9-HDA and HOB,8,10,525,525,0,
Zoology,9-HDA and HOB,8,10,550,550,0,
Zoology,9-HDA and HOB,8,10,557,557,0,bee sort of nudges paper with its legs
Zoology,9-HDA and HOB,8,10,562,562,0,
Zoology,9-HDA and HOB,8,10,573,573,0,
Zoology,9-HDA and HOB,8,10,575,575,0,
Zoology,9-HDA and HOB,8,10,577,579,2,
Zoology,9-HDA and HOB,8,10,593,594,1,
Zoology,9-HDA and HOB,8,10,632,634,2,
Zoology,9-HDA and HOB,8,10,712,713,1,
Zoology,9-HDA and HOB,8,10,714,714,0,
Zoology,9-HDA and HOB,8,10,712,712,0,
Zoology,9-HDA and HOB,8,10,784,784,0,
Zoology,9-HDA and HOB,8,10,806,806,0,
Zoology,9-HDA and HOB,8,10,822,823,1,
Zoology,9-HDA and HOB,8,10,824,824,0,
Zoology,9-HDA and HOB,8,10,840,841,1,
Zoology,9-HDA and HOB,8,10,855,855,0,
Zoology,9-HDA and HOB,8,10,876,876,0,fast touch
Zoology,9-HDA and HOB,8,10,889,890,1,
Zoology,9-HDA and HOB,8,10,968,968,0,
Zoology,9-HDA and HOB,8,10,1013,1042,29,
Zoology,9-HDA and HOB,8,10,1045,1046,1,
Zoology,9-HDA and HOB,8,10,1047,1047,0,
Zoology,9-HDA and HOB,8,10,1047,1062,15,
Zoology,9-HDA and HOB,8,10,1052,1060,8,
Zoology,9-HDA and HOB,8,10,1064,1065,1,
Zoology,9-HDA and HOB,8,10,1068,1070,2,
Zoology,9-HDA and HOB,8,10,1074,1074,0,
Zoology,9-HDA and HOB,8,10,1150,1150,0,
Zoology,9-HDA and HOB,8,10,1182,1185,3,maybe not touching but seems sort of interrested.
Zoology,9-HDA and HOB,8,10,1240,1240,0,
Zoology,9-HDA and HOB,8,10,1266,1266,0,
Zoology,9-HDA and HOB,8,10,1305,1305,0,
Zoology,9-HDA and HOB,8,10,1316,1316,0,
Zoology,9-HDA and HOB,8,10,1341,1341,0,
Zoology,9-HDA and HOB,8,10,1366,1366,0,maybe very fast touch
Zoology,9-HDA and HOB,8,10,1377,1378,1,
Zoology,9-HDA and HOB,8,10,1389,1390,1,
Zoology,9-HDA and HOB,8,10,1402,1402,0,
Zoology,9-HDA and HOB,8,10,1417,1417,0,
Zoology,9-HDA and HOB,8,10,1440,1442,2,
Zoology,9-HDA and HOB,8,10,1460,1462,2,
Zoology,9-HDA and HOB,8,10,1481,1481,0,
Zoology,9-HDA and HOB,8,10,1490,1490,0,
Zoology,9-HDA and HOB,8,10,1513,1513,0,
Zoology,9-HDA and HOB,8,10,1532,1532,0,
Zoology,9-HDA and HOB,8,10,1582,1583,1,
Zoology,9-HDA and HOB,8,10,1592,1596,4,
Zoology,9-HDA and HOB,8,10,1654,1654,0,
Zoology,9-HDA and HOB,8,10,1687,1688,1,
Zoology,9-HDA and HOB,8,10,1689,1689,0,
Zoology,9-HDA and HOB,8,10,1707,1708,1,
Zoology,9-HDA and HOB,8,10,1717,1717,0,
Zoology,9-HDA and HOB,8,10,1720,1720,0,
Zoology,9-HDA and HOB,8,10,1739,1739,0,
Zoology,9-HDA and HOB,8,10,1742,1742,0,
Zoology,9-HDA and HOB,8,10,1764,1764,0,
Zoology,9-HDA and HOB,8,10,1771,1772,1,
Zoology,9-HDA and HOB,8,10,1795,1795,0,
Zoology,9-HDA and HOB,8,10,1798,1799,1,
Zoology,9-HDA and HOB,9,11,18,18,0,
Zoology,9-HDA and HOB,9,11,21,21,0,
Zoology,9-HDA and HOB,9,11,24,24,0,
Zoology,9-HDA and HOB,9,11,40,40,0,
Zoology,9-HDA and HOB,9,11,81,81,0,
Zoology,9-HDA and HOB,9,11,89,90,1,
Zoology,9-HDA and HOB,9,11,145,146,1,
Zoology,9-HDA and HOB,9,11,244,262,18,
Zoology,9-HDA and HOB,9,11,298,301,3,
Zoology,9-HDA and HOB,9,11,310,310,0,
Zoology,9-HDA and HOB,9,11,343,343,0,
Zoology,9-HDA and HOB,9,11,379,384,5,
Zoology,9-HDA and HOB,9,11,404,408,4,
Zoology,9-HDA and HOB,9,11,425,427,2,
Zoology,9-HDA and HOB,9,11,484,500,16,
Zoology,9-HDA and HOB,9,11,485,489,4,
Zoology,9-HDA and HOB,9,11,503,503,0,
Zoology,9-HDA and HOB,9,11,563,563,0,
Zoology,9-HDA and HOB,9,11,629,632,3,
Zoology,9-HDA and HOB,9,11,645,646,1,
Zoology,9-HDA and HOB,9,11,648,650,2,maybe - not touching at all
Zoology,9-HDA and HOB,9,11,675,676,1,
Zoology,9-HDA and HOB,9,11,732,734,2,
Zoology,9-HDA and HOB,9,11,754,760,6,
Zoology,9-HDA and HOB,9,11,820,822,2,
Zoology,9-HDA and HOB,9,11,826,826,0,
Zoology,9-HDA and HOB,9,11,847,848,1,
Zoology,9-HDA and HOB,9,11,871,871,0,
Zoology,9-HDA and HOB,9,11,904,905,1,
Zoology,9-HDA and HOB,9,11,914,916,2,
Zoology,9-HDA and HOB,9,11,914,919,5,
Zoology,9-HDA and HOB,9,11,934,936,2,
Zoology,9-HDA and HOB,9,11,978,978,0,
Zoology,9-HDA and HOB,9,11,982,984,2,
Zoology,9-HDA and HOB,9,11,1003,1004,1,
Zoology,9-HDA and HOB,9,11,1004,1005,1,
Zoology,9-HDA and HOB,9,11,1006,1007,1,
Zoology,9-HDA and HOB,9,11,1012,1012,0,
Zoology,9-HDA and HOB,9,11,1072,1073,1,
Zoology,9-HDA and HOB,9,11,1175,1176,1,
Zoology,9-HDA and HOB,9,11,1279,1281,2,
Zoology,9-HDA and HOB,9,11,1282,1282,0,
Zoology,9-HDA and HOB,9,11,1331,1332,1,
Zoology,9-HDA and HOB,9,11,1334,1334,0,
Zoology,9-HDA and HOB,9,11,1357,1358,1,
Zoology,9-HDA and HOB,9,11,1430,1431,1,
Zoology,9-HDA and HOB,9,11,1466,1475,9,not touching seems to be sniffing
Zoology,9-HDA and HOB,9,11,1475,1476,1,
Zoology,9-HDA and HOB,9,11,1517,1517,0,
Zoology,9-HDA and HOB,9,11,1530,1531,1,
Zoology,9-HDA and HOB,9,11,1532,1533,1,
Zoology,9-HDA and HOB,9,11,1546,1546,0,
Zoology,9-HDA and HOB,9,11,1636,1638,2,
Zoology,9-HDA and HOB,9,11,1678,1678,0,
Zoology,9-HDA and HOB,9,11,1682,1682,0,
Zoology,9-HDA and HOB,9,11,1704,1704,0,
Zoology,9-HDA and HOB,9,11,1740,1741,1,
Zoology,9-HDA and HOB,9,11,1777,1777,0,
Zoology,9-HDA and HOB,9,11,1795,1795,0,
Zoology,9-HDA and HOB,9,11,1797,1797,0,
Zoology,9-HDA and HOB,11,7,136,138,2,
Zoology,9-HDA and HOB,11,7,206,206,0,
Zoology,9-HDA and HOB,11,7,343,343,0,maybe accidental bump
Zoology,9-HDA and HOB,11,7,356,357,1,
Zoology,9-HDA and HOB,11,7,377,403,26,
Zoology,9-HDA and HOB,11,7,392,393,1,
Zoology,9-HDA and HOB,11,7,425,425,0,
Zoology,9-HDA and HOB,11,7,435,436,1,
Zoology,9-HDA and HOB,11,7,463,463,0,
Zoology,9-HDA and HOB,11,7,467,467,0,
Zoology,9-HDA and HOB,11,7,470,470,0,
Zoology,9-HDA and HOB,11,7,540,540,0,
Zoology,9-HDA and HOB,11,7,578,597,19,
Zoology,9-HDA and HOB,11,7,597,597,0,
Zoology,9-HDA and HOB,11,7,600,603,3,
Zoology,9-HDA and HOB,11,7,626,628,2,
Zoology,9-HDA and HOB,11,7,629,629,0,
Zoology,9-HDA and HOB,11,7,638,639,1,
Zoology,9-HDA and HOB,11,7,649,650,1,
Zoology,9-HDA and HOB,11,7,657,658,1,
Zoology,9-HDA and HOB,11,7,657,659,2,
Zoology,9-HDA and HOB,11,7,674,674,0,
Zoology,9-HDA and HOB,11,7,686,693,7,
Zoology,9-HDA and HOB,11,7,687,687,0,
Zoology,9-HDA and HOB,11,7,705,727,22,
Zoology,9-HDA and HOB,11,7,722,722,0,
Zoology,9-HDA and HOB,11,7,746,747,1,
Zoology,9-HDA and HOB,11,7,746,749,3,
Zoology,9-HDA and HOB,11,7,753,753,0,
Zoology,9-HDA and HOB,11,7,757,757,0,
Zoology,9-HDA and HOB,11,7,761,762,1,
Zoology,9-HDA and HOB,11,7,771,819,48,
Zoology,9-HDA and HOB,11,7,781,785,4,
Zoology,9-HDA and HOB,11,7,813,813,0,
Zoology,9-HDA and HOB,11,7,822,828,6,
Zoology,9-HDA and HOB,11,7,833,835,2,
Zoology,9-HDA and HOB,11,7,857,857,0,
Zoology,9-HDA and HOB,11,7,879,879,0,
Zoology,9-HDA and HOB,11,7,883,885,2,
Zoology,9-HDA and HOB,11,7,886,887,1,
Zoology,9-HDA and HOB,11,7,902,903,1,
Zoology,9-HDA and HOB,11,7,911,912,1,
Zoology,9-HDA and HOB,11,7,926,926,0,
Zoology,9-HDA and HOB,11,7,938,938,0,
Zoology,9-HDA and HOB,11,7,956,956,0,
Zoology,9-HDA and HOB,11,7,974,974,0,
Zoology,9-HDA and HOB,11,7,1073,1073,0,
Zoology,9-HDA and HOB,11,7,1163,1166,3,
Zoology,9-HDA and HOB,11,7,1166,1167,1,
Zoology,9-HDA and HOB,11,7,1181,1181,0,
Zoology,9-HDA and HOB,11,7,1223,1223,0,
Zoology,9-HDA and HOB,11,7,1224,1224,0,
Zoology,9-HDA and HOB,11,7,1238,1240,2,
Zoology,9-HDA and HOB,11,7,1245,1245,0,
Zoology,9-HDA and HOB,11,7,1273,1276,3,
Zoology,9-HDA and HOB,11,7,1298,1298,0,
Zoology,9-HDA and HOB,11,7,1300,1300,0,
Zoology,9-HDA and HOB,11,7,1328,1329,1,
Zoology,9-HDA and HOB,11,7,1392,1392,0,
Zoology,9-HDA and HOB,11,7,1399,1400,1,
Zoology,9-HDA and HOB,11,7,1408,1408,0,
Zoology,9-HDA and HOB,11,7,1412,1414,2,
Zoology,9-HDA and HOB,11,7,1430,1430,0,
Zoology,9-HDA and HOB,11,7,1527,1527,0,
Zoology,9-HDA and HOB,11,7,1539,1540,1,
Zoology,9-HDA and HOB,11,7,1551,1562,11,
Zoology,9-HDA and HOB,11,7,1561,1563,2,
Zoology,9-HDA and HOB,11,7,1576,1576,0,
Zoology,9-HDA and HOB,11,7,1586,1586,0,
Zoology,9-HDA and HOB,11,7,1610,1610,0,
Zoology,9-HDA and HOB,11,7,1625,1627,2,not touching paper but seems interrested - kinda walks towards it
Zoology,9-HDA and HOB,11,7,1654,1654,0,
Zoology,9-HDA and HOB,11,7,1670,1670,0,
Zoology,9-HDA and HOB,11,7,1695,1695,0,
Zoology,9-HDA and HOB,11,7,1699,1699,0,
Zoology,9-HDA and HOB,11,7,1701,1702,1,
Zoology,9-HDA and HOB,11,7,1723,1723,0,
Zoology,9-HDA and HOB,11,7,1724,1724,0,
Zoology,9-HDA and HOB,11,7,1745,1749,4,
Zoology,9-HDA and HOB,11,7,1761,1761,0,
Zoology,9-HDA and HOB,11,7,1789,1789,0,
Zoology,9-HDA and HOB,14,2,66,66,0,
Zoology,9-HDA and HOB,14,2,108,108,0,maybe - sort of bumps in to paper
Zoology,9-HDA and HOB,14,2,138,138,0,maybe - sort of bumps in to paper
Zoology,9-HDA and HOB,14,2,224,226,2,
Zoology,9-HDA and HOB,14,2,287,287,0,
Zoology,9-HDA and HOB,14,2,293,293,0,
Zoology,9-HDA and HOB,14,2,461,461,0,
Zoology,9-HDA and HOB,14,2,539,540,1,
Zoology,9-HDA and HOB,14,2,552,553,1,
Zoology,9-HDA and HOB,14,2,595,600,5,
Zoology,9-HDA and HOB,14,2,621,623,2,
Zoology,9-HDA and HOB,14,2,698,698,0,
Zoology,9-HDA and HOB,14,2,742,743,1,
Zoology,9-HDA and HOB,14,2,745,746,1,
Zoology,9-HDA and HOB,14,2,982,982,0,
Zoology,9-HDA and HOB,14,2,1159,1163,4,
Zoology,9-HDA and HOB,14,2,1274,1274,0,
Zoology,9-HDA and HOB,14,2,1300,1301,1,
Zoology,9-HDA and HOB,14,2,1331,1331,0,
Zoology,9-HDA and HOB,14,2,1405,1405,0,
Zoology,9-HDA and HOB,14,2,1430,1430,0,
Zoology,9-HDA and HOB,14,2,1612,1613,1,
Zoology,9-HDA and HOB,14,2,1692,1692,0,
Zoology,9-HDA and HOB,14,2,1747,1748,1,
Zoology,9-HDA and HOB,14,2,1769,1770,1,
Zoology,9-HDA and HOB,14,2,1790,1790,0,
Zoology,9-HDA and HOB,18,8,0,2,2,
Zoology,9-HDA and HOB,18,8,8,10,2,
Zoology,9-HDA and HOB,18,8,27,30,3,
Zoology,9-HDA and HOB,18,8,35,36,1,
Zoology,9-HDA and HOB,18,8,43,47,4,
Zoology,9-HDA and HOB,18,8,131,135,4,
Zoology,9-HDA and HOB,18,8,141,143,2,
Zoology,9-HDA and HOB,18,8,214,220,6,
Zoology,9-HDA and HOB,18,8,231,233,2,
Zoology,9-HDA and HOB,18,8,289,294,5,
Zoology,9-HDA and HOB,18,8,300,303,3,
Zoology,9-HDA and HOB,18,8,311,314,3,
Zoology,9-HDA and HOB,18,8,385,388,3,
Zoology,9-HDA and HOB,18,8,386,387,1,
Zoology,9-HDA and HOB,18,8,393,402,9,
Zoology,9-HDA and HOB,18,8,396,404,8,
Zoology,9-HDA and HOB,18,8,419,482,63,
Zoology,9-HDA and HOB,18,8,423,427,4,
Zoology,9-HDA and HOB,18,8,502,511,9,
Zoology,9-HDA and HOB,18,8,520,521,1,
Zoology,9-HDA and HOB,18,8,528,530,2,
Zoology,9-HDA and HOB,18,8,528,541,13,
Zoology,9-HDA and HOB,18,8,578,595,17,
Zoology,9-HDA and HOB,18,8,599,603,4,
Zoology,9-HDA and HOB,18,8,616,620,4,
Zoology,9-HDA and HOB,18,8,862,903,41,
Zoology,9-HDA and HOB,18,8,932,935,3,
Zoology,9-HDA and HOB,18,8,950,954,4,
Zoology,9-HDA and HOB,18,8,963,971,8,
Zoology,9-HDA and HOB,18,8,995,997,2,
Zoology,9-HDA and HOB,18,8,1049,1628,579,
Zoology,9-HDA and HOB,18,8,1056,1388,332,
Zoology,9-HDA and HOB,18,8,1163,1170,7,
Zoology,9-HDA and HOB,18,8,1184,1388,204,
Zoology,9-HDA and HOB,18,8,1367,1370,3,
Zoology,9-HDA and HOB,18,8,1378,1385,7,
Zoology,9-HDA and HOB,18,8,1424,1450,26,
Zoology,9-HDA and HOB,18,8,1495,1516,21,
Zoology,9-HDA and HOB,18,8,1624,1636,12,
Zoology,9-HDA and HOB,18,8,1660,1665,5,
Zoology,9-HDA and HOB,18,8,1775,1793,18,
Zoology,9-HDA and HOB,19,5,1,1,0,
Zoology,9-HDA and HOB,19,5,15,15,0,
Zoology,9-HDA and HOB,19,5,21,28,7,
Zoology,9-HDA and HOB,19,5,40,40,0,
Zoology,9-HDA and HOB,19,5,57,57,0,bee knocks side ways in to the paper
Zoology,9-HDA and HOB,19,5,79,80,1,
Zoology,9-HDA and HOB,19,5,93,94,1,
Zoology,9-HDA and HOB,19,5,111,112,1,
Zoology,9-HDA and HOB,19,5,151,163,12,
Zoology,9-HDA and HOB,19,5,230,237,7,
Zoology,9-HDA and HOB,19,5,309,309,0,
Zoology,9-HDA and HOB,19,5,324,325,1,
Zoology,9-HDA and HOB,19,5,396,401,5,
Zoology,9-HDA and HOB,19,5,438,438,0,
Zoology,9-HDA and HOB,19,5,441,444,3,
Zoology,9-HDA and HOB,19,5,449,454,5,
Zoology,9-HDA and HOB,19,5,465,466,1,
Zoology,9-HDA and HOB,19,5,472,472,0,
Zoology,9-HDA and HOB,19,5,459,459,0,
Zoology,9-HDA and HOB,19,5,536,536,0,
Zoology,9-HDA and HOB,19,5,548,548,0,
Zoology,9-HDA and HOB,19,5,607,607,0,
Zoology,9-HDA and HOB,19,5,781,784,3,
Zoology,9-HDA and HOB,19,5,808,808,0,
Zoology,9-HDA and HOB,19,5,852,871,19,
Zoology,9-HDA and HOB,19,5,855,856,1,
Zoology,9-HDA and HOB,19,5,858,869,11,
Zoology,9-HDA and HOB,19,5,961,965,4,
Zoology,9-HDA and HOB,19,5,1043,1044,1,
Zoology,9-HDA and HOB,19,5,1051,1053,2,
Zoology,9-HDA and HOB,19,5,1062,1066,4,
Zoology,9-HDA and HOB,19,5,1068,1091,23,
Zoology,9-HDA and HOB,19,5,1088,1092,4,
Zoology,9-HDA and HOB,19,5,1121,1133,12,
Zoology,9-HDA and HOB,19,5,1340,1340,0,
Zoology,9-HDA and HOB,19,5,1376,1382,6,
Zoology,9-HDA and HOB,19,5,1388,1391,3,
Zoology,9-HDA and HOB,19,5,1404,1404,0,
Zoology,9-HDA and HOB,19,5,1410,1419,9,
Zoology,9-HDA and HOB,19,5,1445,1445,0,
Zoology,9-HDA and HOB,19,5,1466,1486,20,
Zoology,9-HDA and HOB,19,5,1483,1483,0,
Zoology,9-HDA and HOB,19,5,1488,1493,5,
Zoology,9-HDA and HOB,19,5,1526,1531,5,
Zoology,9-HDA and HOB,19,5,1527,1529,2,
Zoology,9-HDA and HOB,19,5,1534,1537,3,
Zoology,9-HDA and HOB,19,5,1547,1549,2,
Zoology,9-HDA and HOB,19,5,1566,1569,3,
Zoology,9-HDA and HOB,19,5,1568,1571,3,
Zoology,9-HDA and HOB,19,5,1609,1612,3,
Zoology,9-HDA and HOB,19,5,1638,1639,1,
Zoology,9-HDA and HOB,19,5,1642,1644,2,
Zoology,9-HDA and HOB,19,5,1663,1664,1,
Zoology,9-HDA and HOB,19,5,1705,1705,0,
Zoology,9-HDA and HOB,19,5,1743,1743,0,
Zoology,9-HDA and HOB,19,5,1746,1746,0,
Zoology,9-HDA and HOB,19,5,1764,1775,11,bee mucking about right near paper - seems interrested
Zoology,9-HDA and HOB,19,5,1794,1794,0,
Zoology,9-HDA and HOB,23,3,229,231,2,
Zoology,9-HDA and HOB,23,3,240,242,2,
Zoology,9-HDA and HOB,23,3,351,353,2,
Zoology,9-HDA and HOB,23,3,393,395,2,
Zoology,9-HDA and HOB,23,3,445,445,0,
Zoology,9-HDA and HOB,23,3,530,530,0,
Zoology,9-HDA and HOB,23,3,550,550,0,
Zoology,9-HDA and HOB,23,3,667,669,2,
Zoology,9-HDA and HOB,23,3,1010,1010,0,
Zoology,9-HDA and HOB,23,3,1666,1666,0,
Zoology,9-HDA and HOB,23,3,1730,1731,1,
Zoology,9-HDA and HVA,4,1,22,24,2,
Zoology,9-HDA and HVA,4,1,34,35,1,
Zoology,9-HDA and HVA,4,1,47,47,0,
Zoology,9-HDA and HVA,4,1,96,96,0,
Zoology,9-HDA and HVA,4,1,100,104,4,
Zoology,9-HDA and HVA,4,1,111,111,0,
Zoology,9-HDA and HVA,4,1,119,120,1,
Zoology,9-HDA and HVA,4,1,141,141,0,
Zoology,9-HDA and HVA,4,1,148,151,3,
Zoology,9-HDA and HVA,4,1,149,151,2,
Zoology,9-HDA and HVA,4,1,172,174,2,
Zoology,9-HDA and HVA,4,1,173,176,3,
Zoology,9-HDA and HVA,4,1,201,202,1,
Zoology,9-HDA and HVA,4,1,203,204,1,
Zoology,9-HDA and HVA,4,1,224,224,0,
Zoology,9-HDA and HVA,4,1,226,227,1,
Zoology,9-HDA and HVA,4,1,233,234,1,
Zoology,9-HDA and HVA,4,1,242,244,2,
Zoology,9-HDA and HVA,4,1,280,281,1,
Zoology,9-HDA and HVA,4,1,306,307,1,
Zoology,9-HDA and HVA,4,1,316,318,2,
Zoology,9-HDA and HVA,4,1,353,354,1,
Zoology,9-HDA and HVA,4,1,492,494,2,
Zoology,9-HDA and HVA,4,1,519,520,1,
Zoology,9-HDA and HVA,4,1,575,585,10,
Zoology,9-HDA and HVA,4,1,595,595,0,
Zoology,9-HDA and HVA,4,1,636,648,12,bee sort of sniffing from afar
Zoology,9-HDA and HVA,4,1,671,671,0,
Zoology,9-HDA and HVA,4,1,672,673,1,
Zoology,9-HDA and HVA,4,1,682,684,2,
Zoology,9-HDA and HVA,4,1,688,688,0,
Zoology,9-HDA and HVA,4,1,691,693,2,
Zoology,9-HDA and HVA,4,1,744,746,2,
Zoology,9-HDA and HVA,4,1,779,780,1,
Zoology,9-HDA and HVA,4,1,812,814,2,
Zoology,9-HDA and HVA,4,1,822,824,2,
Zoology,9-HDA and HVA,4,1,862,867,5,
Zoology,9-HDA and HVA,4,1,873,874,1,
Zoology,9-HDA and HVA,4,1,881,882,1,
Zoology,9-HDA and HVA,4,1,884,887,3,
Zoology,9-HDA and HVA,4,1,900,900,0,
Zoology,9-HDA and HVA,4,1,955,956,1,
Zoology,9-HDA and HVA,4,1,987,989,2,
Zoology,9-HDA and HVA,4,1,1014,1015,1,
Zoology,9-HDA and HVA,4,1,1021,1023,2,
Zoology,9-HDA and HVA,4,1,1033,1033,0,
Zoology,9-HDA and HVA,4,1,1047,1047,0,
Zoology,9-HDA and HVA,4,1,1048,1048,0,
Zoology,9-HDA and HVA,4,1,1070,1071,1,
Zoology,9-HDA and HVA,4,1,1087,1090,3,
Zoology,9-HDA and HVA,4,1,1091,1091,0,
Zoology,9-HDA and HVA,4,1,1112,1113,1,
Zoology,9-HDA and HVA,4,1,1114,1115,1,
Zoology,9-HDA and HVA,4,1,1117,1117,0,
Zoology,9-HDA and HVA,4,1,1152,1161,9,
Zoology,9-HDA and HVA,4,1,1176,1180,4,
Zoology,9-HDA and HVA,4,1,1182,1182,0,
Zoology,9-HDA and HVA,4,1,1192,1194,2,
Zoology,9-HDA and HVA,4,1,1198,1199,1,
Zoology,9-HDA and HVA,4,1,1207,1212,5,
Zoology,9-HDA and HVA,4,1,1234,1236,2,
Zoology,9-HDA and HVA,4,1,1238,1239,1,
Zoology,9-HDA and HVA,4,1,1245,1245,0,
Zoology,9-HDA and HVA,4,1,1270,1270,0,
Zoology,9-HDA and HVA,4,1,1309,1310,1,
Zoology,9-HDA and HVA,4,1,1326,1326,0,
Zoology,9-HDA and HVA,4,1,1340,1340,0,
Zoology,9-HDA and HVA,4,1,1351,1351,0,
Zoology,9-HDA and HVA,4,1,1365,1366,1,
Zoology,9-HDA and HVA,4,1,1389,1390,1,
Zoology,9-HDA and HVA,4,1,1410,1410,0,
Zoology,9-HDA and HVA,4,1,1435,1440,5,
Zoology,9-HDA and HVA,4,1,1501,1503,2,
Zoology,9-HDA and HVA,4,1,1506,1506,0,
Zoology,9-HDA and HVA,4,1,1550,1551,1,
Zoology,9-HDA and HVA,4,1,1555,1556,1,
Zoology,9-HDA and HVA,4,1,1575,1575,0,
Zoology,9-HDA and HVA,4,1,1589,1589,0,
Zoology,9-HDA and HVA,4,1,1597,1597,0,
Zoology,9-HDA and HVA,4,1,1650,1651,1,
Zoology,9-HDA and HVA,4,1,1678,1678,0,
Zoology,9-HDA and HVA,4,1,1711,1711,0,
Zoology,9-HDA and HVA,4,1,1746,1746,0,
Zoology,9-HDA and HVA,4,1,1759,1762,3,
Zoology,9-HDA and HVA,4,1,1771,1771,0,
Zoology,9-HDA and HVA,4,1,1779,1779,0,
Zoology,9-HDA and HVA,4,1,1781,1787,6,
Zoology,9-HDA and HVA,4,1,1793,1794,1,
Zoology,9-HDA and HVA,5,10,0,80,80,
Zoology,9-HDA and HVA,5,10,40,41,1,
Zoology,9-HDA and HVA,5,10,126,225,99,
Zoology,9-HDA and HVA,5,10,192,194,2,
Zoology,9-HDA and HVA,5,10,231,235,4,maybe - sniffed from afar
Zoology,9-HDA and HVA,5,10,243,677,434,
Zoology,9-HDA and HVA,5,10,269,270,1,
Zoology,9-HDA and HVA,5,10,310,312,2,
Zoology,9-HDA and HVA,5,10,323,324,1,
Zoology,9-HDA and HVA,5,10,330,331,1,
Zoology,9-HDA and HVA,5,10,335,335,0,
Zoology,9-HDA and HVA,5,10,355,356,1,
Zoology,9-HDA and HVA,5,10,372,375,3,
Zoology,9-HDA and HVA,5,10,392,392,0,
Zoology,9-HDA and HVA,5,10,403,406,3,
Zoology,9-HDA and HVA,5,10,427,430,3,
Zoology,9-HDA and HVA,5,10,453,457,4,
Zoology,9-HDA and HVA,5,10,491,492,1,
Zoology,9-HDA and HVA,5,10,562,563,1,
Zoology,9-HDA and HVA,5,10,580,580,0,
Zoology,9-HDA and HVA,5,10,631,633,2,
Zoology,9-HDA and HVA,5,10,638,640,2,
Zoology,9-HDA and HVA,5,10,666,670,4,
Zoology,9-HDA and HVA,5,10,678,679,1,
Zoology,9-HDA and HVA,5,10,735,735,0,
Zoology,9-HDA and HVA,5,10,737,738,1,
Zoology,9-HDA and HVA,5,10,686,1193,507,
Zoology,9-HDA and HVA,5,10,680,682,2,
Zoology,9-HDA and HVA,5,10,735,735,0,
Zoology,9-HDA and HVA,5,10,737,738,1,
Zoology,9-HDA and HVA,5,10,746,746,0,
Zoology,9-HDA and HVA,5,10,749,752,3,
Zoology,9-HDA and HVA,5,10,781,783,2,
Zoology,9-HDA and HVA,5,10,788,788,0,
Zoology,9-HDA and HVA,5,10,798,798,0,
Zoology,9-HDA and HVA,5,10,823,824,1,
Zoology,9-HDA and HVA,5,10,838,838,0,
Zoology,9-HDA and HVA,5,10,855,856,1,
Zoology,9-HDA and HVA,5,10,856,857,1,
Zoology,9-HDA and HVA,5,10,889,889,0,
Zoology,9-HDA and HVA,5,10,915,919,4,
Zoology,9-HDA and HVA,5,10,935,1058,123,
Zoology,9-HDA and HVA,5,10,937,938,1,
Zoology,9-HDA and HVA,5,10,949,949,0,
Zoology,9-HDA and HVA,5,10,959,960,1,
Zoology,9-HDA and HVA,5,10,973,973,0,
Zoology,9-HDA and HVA,5,10,980,980,0,
Zoology,9-HDA and HVA,5,10,981,982,1,
Zoology,9-HDA and HVA,5,10,1015,1016,1,
Zoology,9-HDA and HVA,5,10,1020,1020,0,
Zoology,9-HDA and HVA,5,10,1033,1033,0,maybe just bumps in to paper
Zoology,9-HDA and HVA,5,10,1063,1064,1,
Zoology,9-HDA and HVA,5,10,1143,1143,0,
Zoology,9-HDA and HVA,5,10,1149,1155,6,bee sort of sniffs from afar
Zoology,9-HDA and HVA,5,10,1187,1188,1,
Zoology,9-HDA and HVA,5,10,1257,1260,3,
Zoology,9-HDA and HVA,5,10,1260,1260,0,
Zoology,9-HDA and HVA,5,10,1274,1274,0,
Zoology,9-HDA and HVA,5,10,1366,1372,6,
Zoology,9-HDA and HVA,5,10,1387,1387,0,
Zoology,9-HDA and HVA,5,10,1566,1566,0,
Zoology,9-HDA and HVA,5,10,1567,1568,1,
Zoology,9-HDA and HVA,5,10,1583,1588,5,
Zoology,9-HDA and HVA,5,10,1587,1590,3,
Zoology,9-HDA and HVA,5,10,1589,1590,1,
Zoology,9-HDA and HVA,5,10,1602,1602,0,
Zoology,9-HDA and HVA,5,10,1621,1622,1,
Zoology,9-HDA and HVA,5,10,1644,1644,0,
Zoology,9-HDA and HVA,5,10,1697,1698,1,
Zoology,9-HDA and HVA,5,10,1708,1708,0,
Zoology,9-HDA and HVA,5,10,1727,1791,64,
Zoology,9-HDA and HVA,5,10,1797,1798,1,
Zoology,9-HDA and HVA,6,8,38,38,0,
Zoology,9-HDA and HVA,6,8,92,92,0,
Zoology,9-HDA and HVA,6,8,140,141,1,
Zoology,9-HDA and HVA,6,8,169,169,0,
Zoology,9-HDA and HVA,6,8,172,178,6,
Zoology,9-HDA and HVA,6,8,207,209,2,
Zoology,9-HDA and HVA,6,8,209,209,0,
Zoology,9-HDA and HVA,6,8,251,257,6,
Zoology,9-HDA and HVA,6,8,251,252,1,
Zoology,9-HDA and HVA,6,8,345,346,1,
Zoology,9-HDA and HVA,6,8,354,354,0,
Zoology,9-HDA and HVA,6,8,364,364,0,
Zoology,9-HDA and HVA,6,8,379,380,1,
Zoology,9-HDA and HVA,6,8,401,405,4,
Zoology,9-HDA and HVA,6,8,407,408,1,
Zoology,9-HDA and HVA,6,8,424,425,1,
Zoology,9-HDA and HVA,6,8,433,433,0,
Zoology,9-HDA and HVA,6,8,470,471,1,
Zoology,9-HDA and HVA,6,8,495,496,1,
Zoology,9-HDA and HVA,6,8,504,504,0,
Zoology,9-HDA and HVA,6,8,549,550,1,
Zoology,9-HDA and HVA,6,8,563,563,0,
Zoology,9-HDA and HVA,6,8,571,574,3,
Zoology,9-HDA and HVA,6,8,593,593,0,
Zoology,9-HDA and HVA,6,8,602,603,1,
Zoology,9-HDA and HVA,6,8,631,633,2,
Zoology,9-HDA and HVA,6,8,643,643,0,
Zoology,9-HDA and HVA,6,8,650,651,1,
Zoology,9-HDA and HVA,6,8,662,662,0,
Zoology,9-HDA and HVA,6,8,668,668,0,
Zoology,9-HDA and HVA,6,8,683,684,1,
Zoology,9-HDA and HVA,6,8,705,705,0,
Zoology,9-HDA and HVA,6,8,770,771,1,
Zoology,9-HDA and HVA,6,8,824,825,1,
Zoology,9-HDA and HVA,6,8,952,953,1,
Zoology,9-HDA and HVA,6,8,873,874,1,
Zoology,9-HDA and HVA,6,8,901,914,13,
Zoology,9-HDA and HVA,6,8,916,917,1,
Zoology,9-HDA and HVA,6,8,923,925,2,
Zoology,9-HDA and HVA,6,8,933,936,3,
Zoology,9-HDA and HVA,6,8,937,938,1,
Zoology,9-HDA and HVA,6,8,952,958,6,
Zoology,9-HDA and HVA,6,8,960,960,0,
Zoology,9-HDA and HVA,6,8,1068,1070,2,
Zoology,9-HDA and HVA,6,8,1076,1078,2,
Zoology,9-HDA and HVA,6,8,1099,1099,0,
Zoology,9-HDA and HVA,6,8,1116,1119,3,
Zoology,9-HDA and HVA,6,8,1118,1119,1,
Zoology,9-HDA and HVA,6,8,1177,1180,3,
Zoology,9-HDA and HVA,6,8,1189,1191,2,
Zoology,9-HDA and HVA,6,8,1210,1218,8,
Zoology,9-HDA and HVA,6,8,1232,1234,2,
Zoology,9-HDA and HVA,6,8,1285,1285,0,
Zoology,9-HDA and HVA,6,8,1308,1310,2,
Zoology,9-HDA and HVA,6,8,1347,1347,0,
Zoology,9-HDA and HVA,6,8,1347,1348,1,
Zoology,9-HDA and HVA,6,8,1419,1422,3,
Zoology,9-HDA and HVA,6,8,1424,1469,45,bee periodically sniffs and sits still next to the paper
Zoology,9-HDA and HVA,6,8,1426,1428,2,
Zoology,9-HDA and HVA,6,8,1477,1477,0,
Zoology,9-HDA and HVA,6,8,1478,1478,0,
Zoology,9-HDA and HVA,6,8,1507,1509,2,
Zoology,9-HDA and HVA,6,8,1554,1555,1,
Zoology,9-HDA and HVA,6,8,1615,1619,4,
Zoology,9-HDA and HVA,6,8,1682,1690,8,
Zoology,9-HDA and HVA,6,8,1709,1721,12,
Zoology,9-HDA and HVA,6,8,1729,1732,3,
Zoology,9-HDA and HVA,6,8,1765,1770,5,
Zoology,9-HDA and HVA,6,8,1776,1778,2,
Zoology,9-HDA and HVA,6,8,1795,1798,3,
Zoology,9-HDA and HVA,7,10,0,2,2,
Zoology,9-HDA and HVA,7,10,42,46,4,
Zoology,9-HDA and HVA,7,10,66,68,2,
Zoology,9-HDA and HVA,7,10,78,78,0,
Zoology,9-HDA and HVA,7,10,120,120,0,
Zoology,9-HDA and HVA,7,10,127,128,1,
Zoology,9-HDA and HVA,7,10,129,129,0,
Zoology,9-HDA and HVA,7,10,153,199,46,
Zoology,9-HDA and HVA,7,10,182,182,0,
Zoology,9-HDA and HVA,7,10,250,252,2,
Zoology,9-HDA and HVA,7,10,275,288,13,
Zoology,9-HDA and HVA,7,10,290,292,2,
Zoology,9-HDA and HVA,7,10,323,323,0,
Zoology,9-HDA and HVA,7,10,325,329,4,
Zoology,9-HDA and HVA,7,10,332,338,6,
Zoology,9-HDA and HVA,7,10,339,339,0,
Zoology,9-HDA and HVA,7,10,352,359,7,
Zoology,9-HDA and HVA,7,10,355,355,0,
Zoology,9-HDA and HVA,7,10,399,405,6,
Zoology,9-HDA and HVA,7,10,414,418,4,
Zoology,9-HDA and HVA,7,10,424,426,2,
Zoology,9-HDA and HVA,7,10,435,436,1,
Zoology,9-HDA and HVA,7,10,459,459,0,
Zoology,9-HDA and HVA,7,10,480,481,1,
Zoology,9-HDA and HVA,7,10,513,513,0,
Zoology,9-HDA and HVA,7,10,519,519,0,
Zoology,9-HDA and HVA,7,10,555,555,0,
Zoology,9-HDA and HVA,7,10,567,572,5,
Zoology,9-HDA and HVA,7,10,574,577,3,
Zoology,9-HDA and HVA,7,10,577,578,1,
Zoology,9-HDA and HVA,7,10,588,599,11,
Zoology,9-HDA and HVA,7,10,610,621,11,
Zoology,9-HDA and HVA,7,10,627,634,7,
Zoology,9-HDA and HVA,7,10,630,634,4,
Zoology,9-HDA and HVA,7,10,639,639,0,
Zoology,9-HDA and HVA,7,10,694,694,0,
Zoology,9-HDA and HVA,7,10,744,744,0,
Zoology,9-HDA and HVA,7,10,746,746,0,
Zoology,9-HDA and HVA,7,10,767,767,0,
Zoology,9-HDA and HVA,7,10,780,780,0,
Zoology,9-HDA and HVA,7,10,795,795,0,
Zoology,9-HDA and HVA,7,10,815,816,1,
Zoology,9-HDA and HVA,7,10,888,892,4,
Zoology,9-HDA and HVA,7,10,895,895,0,
Zoology,9-HDA and HVA,7,10,899,899,0,
Zoology,9-HDA and HVA,7,10,911,911,0,
Zoology,9-HDA and HVA,7,10,940,943,3,
Zoology,9-HDA and HVA,7,10,948,953,5,
Zoology,9-HDA and HVA,7,10,957,957,0,
Zoology,9-HDA and HVA,7,10,958,958,0,
Zoology,9-HDA and HVA,7,10,969,969,0,
Zoology,9-HDA and HVA,7,10,984,984,0,
Zoology,9-HDA and HVA,7,10,1012,1013,1,
Zoology,9-HDA and HVA,7,10,1090,1090,0,
Zoology,9-HDA and HVA,7,10,1095,1097,2,
Zoology,9-HDA and HVA,7,10,1121,1123,2,
Zoology,9-HDA and HVA,7,10,1129,1129,0,
Zoology,9-HDA and HVA,7,10,1137,1138,1,
Zoology,9-HDA and HVA,7,10,1176,1187,11,
Zoology,9-HDA and HVA,7,10,1180,1181,1,
Zoology,9-HDA and HVA,7,10,1192,1193,1,
Zoology,9-HDA and HVA,7,10,1196,1197,1,
Zoology,9-HDA and HVA,7,10,1221,1221,0,
Zoology,9-HDA and HVA,7,10,1266,1266,0,
Zoology,9-HDA and HVA,7,10,1295,1298,3,
Zoology,9-HDA and HVA,7,10,1337,1339,2,
Zoology,9-HDA and HVA,7,10,1407,1408,1,
Zoology,9-HDA and HVA,7,10,1455,1456,1,
Zoology,9-HDA and HVA,7,10,1568,1578,10,
Zoology,9-HDA and HVA,7,10,1587,1602,15,
Zoology,9-HDA and HVA,7,10,1703,1703,0,
Zoology,9-HDA and HVA,7,10,1741,1741,0,
Zoology,9-HDA and HVA,7,10,1762,1762,0,
Zoology,9-HDA and HVA,7,10,1775,1775,0,
Zoology,9-HDA and HVA,7,10,1792,1797,5,
Zoology,9-HDA and HVA,8,6,11,11,0,
Zoology,9-HDA and HVA,8,6,14,14,0,
Zoology,9-HDA and HVA,8,6,33,33,0,
Zoology,9-HDA and HVA,8,6,82,82,0,
Zoology,9-HDA and HVA,8,6,118,118,0,
Zoology,9-HDA and HVA,8,6,166,166,0,
Zoology,9-HDA and HVA,8,6,178,178,0,
Zoology,9-HDA and HVA,8,6,181,183,2,
Zoology,9-HDA and HVA,8,6,186,188,2,bee walks over paper's corner
Zoology,9-HDA and HVA,8,6,192,192,0,
Zoology,9-HDA and HVA,8,6,221,222,1,
Zoology,9-HDA and HVA,8,6,237,237,0,
Zoology,9-HDA and HVA,8,6,271,271,0,
Zoology,9-HDA and HVA,8,6,322,323,1,
Zoology,9-HDA and HVA,8,6,323,323,0,
Zoology,9-HDA and HVA,8,6,326,326,0,
Zoology,9-HDA and HVA,8,6,341,342,1,
Zoology,9-HDA and HVA,8,6,359,359,0,
Zoology,9-HDA and HVA,8,6,400,401,1,
Zoology,9-HDA and HVA,8,6,411,411,0,
Zoology,9-HDA and HVA,8,6,436,438,2,
Zoology,9-HDA and HVA,8,6,454,454,0,
Zoology,9-HDA and HVA,8,6,462,462,0,bee touches corner really fast as it walks
Zoology,9-HDA and HVA,8,6,502,506,4,
Zoology,9-HDA and HVA,8,6,538,540,2,
Zoology,9-HDA and HVA,8,6,553,560,7,
Zoology,9-HDA and HVA,8,6,576,576,0,
Zoology,9-HDA and HVA,8,6,619,620,1,
Zoology,9-HDA and HVA,8,6,683,683,0,
Zoology,9-HDA and HVA,8,6,754,754,0,
Zoology,9-HDA and HVA,8,6,774,774,0,
Zoology,9-HDA and HVA,8,6,802,803,1,
Zoology,9-HDA and HVA,8,6,834,835,1,
Zoology,9-HDA and HVA,8,6,843,845,2,
Zoology,9-HDA and HVA,8,6,843,845,2,
Zoology,9-HDA and HVA,8,6,853,853,0,
Zoology,9-HDA and HVA,8,6,892,893,1,
Zoology,9-HDA and HVA,8,6,941,945,4,
Zoology,9-HDA and HVA,8,6,958,961,3,
Zoology,9-HDA and HVA,8,6,966,966,0,
Zoology,9-HDA and HVA,8,6,982,982,0,
Zoology,9-HDA and HVA,8,6,1053,1054,1,
Zoology,9-HDA and HVA,8,6,1092,1114,22,"bee facing paper still at a distance may be sniffing, i think not though"
Zoology,9-HDA and HVA,8,6,1117,1117,0,
Zoology,9-HDA and HVA,8,6,1134,1139,5,
Zoology,9-HDA and HVA,8,6,1171,1174,3,bee walks over paper
Zoology,9-HDA and HVA,8,6,1265,1265,0,
Zoology,9-HDA and HVA,8,6,1273,1273,0,
Zoology,9-HDA and HVA,8,6,1282,1282,0,
Zoology,9-HDA and HVA,8,6,1427,1429,2,
Zoology,9-HDA and HVA,8,6,1430,1431,1,
Zoology,9-HDA and HVA,8,6,1433,1435,2,bee drags paper with legs almost seems accidental
Zoology,9-HDA and HVA,8,6,1588,1590,2,bee walks over paper
Zoology,9-HDA and HVA,9,7,49,49,0,
Zoology,9-HDA and HVA,9,7,57,65,8,
Zoology,9-HDA and HVA,9,7,142,142,0,
Zoology,9-HDA and HVA,9,7,189,190,1,
Zoology,9-HDA and HVA,9,7,193,199,6,stays sitting on paper until 3:21
Zoology,9-HDA and HVA,9,7,222,223,1,
Zoology,9-HDA and HVA,9,7,259,260,1,
Zoology,9-HDA and HVA,9,7,263,263,0,
Zoology,9-HDA and HVA,9,7,269,270,1,
Zoology,9-HDA and HVA,9,7,273,274,1,
Zoology,9-HDA and HVA,9,7,283,283,0,
Zoology,9-HDA and HVA,9,7,461,461,0,
Zoology,9-HDA and HVA,9,7,472,475,3,
Zoology,9-HDA and HVA,9,7,554,554,0,
Zoology,9-HDA and HVA,9,7,589,595,6,
Zoology,9-HDA and HVA,9,7,607,611,4,
Zoology,9-HDA and HVA,9,7,616,617,1,
Zoology,9-HDA and HVA,9,7,621,623,2,
Zoology,9-HDA and HVA,9,7,625,625,0,maybe - fast touch as its walsking past
Zoology,9-HDA and HVA,9,7,667,667,0,
Zoology,9-HDA and HVA,9,7,677,681,4,
Zoology,9-HDA and HVA,9,7,685,685,0,
Zoology,9-HDA and HVA,9,7,712,716,4,
Zoology,9-HDA and HVA,9,7,731,734,3,
Zoology,9-HDA and HVA,9,7,756,756,0,
Zoology,9-HDA and HVA,9,7,761,762,1,
Zoology,9-HDA and HVA,9,7,771,772,1,
Zoology,9-HDA and HVA,9,7,780,781,1,
Zoology,9-HDA and HVA,9,7,858,861,3,
Zoology,9-HDA and HVA,9,7,870,870,0,
Zoology,9-HDA and HVA,9,7,908,908,0,maybe - fast touch as its walking past
Zoology,9-HDA and HVA,9,7,1078,1080,2,
Zoology,9-HDA and HVA,9,7,1081,1082,1,
Zoology,9-HDA and HVA,9,7,1096,1096,0,
Zoology,9-HDA and HVA,9,7,1145,1147,2,wee walks over edge of paper
Zoology,9-HDA and HVA,9,7,549,550,1,
Zoology,9-HDA and HVA,9,7,1168,1173,5,
Zoology,9-HDA and HVA,9,7,1242,1243,1,
Zoology,9-HDA and HVA,9,7,1297,1299,2,
Zoology,9-HDA and HVA,9,7,1316,1318,2,
Zoology,9-HDA and HVA,9,7,1371,1372,1,maybe sort of sideways touch
Zoology,9-HDA and HVA,9,7,1373,1373,0,maybe - fast touch as its walking past
Zoology,9-HDA and HVA,9,7,1412,1412,0,
Zoology,9-HDA and HVA,9,7,1417,1417,0,maybe - fast touch as its walking past
Zoology,9-HDA and HVA,9,7,1473,1474,1,
Zoology,9-HDA and HVA,9,7,1533,1533,0,
Zoology,9-HDA and HVA,9,7,1538,1546,8,
Zoology,9-HDA and HVA,9,7,1715,1716,1,
Zoology,9-HDA and HVA,9,7,1716,1717,1,
Zoology,9-HDA and HVA,9,7,1721,1722,1,
Zoology,9-HDA and HVA,9,7,1723,1726,3,
Zoology,9-HDA and HVA,11,8,4,4,0,
Zoology,9-HDA and HVA,11,8,25,25,0,
Zoology,9-HDA and HVA,11,8,27,27,0,
Zoology,9-HDA and HVA,11,8,36,41,5,
Zoology,9-HDA and HVA,11,8,43,43,0,
Zoology,9-HDA and HVA,11,8,65,68,3,
Zoology,9-HDA and HVA,11,8,98,99,1,
Zoology,9-HDA and HVA,11,8,130,132,2,bee sits on paper until 2:14
Zoology,9-HDA and HVA,11,8,142,142,0,
Zoology,9-HDA and HVA,11,8,149,151,2,
Zoology,9-HDA and HVA,11,8,154,157,3,
Zoology,9-HDA and HVA,11,8,157,159,2,
Zoology,9-HDA and HVA,11,8,164,164,0,
Zoology,9-HDA and HVA,11,8,167,168,1,
Zoology,9-HDA and HVA,11,8,169,173,4,
Zoology,9-HDA and HVA,11,8,189,190,1,
Zoology,9-HDA and HVA,11,8,232,234,2,
Zoology,9-HDA and HVA,11,8,301,302,1,
Zoology,9-HDA and HVA,11,8,337,344,7,
Zoology,9-HDA and HVA,11,8,355,355,0,
Zoology,9-HDA and HVA,11,8,361,363,2,bee maybe sniffing from afar
Zoology,9-HDA and HVA,11,8,375,376,1,
Zoology,9-HDA and HVA,11,8,411,411,0,
Zoology,9-HDA and HVA,11,8,445,445,0,
Zoology,9-HDA and HVA,11,8,448,448,0,
Zoology,9-HDA and HVA,11,8,456,457,1,bee maybe sniffing from afar
Zoology,9-HDA and HVA,11,8,471,471,0,
Zoology,9-HDA and HVA,11,8,503,504,1,
Zoology,9-HDA and HVA,11,8,517,520,3,
Zoology,9-HDA and HVA,11,8,566,566,0,
Zoology,9-HDA and HVA,11,8,600,601,1,
Zoology,9-HDA and HVA,11,8,608,609,1,
Zoology,9-HDA and HVA,11,8,614,614,0,
Zoology,9-HDA and HVA,11,8,642,642,0,
Zoology,9-HDA and HVA,11,8,649,649,0,
Zoology,9-HDA and HVA,11,8,695,699,4,
Zoology,9-HDA and HVA,11,8,705,714,9,
Zoology,9-HDA and HVA,11,8,721,728,7,
Zoology,9-HDA and HVA,11,8,729,733,4,
Zoology,9-HDA and HVA,11,8,739,740,1,
Zoology,9-HDA and HVA,11,8,750,781,31,
Zoology,9-HDA and HVA,11,8,783,784,1,
Zoology,9-HDA and HVA,11,8,796,799,3,
Zoology,9-HDA and HVA,11,8,800,801,1,
Zoology,9-HDA and HVA,11,8,831,832,1,
Zoology,9-HDA and HVA,11,8,847,855,8,
Zoology,9-HDA and HVA,11,8,866,871,5,bee maybe sniffing from afar
Zoology,9-HDA and HVA,11,8,872,873,1,
Zoology,9-HDA and HVA,11,8,879,881,2,
Zoology,9-HDA and HVA,11,8,915,916,1,
Zoology,9-HDA and HVA,11,8,921,921,0,
Zoology,9-HDA and HVA,11,8,970,1001,31,
Zoology,9-HDA and HVA,11,8,1003,1003,0,
Zoology,9-HDA and HVA,11,8,1013,1014,1,
Zoology,9-HDA and HVA,11,8,1062,1062,0,
Zoology,9-HDA and HVA,11,8,1085,1085,0,
Zoology,9-HDA and HVA,11,8,1141,1141,0,
Zoology,9-HDA and HVA,11,8,1154,1154,0,
Zoology,9-HDA and HVA,11,8,1172,1172,0,
Zoology,9-HDA and HVA,11,8,1185,1186,1,
Zoology,9-HDA and HVA,11,8,1199,1199,0,
Zoology,9-HDA and HVA,11,8,1208,1208,0,
Zoology,9-HDA and HVA,11,8,1320,1322,2,
Zoology,9-HDA and HVA,11,8,1321,1326,5,
Zoology,9-HDA and HVA,11,8,1341,1346,5,
Zoology,9-HDA and HVA,11,8,1363,1375,12,bee sniffing from afar I think
Zoology,9-HDA and HVA,11,8,1375,1375,0,
Zoology,9-HDA and HVA,11,8,1390,1398,8,
Zoology,9-HDA and HVA,11,8,1406,1411,5,
Zoology,9-HDA and HVA,11,8,1413,1413,0,
Zoology,9-HDA and HVA,11,8,1463,1465,2,
Zoology,9-HDA and HVA,11,8,1465,1470,5,
Zoology,9-HDA and HVA,11,8,1466,1466,0,
Zoology,9-HDA and HVA,11,8,1471,1471,0,
Zoology,9-HDA and HVA,11,8,1473,1475,2,
Zoology,9-HDA and HVA,11,8,1482,1482,0,
Zoology,9-HDA and HVA,11,8,1502,1502,0,
Zoology,9-HDA and HVA,11,8,1521,1522,1,
Zoology,9-HDA and HVA,11,8,1526,1526,0,
Zoology,9-HDA and HVA,11,8,1533,1537,4,
Zoology,9-HDA and HVA,11,8,1555,1555,0,
Zoology,9-HDA and HVA,11,8,1556,1556,0,
Zoology,9-HDA and HVA,11,8,1559,1559,0,
Zoology,9-HDA and HVA,11,8,1562,1565,3,
Zoology,9-HDA and HVA,11,8,1569,1569,0,
Zoology,9-HDA and HVA,11,8,1588,1589,1,
Zoology,9-HDA and HVA,11,8,1598,1598,0,
Zoology,9-HDA and HVA,11,8,1608,1609,1,
Zoology,9-HDA and HVA,11,8,1702,1702,0,
Zoology,9-HDA and HVA,11,8,1743,1746,3,
Zoology,9-HDA and HVA,11,8,1754,1755,1,
Zoology,9-HDA and HVA,11,8,1761,1763,2,
Zoology,9-HDA and HVA,11,8,1765,1765,0,
Zoology,9-HDA and HVA,11,8,1765,1767,2,
Zoology,9-HDA and HVA,11,8,1788,1789,1,
Zoology,9-HDA and HVA,14,1,238,239,1,
Zoology,9-HDA and HVA,14,1,263,263,0,very fast touch
Zoology,9-HDA and HVA,14,1,275,277,2,
Zoology,9-HDA and HVA,14,1,290,290,0,
Zoology,9-HDA and HVA,14,1,336,338,2,
Zoology,9-HDA and HVA,14,1,384,385,1,
Zoology,9-HDA and HVA,14,1,414,415,1,
Zoology,9-HDA and HVA,14,1,430,432,2,
Zoology,9-HDA and HVA,14,1,463,464,1,
Zoology,9-HDA and HVA,14,1,480,481,1,
Zoology,9-HDA and HVA,14,1,578,578,0,not sure - side touch
Zoology,9-HDA and HVA,14,1,599,599,0,
Zoology,9-HDA and HVA,14,1,671,673,2,
Zoology,9-HDA and HVA,14,1,754,754,0,
Zoology,9-HDA and HVA,14,1,765,765,0,bump in to paper maybe
Zoology,9-HDA and HVA,14,1,775,775,0,
Zoology,9-HDA and HVA,14,1,834,834,0,
Zoology,9-HDA and HVA,14,1,963,964,1,
Zoology,9-HDA and HVA,14,1,1183,1183,0,
Zoology,9-HDA and HVA,14,1,1213,1213,0,
Zoology,9-HDA and HVA,14,1,1288,1298,10,
Zoology,9-HDA and HVA,14,1,1288,1291,3,
Zoology,9-HDA and HVA,14,1,1347,1350,3,
Zoology,9-HDA and HVA,14,1,1359,1359,0,
Zoology,9-HDA and HVA,14,1,1384,1387,3,
Zoology,9-HDA and HVA,14,1,1432,1432,0,not too sure
Zoology,9-HDA and HVA,14,1,1437,1444,7,
Zoology,9-HDA and HVA,14,1,1583,1585,2,
Zoology,9-HDA and HVA,14,1,1621,1621,0,
Zoology,9-HDA and HVA,14,1,1627,1627,0,
Zoology,9-HDA and HVA,14,1,1749,1749,0,
Zoology,9-HDA and HVA,18,3,36,37,1,
Zoology,9-HDA and HVA,18,3,58,58,0,
Zoology,9-HDA and HVA,18,3,277,281,4,nto sure bee sniff from a distance
Zoology,9-HDA and HVA,18,3,285,286,1,
Zoology,9-HDA and HVA,18,3,334,341,7,bee sits on paper until 5:45
Zoology,9-HDA and HVA,18,3,400,403,3,
Zoology,9-HDA and HVA,18,3,517,519,2,bee walks alongside paper very close
Zoology,9-HDA and HVA,18,3,620,624,4,
Zoology,9-HDA and HVA,18,3,620,1231,611,
Zoology,9-HDA and HVA,18,3,897,898,1,
Zoology,9-HDA and HVA,18,3,918,922,4,
Zoology,9-HDA and HVA,18,3,952,955,3,
Zoology,9-HDA and HVA,18,3,1083,1083,0,
Zoology,9-HDA and HVA,18,3,1105,1105,0,
Zoology,9-HDA and HVA,18,3,1134,1141,7,
Zoology,9-HDA and HVA,18,3,1175,1180,5,
Zoology,9-HDA and HVA,18,3,1192,1193,1,
Zoology,9-HDA and HVA,18,3,1223,1223,0,
Zoology,9-HDA and HVA,18,3,1322,1323,1,
Zoology,9-HDA and HVA,18,3,1380,1381,1,
Zoology,9-HDA and HVA,18,3,1402,1406,4,
Zoology,9-HDA and HVA,18,3,1444,1444,0,
Zoology,9-HDA and HVA,18,3,1448,1448,0,
Zoology,9-HDA and HVA,18,3,1449,1450,1,
Zoology,9-HDA and HVA,18,3,1464,1464,0,
Zoology,9-HDA and HVA,18,3,1657,1658,1,
Zoology,9-HDA and HVA,18,3,1738,1740,2,
Zoology,9-HDA and HVA,18,3,1743,1744,1,
Zoology,9-HDA and HVA,18,3,1757,1757,0,
Zoology,9-HDA and HVA,19,11,49,54,5,
Zoology,9-HDA and HVA,19,11,84,86,2,
Zoology,9-HDA and HVA,19,11,114,114,0,
Zoology,9-HDA and HVA,19,11,150,150,0,
Zoology,9-HDA and HVA,19,11,165,165,0,
Zoology,9-HDA and HVA,19,11,174,182,8,
Zoology,9-HDA and HVA,19,11,218,219,1,
Zoology,9-HDA and HVA,19,11,237,237,0,
Zoology,9-HDA and HVA,19,11,292,293,1,
Zoology,9-HDA and HVA,19,11,298,298,0,
Zoology,9-HDA and HVA,19,11,363,363,0,
Zoology,9-HDA and HVA,19,11,386,387,1,
Zoology,9-HDA and HVA,19,11,396,397,1,
Zoology,9-HDA and HVA,19,11,404,406,2,
Zoology,9-HDA and HVA,19,11,407,409,2,
Zoology,9-HDA and HVA,19,11,447,449,2,
Zoology,9-HDA and HVA,19,11,467,470,3,
Zoology,9-HDA and HVA,19,11,467,470,3,
Zoology,9-HDA and HVA,19,11,531,534,3,
Zoology,9-HDA and HVA,19,11,582,582,0,
Zoology,9-HDA and HVA,19,11,583,584,1,
Zoology,9-HDA and HVA,19,11,598,601,3,
Zoology,9-HDA and HVA,19,11,617,619,2,
Zoology,9-HDA and HVA,19,11,623,623,0,
Zoology,9-HDA and HVA,19,11,638,640,2,
Zoology,9-HDA and HVA,19,11,644,645,1,
Zoology,9-HDA and HVA,19,11,695,696,1,
Zoology,9-HDA and HVA,19,11,706,707,1,
Zoology,9-HDA and HVA,19,11,852,854,2,
Zoology,9-HDA and HVA,19,11,936,939,3,
Zoology,9-HDA and HVA,19,11,944,944,0,
Zoology,9-HDA and HVA,19,11,944,945,1,
Zoology,9-HDA and HVA,19,11,954,954,0,
Zoology,9-HDA and HVA,19,11,967,970,3,
Zoology,9-HDA and HVA,19,11,973,973,0,
Zoology,9-HDA and HVA,19,11,999,999,0,
Zoology,9-HDA and HVA,19,11,1015,1017,2,
Zoology,9-HDA and HVA,19,11,1037,1037,0,
Zoology,9-HDA and HVA,19,11,1116,1118,2,
Zoology,9-HDA and HVA,19,11,1146,1148,2,
Zoology,9-HDA and HVA,19,11,1149,1149,0,
Zoology,9-HDA and HVA,19,11,1165,1165,0,
Zoology,9-HDA and HVA,19,11,1219,1219,0,
Zoology,9-HDA and HVA,19,11,1274,1274,0,
Zoology,9-HDA and HVA,19,11,1274,1276,2,
Zoology,9-HDA and HVA,19,11,1310,1310,0,
Zoology,9-HDA and HVA,19,11,1373,1377,4,
Zoology,9-HDA and HVA,19,11,1397,1408,11,
Zoology,9-HDA and HVA,19,11,1408,1408,0,
Zoology,9-HDA and HVA,19,11,1436,1439,3,
Zoology,9-HDA and HVA,19,11,1492,1492,0,
Zoology,9-HDA and HVA,19,11,1546,1546,0,
Zoology,9-HDA and HVA,19,11,1640,1642,2,
Zoology,9-HDA and HVA,19,11,1654,1655,1,
Zoology,9-HDA and HVA,19,11,1676,1679,3,
Zoology,9-HDA and HVA,19,11,1710,1711,1,
Zoology,9-HDA and HVA,19,11,1735,1736,1,
Zoology,9-HDA and HVA,19,11,1740,1740,0,
Zoology,9-HDA and HVA,19,11,1778,1778,0,
Zoology,9-HDA and HVA,19,11,1798,1800,2,
Zoology,9-HDA and HVA,23,5,17,18,1,
Zoology,9-HDA and HVA,23,5,20,20,0,
Zoology,9-HDA and HVA,23,5,31,33,2,
Zoology,9-HDA and HVA,23,5,41,41,0,
Zoology,9-HDA and HVA,23,5,42,44,2,
Zoology,9-HDA and HVA,23,5,80,80,0,
Zoology,9-HDA and HVA,23,5,84,86,2,
Zoology,9-HDA and HVA,23,5,102,104,2,
Zoology,9-HDA and HVA,23,5,114,115,1,
Zoology,9-HDA and HVA,23,5,116,116,0,
Zoology,9-HDA and HVA,23,5,118,118,0,
Zoology,9-HDA and HVA,23,5,129,131,2,
Zoology,9-HDA and HVA,23,5,148,148,0,
Zoology,9-HDA and HVA,23,5,153,154,1,
Zoology,9-HDA and HVA,23,5,156,157,1,
Zoology,9-HDA and HVA,23,5,165,165,0,
Zoology,9-HDA and HVA,23,5,177,179,2,
Zoology,9-HDA and HVA,23,5,207,209,2,
Zoology,9-HDA and HVA,23,5,215,218,3,
Zoology,9-HDA and HVA,23,5,240,240,0,
Zoology,9-HDA and HVA,23,5,248,249,1,
Zoology,9-HDA and HVA,23,5,256,256,0,
Zoology,9-HDA and HVA,23,5,267,268,1,
Zoology,9-HDA and HVA,23,5,270,270,0,
Zoology,9-HDA and HVA,23,5,276,276,0,
Zoology,9-HDA and HVA,23,5,298,298,0,
Zoology,9-HDA and HVA,23,5,298,298,0,
Zoology,9-HDA and HVA,23,5,314,316,2,
Zoology,9-HDA and HVA,23,5,318,318,0,
Zoology,9-HDA and HVA,23,5,374,374,0,
Zoology,9-HDA and HVA,23,5,455,455,0,
Zoology,9-HDA and HVA,23,5,538,539,1,
Zoology,9-HDA and HVA,23,5,562,563,1,
Zoology,9-HDA and HVA,23,5,583,583,0,
Zoology,9-HDA and HVA,23,5,595,596,1,
Zoology,9-HDA and HVA,23,5,620,620,0,
Zoology,9-HDA and HVA,23,5,813,813,0,
Zoology,9-HDA and HVA,23,5,819,881,62,
Zoology,9-HDA and HVA,23,5,877,877,0,
Zoology,9-HDA and HVA,23,5,887,888,1,
Zoology,9-HDA and HVA,23,5,937,937,0,
Zoology,9-HDA and HVA,23,5,938,938,0,
Zoology,9-HDA and HVA,23,5,1013,1013,0,
Zoology,9-HDA and HVA,23,5,1135,1135,0,
Zoology,9-HDA and HVA,23,5,1152,1152,0,
Zoology,9-HDA and HVA,23,5,1156,1156,0,
Zoology,9-HDA and HVA,23,5,1256,1256,0,
Zoology,9-HDA and HVA,23,5,1268,1268,0,
Zoology,9-HDA and HVA,23,5,1282,1285,3,
Zoology,9-HDA and HVA,23,5,1331,1333,2,
Zoology,9-HDA and HVA,23,5,1459,1459,0,
Zoology,9-HDA and HVA,23,5,1588,1589,1,
Zoology,9-HDA and HVA,23,5,1599,1599,0,
Zoology,9-HDA and HVA,23,5,1729,1729,0,
Zoology,9-HDA and HVA,23,5,1750,1750,0,
Zoology,9-HDA and HVA,27,6,29,30,1,
Zoology,9-HDA and HVA,27,6,81,81,0,
Zoology,9-HDA and HVA,27,6,215,219,4,
Zoology,9-HDA and HVA,27,6,246,246,0,
Zoology,9-HDA and HVA,27,6,295,296,1,
Zoology,9-HDA and HVA,27,6,299,299,0,
Zoology,9-HDA and HVA,27,6,324,324,0,
Zoology,9-HDA and HVA,27,6,457,457,0,
Zoology,9-HDA and HVA,27,6,490,491,1,
Zoology,9-HDA and HVA,27,6,501,501,0,
Zoology,9-HDA and HVA,27,6,508,509,1,
Zoology,9-HDA and HVA,27,6,511,512,1,
Zoology,9-HDA and HVA,27,6,563,563,0,
Zoology,9-HDA and HVA,27,6,715,718,3,
Zoology,9-HDA and HVA,27,6,895,895,0,
Zoology,9-HDA and HVA,27,6,934,935,1,
Zoology,9-HDA and HVA,27,6,942,942,0,
Zoology,9-HDA and HVA,27,6,963,963,0,
Zoology,9-HDA and HVA,27,6,973,973,0,
Zoology,9-HDA and HVA,27,6,1070,1070,0,
Zoology,9-HDA and HVA,27,6,1091,1091,0,
Zoology,9-HDA and HVA,27,6,1483,1485,2,
Zoology,9-HDA and HVA,27,6,1507,1507,0,
Zoology,9-HDA and HVA,27,6,1587,1593,6,
Zoology,9-HDA and HVA,27,6,1601,1601,0,
Zoology,9-HDA and HVA,27,6,1676,1676,0,
Zoology,9-HDA and HVA,27,6,1762,1763,1,
Zoology,9-HDA and HVA,32,10,43,43,0,
Zoology,9-HDA and HVA,32,10,84,84,0,
Zoology,9-HDA and HVA,32,10,110,113,3,
Zoology,9-HDA and HVA,32,10,122,123,1,
Zoology,9-HDA and HVA,32,10,141,141,0,
Zoology,9-HDA and HVA,32,10,152,152,0,
Zoology,9-HDA and HVA,32,10,192,192,0,
Zoology,9-HDA and HVA,32,10,201,202,1,
Zoology,9-HDA and HVA,32,10,210,210,0,
Zoology,9-HDA and HVA,32,10,382,382,0,
Zoology,9-HDA and HVA,32,10,399,399,0,
Zoology,9-HDA and HVA,32,10,459,459,0,
Zoology,9-HDA and HVA,32,10,481,481,0,
Zoology,9-HDA and HVA,32,10,508,508,0,
Zoology,9-HDA and HVA,32,10,518,519,1,
Zoology,9-HDA and HVA,32,10,524,524,0,
Zoology,9-HDA and HVA,32,10,548,548,0,
Zoology,9-HDA and HVA,32,10,554,558,4,
Zoology,9-HDA and HVA,32,10,665,669,4,
Zoology,9-HDA and HVA,32,10,753,760,7,
Zoology,9-HDA and HVA,32,10,810,810,0,
Zoology,9-HDA and HVA,32,10,749,749,0,
Zoology,9-HDA and HVA,32,10,968,970,2,bee walsk over it but seems to stop and sniff
Zoology,9-HDA and HVA,32,10,994,994,0,Bee bumbles in to it
Zoology,9-HDA and HVA,32,10,1036,1053,17,
Zoology,9-HDA and HVA,32,10,1053,1053,0,
Zoology,9-HDA and HVA,32,10,1068,1072,4,
Zoology,9-HDA and HVA,32,10,1078,1092,14,
Zoology,9-HDA and HVA,32,10,1128,1128,0,
Zoology,9-HDA and HVA,32,10,1141,1141,0,
Zoology,9-HDA and HVA,32,10,1144,1144,0,
Zoology,9-HDA and HVA,32,10,1204,1204,0,
Zoology,9-HDA and HVA,32,10,1228,1228,0,20:55
Zoology,9-HDA and HVA,32,10,1233,1233,0,
Zoology,9-HDA and HVA,32,10,1261,1261,0,
Zoology,9-HDA and HVA,32,10,1262,1262,0,
Zoology,9-HDA and HVA,32,10,1264,1276,12,
Zoology,9-HDA and HVA,32,10,1293,1457,164,
Zoology,9-HDA and HVA,32,10,1329,1329,0,
Zoology,9-HDA and HVA,32,10,1368,1374,6,
Zoology,9-HDA and HVA,32,10,1415,1415,0,
Zoology,9-HDA and HVA,32,10,1493,1494,1,
Zoology,9-HDA and HVA,32,10,1557,1558,1,
Zoology,9-HDA and HVA,32,10,1586,1586,0,
Zoology,9-HDA and HVA,32,10,1618,1618,0,
Zoology,9-HDA and HVA,32,10,1625,1625,0,
Zoology,9-ODA and HOB,4,4,8,8,0,
Zoology,9-ODA and HOB,4,4,41,41,0,
Zoology,9-ODA and HOB,4,4,43,44,1,
Zoology,9-ODA and HOB,4,4,74,74,0,
Zoology,9-ODA and HOB,4,4,118,119,1,
Zoology,9-ODA and HOB,4,4,129,129,0,
Zoology,9-ODA and HOB,4,4,140,141,1,
Zoology,9-ODA and HOB,4,4,154,154,0,
Zoology,9-ODA and HOB,4,4,212,213,1,
Zoology,9-ODA and HOB,4,4,234,235,1,
Zoology,9-ODA and HOB,4,4,237,237,0,
Zoology,9-ODA and HOB,4,4,286,288,2,
Zoology,9-ODA and HOB,4,4,308,309,1,
Zoology,9-ODA and HOB,4,4,404,406,2,
Zoology,9-ODA and HOB,4,4,471,472,1,
Zoology,9-ODA and HOB,4,4,476,478,2,
Zoology,9-ODA and HOB,4,4,486,489,3,
Zoology,9-ODA and HOB,4,4,511,513,2,
Zoology,9-ODA and HOB,4,4,554,559,5,
Zoology,9-ODA and HOB,4,4,575,575,0,
Zoology,9-ODA and HOB,4,4,646,648,2,
Zoology,9-ODA and HOB,4,4,650,654,4,
Zoology,9-ODA and HOB,4,4,657,660,3,
Zoology,9-ODA and HOB,4,4,674,674,0,
Zoology,9-ODA and HOB,4,4,698,703,5,
Zoology,9-ODA and HOB,4,4,705,706,1,
Zoology,9-ODA and HOB,4,4,707,707,0,
Zoology,9-ODA and HOB,4,4,707,707,0,
Zoology,9-ODA and HOB,4,4,723,723,0,
Zoology,9-ODA and HOB,4,4,725,725,0,
Zoology,9-ODA and HOB,4,4,759,759,0,
Zoology,9-ODA and HOB,4,4,780,781,1,
Zoology,9-ODA and HOB,4,4,790,791,1,
Zoology,9-ODA and HOB,4,4,807,807,0,
Zoology,9-ODA and HOB,4,4,810,814,4,
Zoology,9-ODA and HOB,4,4,839,841,2,
Zoology,9-ODA and HOB,4,4,844,845,1,
Zoology,9-ODA and HOB,4,4,852,854,2,
Zoology,9-ODA and HOB,4,4,859,860,1,
Zoology,9-ODA and HOB,4,4,867,869,2,
Zoology,9-ODA and HOB,4,4,1013,1017,4,
Zoology,9-ODA and HOB,4,4,1020,1024,4,bee sniffing from afar maybe
Zoology,9-ODA and HOB,4,4,1031,1032,1,
Zoology,9-ODA and HOB,4,4,1043,1059,16,
Zoology,9-ODA and HOB,4,4,1126,1142,16,
Zoology,9-ODA and HOB,4,4,1147,1155,8,
Zoology,9-ODA and HOB,4,4,1270,1271,1,
Zoology,9-ODA and HOB,4,4,1296,1298,2,
Zoology,9-ODA and HOB,4,4,1301,1302,1,
Zoology,9-ODA and HOB,4,4,1307,1307,0,
Zoology,9-ODA and HOB,4,4,1319,1319,0,
Zoology,9-ODA and HOB,4,4,1320,1322,2,
Zoology,9-ODA and HOB,4,4,1416,1416,0,
Zoology,9-ODA and HOB,4,4,1412,1417,5,bee sitting still papalell to paper very close to it
Zoology,9-ODA and HOB,4,4,1432,1439,7,
Zoology,9-ODA and HOB,4,4,1453,1544,91,
Zoology,9-ODA and HOB,4,4,1490,1498,8,
Zoology,9-ODA and HOB,4,4,1616,1619,3,
Zoology,9-ODA and HOB,4,4,1630,1630,0,
Zoology,9-ODA and HOB,4,4,1777,1779,2,
Zoology,9-ODA and HOB,4,4,1794,1795,1,
Zoology,9-ODA and HOB,5,1,11,20,9,
Zoology,9-ODA and HOB,5,1,21,21,0,
Zoology,9-ODA and HOB,5,1,21,23,2,
Zoology,9-ODA and HOB,5,1,34,35,1,
Zoology,9-ODA and HOB,5,1,75,80,5,
Zoology,9-ODA and HOB,5,1,180,186,6,
Zoology,9-ODA and HOB,5,1,186,191,5,
Zoology,9-ODA and HOB,5,1,191,193,2,
Zoology,9-ODA and HOB,5,1,192,277,85,Bee sits still close to aper facing it
Zoology,9-ODA and HOB,5,1,195,197,2,
Zoology,9-ODA and HOB,5,1,211,211,0,
Zoology,9-ODA and HOB,5,1,236,237,1,
Zoology,9-ODA and HOB,5,1,250,250,0,bumps in to paper as its turning around
Zoology,9-ODA and HOB,5,1,280,280,0,
Zoology,9-ODA and HOB,5,1,287,292,5,
Zoology,9-ODA and HOB,5,1,288,289,1,
Zoology,9-ODA and HOB,5,1,292,304,12,
Zoology,9-ODA and HOB,5,1,300,300,0,
Zoology,9-ODA and HOB,5,1,309,310,1,
Zoology,9-ODA and HOB,5,1,321,321,0,
Zoology,9-ODA and HOB,5,1,326,327,1,
Zoology,9-ODA and HOB,5,1,340,340,0,
Zoology,9-ODA and HOB,5,1,352,353,1,
Zoology,9-ODA and HOB,5,1,358,359,1,
Zoology,9-ODA and HOB,5,1,373,374,1,
Zoology,9-ODA and HOB,5,1,385,390,5,
Zoology,9-ODA and HOB,5,1,407,408,1,
Zoology,9-ODA and HOB,5,1,408,409,1,
Zoology,9-ODA and HOB,5,1,431,432,1,
Zoology,9-ODA and HOB,5,1,533,533,0,
Zoology,9-ODA and HOB,5,1,628,629,1,
Zoology,9-ODA and HOB,5,1,681,687,6,
Zoology,9-ODA and HOB,5,1,701,702,1,
Zoology,9-ODA and HOB,5,1,749,749,0,
Zoology,9-ODA and HOB,5,1,798,798,0,not quite touching
Zoology,9-ODA and HOB,5,1,894,901,7,
Zoology,9-ODA and HOB,5,1,908,909,1,
Zoology,9-ODA and HOB,5,1,989,993,4,
Zoology,9-ODA and HOB,5,1,999,1006,7,
Zoology,9-ODA and HOB,5,1,1007,1009,2,
Zoology,9-ODA and HOB,5,1,1012,1013,1,
Zoology,9-ODA and HOB,5,1,1023,1023,0,
Zoology,9-ODA and HOB,5,1,1054,1054,0,
Zoology,9-ODA and HOB,5,1,1057,1058,1,
Zoology,9-ODA and HOB,5,1,1103,1128,25,
Zoology,9-ODA and HOB,5,1,1155,1158,3,
Zoology,9-ODA and HOB,5,1,1169,1171,2,
Zoology,9-ODA and HOB,5,1,1172,1173,1,
Zoology,9-ODA and HOB,5,1,1184,1184,0,
Zoology,9-ODA and HOB,5,1,1188,1189,1,
Zoology,9-ODA and HOB,5,1,1205,1211,6,
Zoology,9-ODA and HOB,5,1,1248,1248,0,
Zoology,9-ODA and HOB,5,1,1302,1304,2,
Zoology,9-ODA and HOB,5,1,176,176,0,
Zoology,9-ODA and HOB,5,1,1534,1535,1,
Zoology,9-ODA and HOB,5,1,1629,1629,0,
Zoology,9-ODA and HOB,5,1,1648,1652,4,
Zoology,9-ODA and HOB,5,1,1652,1653,1,
Zoology,9-ODA and HOB,5,1,1663,1663,0,
Zoology,9-ODA and HOB,5,1,1679,1679,0,
Zoology,9-ODA and HOB,5,1,1688,1688,0,
Zoology,9-ODA and HOB,5,1,1689,1689,0,
Zoology,9-ODA and HOB,5,1,1703,1703,0,
Zoology,9-ODA and HOB,5,1,1731,1734,3,
Zoology,9-ODA and HOB,5,1,1760,1763,3,
Zoology,9-ODA and HOB,5,1,1772,1772,0,
Zoology,9-ODA and HOB,5,1,1794,1795,1,
Zoology,9-ODA and HOB,5,1,1795,1795,0,
Zoology,9-ODA and HOB,5,1,1797,1800,3,
Zoology,9-ODA and HOB,6,5,3,4,1,
Zoology,9-ODA and HOB,6,5,5,12,7,
Zoology,9-ODA and HOB,6,5,9,19,10,
Zoology,9-ODA and HOB,6,5,36,36,0,
Zoology,9-ODA and HOB,6,5,56,57,1,
Zoology,9-ODA and HOB,6,5,63,63,0,
Zoology,9-ODA and HOB,6,5,64,64,0,
Zoology,9-ODA and HOB,6,5,64,65,1,
Zoology,9-ODA and HOB,6,5,78,78,0,
Zoology,9-ODA and HOB,6,5,82,82,0,
Zoology,9-ODA and HOB,6,5,109,109,0,
Zoology,9-ODA and HOB,6,5,142,142,0,
Zoology,9-ODA and HOB,6,5,144,144,0,
Zoology,9-ODA and HOB,6,5,149,150,1,
Zoology,9-ODA and HOB,6,5,152,153,1,
Zoology,9-ODA and HOB,6,5,169,170,1,
Zoology,9-ODA and HOB,6,5,184,184,0,
Zoology,9-ODA and HOB,6,5,192,192,0,
Zoology,9-ODA and HOB,6,5,197,197,0,
Zoology,9-ODA and HOB,6,5,210,211,1,
Zoology,9-ODA and HOB,6,5,214,215,1,
Zoology,9-ODA and HOB,6,5,222,224,2,
Zoology,9-ODA and HOB,6,5,247,248,1,
Zoology,9-ODA and HOB,6,5,250,251,1,
Zoology,9-ODA and HOB,6,5,274,275,1,
Zoology,9-ODA and HOB,6,5,300,300,0,
Zoology,9-ODA and HOB,6,5,317,317,0,
Zoology,9-ODA and HOB,6,5,401,401,0,
Zoology,9-ODA and HOB,6,5,430,430,0,
Zoology,9-ODA and HOB,6,5,472,473,1,
Zoology,9-ODA and HOB,6,5,483,484,1,
Zoology,9-ODA and HOB,6,5,515,515,0,maybe - very fast toush as it walks
Zoology,9-ODA and HOB,6,5,526,526,0,
Zoology,9-ODA and HOB,6,5,554,554,0,
Zoology,9-ODA and HOB,6,5,558,558,0,
Zoology,9-ODA and HOB,6,5,577,577,0,maybe - very fast toush as it walks
Zoology,9-ODA and HOB,6,5,594,609,15,
Zoology,9-ODA and HOB,6,5,602,603,1,
Zoology,9-ODA and HOB,6,5,609,609,0,
Zoology,9-ODA and HOB,6,5,616,617,1,
Zoology,9-ODA and HOB,6,5,620,625,5,
Zoology,9-ODA and HOB,6,5,633,634,1,
Zoology,9-ODA and HOB,6,5,648,650,2,
Zoology,9-ODA and HOB,6,5,690,703,13,
Zoology,9-ODA and HOB,6,5,702,703,1,
Zoology,9-ODA and HOB,6,5,715,715,0,
Zoology,9-ODA and HOB,6,5,727,728,1,
Zoology,9-ODA and HOB,6,5,733,733,0,
Zoology,9-ODA and HOB,6,5,767,767,0,
Zoology,9-ODA and HOB,6,5,824,825,1,
Zoology,9-ODA and HOB,6,5,830,831,1,
Zoology,9-ODA and HOB,6,5,845,855,10,
Zoology,9-ODA and HOB,6,5,860,860,0,
Zoology,9-ODA and HOB,6,5,864,864,0,
Zoology,9-ODA and HOB,6,5,881,882,1,
Zoology,9-ODA and HOB,6,5,912,912,0,
Zoology,9-ODA and HOB,6,5,930,931,1,
Zoology,9-ODA and HOB,6,5,936,938,2,
Zoology,9-ODA and HOB,6,5,940,940,0,
Zoology,9-ODA and HOB,6,5,945,945,0,
Zoology,9-ODA and HOB,6,5,947,947,0,
Zoology,9-ODA and HOB,6,5,970,970,0,
Zoology,9-ODA and HOB,6,5,976,977,1,
Zoology,9-ODA and HOB,6,5,984,990,6,bee sort of sits still near paper
Zoology,9-ODA and HOB,6,5,992,992,0,
Zoology,9-ODA and HOB,6,5,994,994,0,
Zoology,9-ODA and HOB,6,5,1040,1045,5,
Zoology,9-ODA and HOB,6,5,1067,1067,0,
Zoology,9-ODA and HOB,6,5,1069,1072,3,
Zoology,9-ODA and HOB,6,5,1090,1092,2,
Zoology,9-ODA and HOB,6,5,1094,1094,0,
Zoology,9-ODA and HOB,6,5,1101,1102,1,
Zoology,9-ODA and HOB,6,5,1108,1108,0,
Zoology,9-ODA and HOB,6,5,1143,1143,0,
Zoology,9-ODA and HOB,6,5,1187,1188,1,
Zoology,9-ODA and HOB,6,5,1285,1287,2,bee sort of sniffing
Zoology,9-ODA and HOB,6,5,1347,1348,1,
Zoology,9-ODA and HOB,6,5,1349,1350,1,
Zoology,9-ODA and HOB,6,5,1358,1358,0,
Zoology,9-ODA and HOB,6,5,1360,1360,0,
Zoology,9-ODA and HOB,6,5,1374,1374,0,
Zoology,9-ODA and HOB,6,5,1383,1384,1,
Zoology,9-ODA and HOB,6,5,1454,1454,0,
Zoology,9-ODA and HOB,6,5,1503,1503,0,
Zoology,9-ODA and HOB,6,5,1518,1519,1,
Zoology,9-ODA and HOB,6,5,1521,1521,0,
Zoology,9-ODA and HOB,6,5,1527,1528,1,
Zoology,9-ODA and HOB,6,5,1601,1602,1,
Zoology,9-ODA and HOB,6,5,1637,1638,1,
Zoology,9-ODA and HOB,6,5,1658,1659,1,maybe sits still near paper
Zoology,9-ODA and HOB,6,5,1717,1717,0,
Zoology,9-ODA and HOB,6,5,1718,1718,0,
Zoology,9-ODA and HOB,6,5,1729,1729,0,
Zoology,9-ODA and HOB,6,5,1734,1744,10,
Zoology,9-ODA and HOB,6,5,1766,1767,1,
Zoology,9-ODA and HOB,6,5,1782,1783,1,
Zoology,9-ODA and HOB,7,12,10,11,1,
Zoology,9-ODA and HOB,7,12,60,60,0,
Zoology,9-ODA and HOB,7,12,60,63,3,bee sort of sits still near paper
Zoology,9-ODA and HOB,7,12,72,75,3,bee sort of sits still near paper
Zoology,9-ODA and HOB,7,12,91,91,0,
Zoology,9-ODA and HOB,7,12,115,115,0,
Zoology,9-ODA and HOB,7,12,156,156,0,
Zoology,9-ODA and HOB,7,12,172,172,0,
Zoology,9-ODA and HOB,7,12,180,182,2,
Zoology,9-ODA and HOB,7,12,187,187,0,
Zoology,9-ODA and HOB,7,12,230,231,1,
Zoology,9-ODA and HOB,7,12,232,234,2,
Zoology,9-ODA and HOB,7,12,335,335,0,
Zoology,9-ODA and HOB,7,12,342,343,1,
Zoology,9-ODA and HOB,7,12,466,468,2,
Zoology,9-ODA and HOB,7,12,481,482,1,
Zoology,9-ODA and HOB,7,12,564,566,2,
Zoology,9-ODA and HOB,7,12,611,611,0,
Zoology,9-ODA and HOB,7,12,637,637,0,
Zoology,9-ODA and HOB,7,12,658,662,4,
Zoology,9-ODA and HOB,7,12,664,665,1,
Zoology,9-ODA and HOB,7,12,739,740,1,
Zoology,9-ODA and HOB,7,12,741,742,1,
Zoology,9-ODA and HOB,7,12,743,747,4,
Zoology,9-ODA and HOB,7,12,766,766,0,
Zoology,9-ODA and HOB,7,12,783,784,1,
Zoology,9-ODA and HOB,7,12,825,828,3,
Zoology,9-ODA and HOB,7,12,836,837,1,
Zoology,9-ODA and HOB,7,12,841,844,3,
Zoology,9-ODA and HOB,7,12,845,847,2,
Zoology,9-ODA and HOB,7,12,893,896,3,
Zoology,9-ODA and HOB,7,12,927,930,3,
Zoology,9-ODA and HOB,7,12,1037,1037,0,
Zoology,9-ODA and HOB,7,12,1047,1048,1,
Zoology,9-ODA and HOB,7,12,1054,1063,9,
Zoology,9-ODA and HOB,7,12,1067,1070,3,
Zoology,9-ODA and HOB,7,12,1186,1187,1,
Zoology,9-ODA and HOB,7,12,1207,1208,1,
Zoology,9-ODA and HOB,7,12,1208,1213,5,
Zoology,9-ODA and HOB,7,12,1239,1240,1,
Zoology,9-ODA and HOB,7,12,1302,1306,4,
Zoology,9-ODA and HOB,7,12,1308,1308,0,
Zoology,9-ODA and HOB,7,12,1372,1372,0,
Zoology,9-ODA and HOB,7,12,1487,1487,0,
Zoology,9-ODA and HOB,7,12,1490,1490,0,
Zoology,9-ODA and HOB,7,12,1501,1505,4,
Zoology,9-ODA and HOB,7,12,1516,1517,1,
Zoology,9-ODA and HOB,7,12,1531,1531,0,
Zoology,9-ODA and HOB,7,12,1533,1534,1,
Zoology,9-ODA and HOB,7,12,1547,1547,0,
Zoology,9-ODA and HOB,7,12,1551,1553,2,
Zoology,9-ODA and HOB,7,12,1556,1557,1,
Zoology,9-ODA and HOB,7,12,1617,1618,1,
Zoology,9-ODA and HOB,7,12,1633,1634,1,
Zoology,9-ODA and HOB,7,12,1642,1642,0,
Zoology,9-ODA and HOB,7,12,1648,1649,1,
Zoology,9-ODA and HOB,7,12,1650,1650,0,
Zoology,9-ODA and HOB,7,12,1655,1655,0,
Zoology,9-ODA and HOB,7,12,1658,1659,1,
Zoology,9-ODA and HOB,7,12,1671,1672,1,
Zoology,9-ODA and HOB,7,12,1702,1703,1,
Zoology,9-ODA and HOB,7,12,1773,1773,0,
Zoology,9-ODA and HOB,7,12,1784,1784,0,
Zoology,9-ODA and HOB,8,7,27,28,1,
Zoology,9-ODA and HOB,8,7,37,39,2,
Zoology,9-ODA and HOB,8,7,76,76,0,
Zoology,9-ODA and HOB,8,7,109,111,2,
Zoology,9-ODA and HOB,8,7,143,143,0,
Zoology,9-ODA and HOB,8,7,147,152,5,
Zoology,9-ODA and HOB,8,7,157,159,2,
Zoology,9-ODA and HOB,8,7,164,164,0,
Zoology,9-ODA and HOB,8,7,167,181,14,bee moves around on top of paper
Zoology,9-ODA and HOB,8,7,184,194,10,
Zoology,9-ODA and HOB,8,7,191,197,6,
Zoology,9-ODA and HOB,8,7,243,245,2,
Zoology,9-ODA and HOB,8,7,250,252,2,
Zoology,9-ODA and HOB,8,7,256,261,5,
Zoology,9-ODA and HOB,8,7,274,274,0,
Zoology,9-ODA and HOB,8,7,301,301,0,
Zoology,9-ODA and HOB,8,7,303,303,0,
Zoology,9-ODA and HOB,8,7,312,322,10,
Zoology,9-ODA and HOB,8,7,322,324,2,
Zoology,9-ODA and HOB,8,7,324,325,1,
Zoology,9-ODA and HOB,8,7,333,333,0,
Zoology,9-ODA and HOB,8,7,335,336,1,
Zoology,9-ODA and HOB,8,7,337,337,0,
Zoology,9-ODA and HOB,8,7,350,350,0,ver fast touch as its walking past
Zoology,9-ODA and HOB,8,7,393,3993,3600,
Zoology,9-ODA and HOB,8,7,399,400,1,
Zoology,9-ODA and HOB,8,7,401,404,3,
Zoology,9-ODA and HOB,8,7,412,413,1,
Zoology,9-ODA and HOB,8,7,461,465,4,
Zoology,9-ODA and HOB,8,7,467,467,0,
Zoology,9-ODA and HOB,8,7,471,471,0,
Zoology,9-ODA and HOB,8,7,508,513,5,bee seemss to be sniffing fromm afar - not quite sure
Zoology,9-ODA and HOB,8,7,513,516,3,
Zoology,9-ODA and HOB,8,7,543,543,0,
Zoology,9-ODA and HOB,8,7,557,559,2,
Zoology,9-ODA and HOB,8,7,562,562,0,
Zoology,9-ODA and HOB,8,7,565,565,0,"bee sort of lunges towardss paper, not touching it."
Zoology,9-ODA and HOB,8,7,579,579,0,
Zoology,9-ODA and HOB,8,7,589,589,0,
Zoology,9-ODA and HOB,8,7,611,611,0,
Zoology,9-ODA and HOB,8,7,613,615,2,
Zoology,9-ODA and HOB,8,7,648,649,1,
Zoology,9-ODA and HOB,8,7,668,669,1,
Zoology,9-ODA and HOB,8,7,679,679,0,
Zoology,9-ODA and HOB,8,7,689,690,1,bee sort of bumps in to paper
Zoology,9-ODA and HOB,8,7,769,770,1,
Zoology,9-ODA and HOB,8,7,804,805,1,
Zoology,9-ODA and HOB,8,7,815,815,0,
Zoology,9-ODA and HOB,8,7,842,843,1,
Zoology,9-ODA and HOB,8,7,863,864,1,
Zoology,9-ODA and HOB,8,7,863,869,6,
Zoology,9-ODA and HOB,8,7,900,900,0,
Zoology,9-ODA and HOB,8,7,918,919,1,
Zoology,9-ODA and HOB,8,7,922,925,3,
Zoology,9-ODA and HOB,8,7,926,927,1,
Zoology,9-ODA and HOB,8,7,931,931,0,
Zoology,9-ODA and HOB,8,7,933,934,1,
Zoology,9-ODA and HOB,8,7,1006,1012,6,
Zoology,9-ODA and HOB,8,7,1008,1011,3,
Zoology,9-ODA and HOB,8,7,1019,1024,5,
Zoology,9-ODA and HOB,8,7,1125,1144,19,
Zoology,9-ODA and HOB,8,7,1133,1154,21,
Zoology,9-ODA and HOB,8,7,1135,1135,0,
Zoology,9-ODA and HOB,8,7,1167,1169,2,
Zoology,9-ODA and HOB,8,7,1172,1173,1,
Zoology,9-ODA and HOB,8,7,1194,1196,2,
Zoology,9-ODA and HOB,8,7,1201,1212,11,
Zoology,9-ODA and HOB,8,7,1206,1207,1,
Zoology,9-ODA and HOB,8,7,1218,1220,2,
Zoology,9-ODA and HOB,8,7,1246,1830,584,bee sniffs and then sits still really close to paper
Zoology,9-ODA and HOB,8,7,1247,1247,0,
Zoology,9-ODA and HOB,8,7,1249,1249,0,
Zoology,9-ODA and HOB,8,7,1263,1271,8,
Zoology,9-ODA and HOB,8,7,1265,1267,2,
Zoology,9-ODA and HOB,8,7,1291,1294,3,
Zoology,9-ODA and HOB,8,7,1295,1297,2,
Zoology,9-ODA and HOB,8,7,1299,1830,531,bee starts off sniffing and then just sits on paper
Zoology,9-ODA and HOB,8,7,1404,1404,0,
Zoology,9-ODA and HOB,8,7,1428,1428,0,
Zoology,9-ODA and HOB,8,7,1506,1510,4,
Zoology,9-ODA and HOB,8,7,1592,1594,2,
Zoology,9-ODA and HOB,8,7,1607,1610,3,
Zoology,9-ODA and HOB,8,7,1642,1644,2,
Zoology,9-ODA and HOB,8,7,1649,1649,0,
Zoology,9-ODA and HOB,8,7,1672,1674,2,
Zoology,9-ODA and HOB,8,7,1687,1689,2,
Zoology,9-ODA and HOB,8,7,1709,1711,2,
Zoology,9-ODA and HOB,8,7,1729,1729,0,
Zoology,9-ODA and HOB,8,7,1730,1734,4,
Zoology,9-ODA and HOB,8,7,1735,1740,5,
Zoology,9-ODA and HOB,9,6,5,6,1,
Zoology,9-ODA and HOB,9,6,31,31,0,
Zoology,9-ODA and HOB,9,6,45,46,1,
Zoology,9-ODA and HOB,9,6,60,60,0,
Zoology,9-ODA and HOB,9,6,62,63,1,
Zoology,9-ODA and HOB,9,6,70,70,0,
Zoology,9-ODA and HOB,9,6,74,74,0,
Zoology,9-ODA and HOB,9,6,79,79,0,maybe - very fast touch
Zoology,9-ODA and HOB,9,6,112,112,0,
Zoology,9-ODA and HOB,9,6,171,174,3,
Zoology,9-ODA and HOB,9,6,186,186,0,maybe - very fast touch
Zoology,9-ODA and HOB,9,6,233,234,1,
Zoology,9-ODA and HOB,9,6,274,274,0,
Zoology,9-ODA and HOB,9,6,281,281,0,
Zoology,9-ODA and HOB,9,6,317,317,0,
Zoology,9-ODA and HOB,9,6,333,339,6,
Zoology,9-ODA and HOB,9,6,451,451,0,
Zoology,9-ODA and HOB,9,6,538,541,3,
Zoology,9-ODA and HOB,9,6,579,581,2,
Zoology,9-ODA and HOB,9,6,705,707,2,
Zoology,9-ODA and HOB,9,6,717,717,0,
Zoology,9-ODA and HOB,9,6,719,720,1,
Zoology,9-ODA and HOB,9,6,724,725,1,
Zoology,9-ODA and HOB,9,6,759,760,1,
Zoology,9-ODA and HOB,9,6,859,865,6,
Zoology,9-ODA and HOB,9,6,936,939,3,Maybe - think it just bumps in to paper
Zoology,9-ODA and HOB,9,6,948,949,1,
Zoology,9-ODA and HOB,9,6,961,962,1,
Zoology,9-ODA and HOB,9,6,980,981,1,
Zoology,9-ODA and HOB,9,6,991,991,0,
Zoology,9-ODA and HOB,9,6,1008,1008,0,
Zoology,9-ODA and HOB,9,6,1011,1011,0,
Zoology,9-ODA and HOB,9,6,1035,1036,1,
Zoology,9-ODA and HOB,9,6,1039,1040,1,
Zoology,9-ODA and HOB,9,6,1046,1047,1,
Zoology,9-ODA and HOB,9,6,1058,1059,1,
Zoology,9-ODA and HOB,9,6,1059,1059,0,
Zoology,9-ODA and HOB,9,6,1121,1123,2,
Zoology,9-ODA and HOB,9,6,1162,1162,0,"sort of seems interrested, not quite touching"
Zoology,9-ODA and HOB,9,6,1189,1189,0,
Zoology,9-ODA and HOB,9,6,1198,1202,4,
Zoology,9-ODA and HOB,9,6,1247,1248,1,walks over paper
Zoology,9-ODA and HOB,9,6,1283,1283,0,
Zoology,9-ODA and HOB,9,6,1285,1285,0,
Zoology,9-ODA and HOB,9,6,1291,1292,1,
Zoology,9-ODA and HOB,9,6,1318,1319,1,
Zoology,9-ODA and HOB,9,6,1321,1321,0,
Zoology,9-ODA and HOB,9,6,1330,1331,1,
Zoology,9-ODA and HOB,9,6,1330,1330,0,
Zoology,9-ODA and HOB,9,6,1383,1384,1,
Zoology,9-ODA and HOB,9,6,1392,1392,0,
Zoology,9-ODA and HOB,9,6,1415,1415,0,
Zoology,9-ODA and HOB,9,6,1419,1419,0,
Zoology,9-ODA and HOB,9,6,1431,1431,0,
Zoology,9-ODA and HOB,9,6,1432,1432,0,
Zoology,9-ODA and HOB,9,6,1441,1441,0,
Zoology,9-ODA and HOB,9,6,1474,1474,0,maybe - very fast touch
Zoology,9-ODA and HOB,9,6,1610,1612,2,
Zoology,9-ODA and HOB,9,6,1648,1648,0,not quite touching
Zoology,9-ODA and HOB,9,6,1678,1678,0,
Zoology,9-ODA and HOB,9,6,1763,1763,0,
Zoology,9-ODA and HOB,9,6,1780,1782,2,
Zoology,9-ODA and HOB,11,5,0,1,1,
Zoology,9-ODA and HOB,11,5,6,6,0,
Zoology,9-ODA and HOB,11,5,9,10,1,
Zoology,9-ODA and HOB,11,5,18,24,6,
Zoology,9-ODA and HOB,11,5,36,36,0,
Zoology,9-ODA and HOB,11,5,40,42,2,
Zoology,9-ODA and HOB,11,5,45,49,4,
Zoology,9-ODA and HOB,11,5,55,56,1,
Zoology,9-ODA and HOB,11,5,77,80,3,
Zoology,9-ODA and HOB,11,5,84,88,4,
Zoology,9-ODA and HOB,11,5,120,130,10,
Zoology,9-ODA and HOB,11,5,138,140,2,
Zoology,9-ODA and HOB,11,5,141,142,1,
Zoology,9-ODA and HOB,11,5,151,152,1,
Zoology,9-ODA and HOB,11,5,151,152,1,
Zoology,9-ODA and HOB,11,5,153,154,1,
Zoology,9-ODA and HOB,11,5,159,160,1,
Zoology,9-ODA and HOB,11,5,170,170,0,
Zoology,9-ODA and HOB,11,5,197,197,0,
Zoology,9-ODA and HOB,11,5,203,205,2,
Zoology,9-ODA and HOB,11,5,213,216,3,
Zoology,9-ODA and HOB,11,5,232,232,0,
Zoology,9-ODA and HOB,11,5,234,237,3,
Zoology,9-ODA and HOB,11,5,243,244,1,
Zoology,9-ODA and HOB,11,5,249,252,3,
Zoology,9-ODA and HOB,11,5,253,256,3,
Zoology,9-ODA and HOB,11,5,261,262,1,
Zoology,9-ODA and HOB,11,5,265,267,2,
Zoology,9-ODA and HOB,11,5,275,277,2,
Zoology,9-ODA and HOB,11,5,279,281,2,
Zoology,9-ODA and HOB,11,5,373,377,4,
Zoology,9-ODA and HOB,11,5,378,379,1,
Zoology,9-ODA and HOB,11,5,385,386,1,
Zoology,9-ODA and HOB,11,5,386,386,0,
Zoology,9-ODA and HOB,11,5,390,391,1,
Zoology,9-ODA and HOB,11,5,394,394,0,
Zoology,9-ODA and HOB,11,5,418,418,0,
Zoology,9-ODA and HOB,11,5,426,426,0,
Zoology,9-ODA and HOB,11,5,446,457,11,
Zoology,9-ODA and HOB,11,5,446,461,15,
Zoology,9-ODA and HOB,11,5,454,454,0,
Zoology,9-ODA and HOB,11,5,466,466,0,
Zoology,9-ODA and HOB,11,5,469,471,2,
Zoology,9-ODA and HOB,11,5,474,482,8,
Zoology,9-ODA and HOB,11,5,477,479,2,
Zoology,9-ODA and HOB,11,5,479,480,1,
Zoology,9-ODA and HOB,11,5,480,480,0,
Zoology,9-ODA and HOB,11,5,485,490,5,
Zoology,9-ODA and HOB,11,5,494,494,0,
Zoology,9-ODA and HOB,11,5,502,502,0,
Zoology,9-ODA and HOB,11,5,565,565,0,
Zoology,9-ODA and HOB,11,5,568,568,0,
Zoology,9-ODA and HOB,11,5,571,571,0,
Zoology,9-ODA and HOB,11,5,579,579,0,
Zoology,9-ODA and HOB,11,5,623,623,0,
Zoology,9-ODA and HOB,11,5,639,640,1,
Zoology,9-ODA and HOB,11,5,652,653,1,bee sits near the paper and seems sort of interrested
Zoology,9-ODA and HOB,11,5,657,658,1,
Zoology,9-ODA and HOB,11,5,674,674,0,
Zoology,9-ODA and HOB,11,5,716,716,0,
Zoology,9-ODA and HOB,11,5,727,727,0,
Zoology,9-ODA and HOB,11,5,728,732,4,
Zoology,9-ODA and HOB,11,5,748,748,0,
Zoology,9-ODA and HOB,11,5,754,754,0,
Zoology,9-ODA and HOB,11,5,780,781,1,
Zoology,9-ODA and HOB,11,5,809,809,0,
Zoology,9-ODA and HOB,11,5,816,816,0,
Zoology,9-ODA and HOB,11,5,864,864,0,
Zoology,9-ODA and HOB,11,5,876,876,0,
Zoology,9-ODA and HOB,11,5,931,931,0,
Zoology,9-ODA and HOB,11,5,933,933,0,
Zoology,9-ODA and HOB,11,5,947,955,8,
Zoology,9-ODA and HOB,11,5,970,970,0,
Zoology,9-ODA and HOB,11,5,978,983,5,
Zoology,9-ODA and HOB,11,5,985,991,6,
Zoology,9-ODA and HOB,11,5,996,998,2,
Zoology,9-ODA and HOB,11,5,1004,1004,0,
Zoology,9-ODA and HOB,11,5,1032,1039,7,
Zoology,9-ODA and HOB,11,5,1068,1104,36,
Zoology,9-ODA and HOB,11,5,1070,1072,2,
Zoology,9-ODA and HOB,11,5,1094,1112,18,
Zoology,9-ODA and HOB,11,5,1118,1119,1,
Zoology,9-ODA and HOB,11,5,1294,1320,26,
Zoology,9-ODA and HOB,11,5,1328,1336,8,
Zoology,9-ODA and HOB,11,5,1337,1350,13,
Zoology,9-ODA and HOB,11,5,1347,1352,5,
Zoology,9-ODA and HOB,11,5,1373,1374,1,
Zoology,9-ODA and HOB,11,5,1405,1408,3,
Zoology,9-ODA and HOB,11,5,1436,1436,0,
Zoology,9-ODA and HOB,11,5,1433,1439,6,be sniffing from a short distance
Zoology,9-ODA and HOB,11,5,1442,1444,2,
Zoology,9-ODA and HOB,11,5,1445,1448,3,
Zoology,9-ODA and HOB,11,5,1465,1466,1,
Zoology,9-ODA and HOB,11,5,1476,1477,1,
Zoology,9-ODA and HOB,11,5,1476,1477,1,
Zoology,9-ODA and HOB,11,5,1483,1484,1,
Zoology,9-ODA and HOB,11,5,1487,1489,2,
Zoology,9-ODA and HOB,11,5,1489,1489,0,
Zoology,9-ODA and HOB,11,5,1503,1503,0,
Zoology,9-ODA and HOB,11,5,1509,1510,1,
Zoology,9-ODA and HOB,11,5,1513,1514,1,
Zoology,9-ODA and HOB,11,5,1522,1522,0,
Zoology,9-ODA and HOB,11,5,1554,1557,3,
Zoology,9-ODA and HOB,11,5,1563,1564,1,
Zoology,9-ODA and HOB,11,5,1505,1506,1,
Zoology,9-ODA and HOB,11,5,1579,1579,0,
Zoology,9-ODA and HOB,11,5,1590,1590,0,
Zoology,9-ODA and HOB,11,5,1612,1612,0,
Zoology,9-ODA and HOB,11,5,1632,1633,1,
Zoology,9-ODA and HOB,11,5,1698,1698,0,
Zoology,9-ODA and HOB,11,5,1718,1718,0,
Zoology,9-ODA and HOB,11,5,1756,1756,0,
Zoology,9-ODA and HOB,11,5,1760,1761,1,
Zoology,9-ODA and HOB,11,5,1761,1761,0,
Zoology,9-ODA and HOB,14,9,88,89,1,
Zoology,9-ODA and HOB,14,9,122,122,0,maybe - very fast touch
Zoology,9-ODA and HOB,14,9,141,148,7,
Zoology,9-ODA and HOB,14,9,154,155,1,
Zoology,9-ODA and HOB,14,9,169,169,0,
Zoology,9-ODA and HOB,14,9,238,239,1,
Zoology,9-ODA and HOB,14,9,287,287,0,
Zoology,9-ODA and HOB,14,9,296,298,2,
Zoology,9-ODA and HOB,14,9,377,377,0,
Zoology,9-ODA and HOB,14,9,416,417,1,
Zoology,9-ODA and HOB,14,9,430,430,0,
Zoology,9-ODA and HOB,14,9,461,463,2,
Zoology,9-ODA and HOB,14,9,477,477,0,
Zoology,9-ODA and HOB,14,9,485,485,0,
Zoology,9-ODA and HOB,14,9,491,495,4,
Zoology,9-ODA and HOB,14,9,556,556,0,
Zoology,9-ODA and HOB,14,9,571,571,0,
Zoology,9-ODA and HOB,14,9,615,615,0,
Zoology,9-ODA and HOB,14,9,637,638,1,
Zoology,9-ODA and HOB,14,9,682,685,3,
Zoology,9-ODA and HOB,14,9,683,683,0,
Zoology,9-ODA and HOB,14,9,695,695,0,
Zoology,9-ODA and HOB,14,9,698,699,1,
Zoology,9-ODA and HOB,14,9,723,723,0,
Zoology,9-ODA and HOB,14,9,737,739,2,
Zoology,9-ODA and HOB,14,9,747,749,2,
Zoology,9-ODA and HOB,14,9,750,756,6,
Zoology,9-ODA and HOB,14,9,760,760,0,bee bumps in to paper as it turns around
Zoology,9-ODA and HOB,14,9,766,779,13,
Zoology,9-ODA and HOB,14,9,792,792,0,
Zoology,9-ODA and HOB,14,9,802,802,0,bee bumps in to paper as it turns around
Zoology,9-ODA and HOB,14,9,804,805,1,
Zoology,9-ODA and HOB,14,9,811,811,0,
Zoology,9-ODA and HOB,14,9,813,814,1,
Zoology,9-ODA and HOB,14,9,818,818,0,
Zoology,9-ODA and HOB,14,9,844,845,1,
Zoology,9-ODA and HOB,14,9,882,883,1,
Zoology,9-ODA and HOB,14,9,914,914,0,
Zoology,9-ODA and HOB,14,9,928,930,2,
Zoology,9-ODA and HOB,14,9,941,942,1,
Zoology,9-ODA and HOB,14,9,944,944,0,
Zoology,9-ODA and HOB,14,9,951,954,3,
Zoology,9-ODA and HOB,14,9,952,952,0,
Zoology,9-ODA and HOB,14,9,1088,1088,0,bee bumps in to paper as it turns around
Zoology,9-ODA and HOB,14,9,1097,1097,0,bee bumps paper
Zoology,9-ODA and HOB,14,9,1231,1231,0,maybe
Zoology,9-ODA and HOB,14,9,1236,1236,0,bee bumps in to paper as it turns around
Zoology,9-ODA and HOB,14,9,1399,1399,0,
Zoology,9-ODA and HOB,14,9,1539,1540,1,
Zoology,9-ODA and HOB,14,9,1599,1600,1,
Zoology,9-ODA and HOB,14,9,1638,1638,0,maybe
Zoology,9-ODA and HOB,14,9,1643,1643,0,
Zoology,9-ODA and HOB,14,9,1647,1648,1,
Zoology,9-ODA and HOB,14,9,1674,1675,1,
Zoology,9-ODA and HOB,14,9,1725,1726,1,
Zoology,9-ODA and HOB,14,9,1763,1763,0,
Zoology,9-ODA and HOB,14,9,1769,1770,1,
Zoology,9-ODA and HOB,14,9,1796,1797,1,
Zoology,9-ODA and HOB,18,12,9,13,4,
Zoology,9-ODA and HOB,18,12,81,83,2,
Zoology,9-ODA and HOB,18,12,147,148,1,
Zoology,9-ODA and HOB,18,12,183,184,1,bee sniffs not touch
Zoology,9-ODA and HOB,18,12,203,203,0,bee sniffs not touch
Zoology,9-ODA and HOB,18,12,500,500,0,
Zoology,9-ODA and HOB,18,12,604,604,0,
Zoology,9-ODA and HOB,18,12,691,692,1,
Zoology,9-ODA and HOB,18,12,769,772,3,not sure bee sort of sniffs from a distance
Zoology,9-ODA and HOB,18,12,804,804,0,
Zoology,9-ODA and HOB,18,12,827,828,1,not sure bee sort of sniffs from a distance
Zoology,9-ODA and HOB,18,12,878,879,1,not sure bee sort of sniffs from a distance
Zoology,9-ODA and HOB,18,12,923,925,2,
Zoology,9-ODA and HOB,18,12,935,936,1,
Zoology,9-ODA and HOB,18,12,980,981,1,
Zoology,9-ODA and HOB,18,12,1011,1011,0,
Zoology,9-ODA and HOB,18,12,1446,1447,1,
Zoology,9-ODA and HOB,18,12,1510,1512,2,
Zoology,9-ODA and HOB,18,12,1533,1535,2,
Zoology,9-ODA and HOB,19,10,3,4,1,
Zoology,9-ODA and HOB,19,10,16,16,0,
Zoology,9-ODA and HOB,19,10,44,45,1,
Zoology,9-ODA and HOB,19,10,79,79,0,
Zoology,9-ODA and HOB,19,10,100,102,2,
Zoology,9-ODA and HOB,19,10,138,139,1,
Zoology,9-ODA and HOB,19,10,171,173,2,
Zoology,9-ODA and HOB,19,10,198,201,3,
Zoology,9-ODA and HOB,19,10,300,303,3,
Zoology,9-ODA and HOB,19,10,305,305,0,
Zoology,9-ODA and HOB,19,10,323,327,4,
Zoology,9-ODA and HOB,19,10,331,334,3,
Zoology,9-ODA and HOB,19,10,400,403,3,
Zoology,9-ODA and HOB,19,10,459,462,3,
Zoology,9-ODA and HOB,19,10,480,482,2,
Zoology,9-ODA and HOB,19,10,497,501,4,
Zoology,9-ODA and HOB,19,10,523,524,1,
Zoology,9-ODA and HOB,19,10,542,544,2,
Zoology,9-ODA and HOB,19,10,606,606,0,
Zoology,9-ODA and HOB,19,10,613,613,0,
Zoology,9-ODA and HOB,19,10,616,616,0,
Zoology,9-ODA and HOB,19,10,652,657,5,
Zoology,9-ODA and HOB,19,10,659,660,1,
Zoology,9-ODA and HOB,19,10,606,609,3,bee walks over paper
Zoology,9-ODA and HOB,19,10,735,735,0,
Zoology,9-ODA and HOB,19,10,781,783,2,
Zoology,9-ODA and HOB,19,10,867,867,0,
Zoology,9-ODA and HOB,19,10,869,871,2,
Zoology,9-ODA and HOB,19,10,879,881,2,
Zoology,9-ODA and HOB,19,10,891,893,2,
Zoology,9-ODA and HOB,19,10,1080,1080,0,
Zoology,9-ODA and HOB,19,10,1130,1131,1,
Zoology,9-ODA and HOB,19,10,1181,1181,0,
Zoology,9-ODA and HOB,19,10,1209,1212,3,
Zoology,9-ODA and HOB,19,10,1269,1272,3,
Zoology,9-ODA and HOB,19,10,1292,1293,1,
Zoology,9-ODA and HOB,19,10,1344,1346,2,
Zoology,9-ODA and HOB,19,10,1347,1351,4,
Zoology,9-ODA and HOB,19,10,1365,1368,3,
Zoology,9-ODA and HOB,19,10,1398,1402,4,
Zoology,9-ODA and HOB,19,10,1494,1494,0,
Zoology,9-ODA and HOB,19,10,1511,1512,1,
Zoology,9-ODA and HOB,19,10,1526,1528,2,
Zoology,9-ODA and HOB,19,10,1528,1528,0,
Zoology,9-ODA and HOB,19,10,1534,1534,0,
Zoology,9-ODA and HOB,19,10,1538,1539,1,
Zoology,9-ODA and HOB,19,10,1614,1616,2,
Zoology,9-ODA and HOB,19,10,1704,1706,2,
Zoology,9-ODA and HOB,19,10,1727,1730,3,
Zoology,9-ODA and HOB,19,10,1758,1760,2,
Zoology,9-ODA and HOB,19,10,1760,1760,0,
Zoology,9-ODA and HOB,23,10,1124,1124,0,
Zoology,9-ODA and HOB,23,10,44,45,1,
Zoology,9-ODA and HOB,23,10,65,65,0,
Zoology,9-ODA and HOB,23,10,83,85,2,
Zoology,9-ODA and HOB,23,10,89,93,4,
Zoology,9-ODA and HOB,23,10,100,100,0,
Zoology,9-ODA and HOB,23,10,102,102,0,
Zoology,9-ODA and HOB,23,10,119,119,0,
Zoology,9-ODA and HOB,23,10,123,126,3,
Zoology,9-ODA and HOB,23,10,137,137,0,
Zoology,9-ODA and HOB,23,10,158,158,0,
Zoology,9-ODA and HOB,23,10,160,160,0,
Zoology,9-ODA and HOB,23,10,192,192,0,
Zoology,9-ODA and HOB,23,10,195,248,53,
Zoology,9-ODA and HOB,23,10,252,261,9,
Zoology,9-ODA and HOB,23,10,310,343,33,
Zoology,9-ODA and HOB,23,10,345,381,36,
Zoology,9-ODA and HOB,23,10,399,431,32,
Zoology,9-ODA and HOB,23,10,422,424,2,
Zoology,9-ODA and HOB,23,10,426,427,1,
Zoology,9-ODA and HOB,23,10,443,470,27,
Zoology,9-ODA and HOB,23,10,473,476,3,
Zoology,9-ODA and HOB,23,10,542,549,7,
Zoology,9-ODA and HOB,23,10,598,615,17,bee sniffs from afar - i'm not sure about this one
Zoology,9-ODA and HOB,23,10,82,685,603,
Zoology,9-ODA and HOB,27,7,16,16,0,
Zoology,9-ODA and HOB,27,7,25,28,3,
Zoology,9-ODA and HOB,27,7,29,30,1,
Zoology,9-ODA and HOB,27,7,67,70,3,
Zoology,9-ODA and HOB,27,7,75,75,0,
Zoology,9-ODA and HOB,27,7,98,98,0,
Zoology,9-ODA and HOB,27,7,105,106,1,
Zoology,9-ODA and HOB,27,7,131,134,3,
Zoology,9-ODA and HOB,27,7,222,226,4,
Zoology,9-ODA and HOB,27,7,229,233,4,
Zoology,9-ODA and HOB,27,7,237,240,3,
Zoology,9-ODA and HOB,27,7,245,246,1,
Zoology,9-ODA and HOB,27,7,249,249,0,
Zoology,9-ODA and HOB,27,7,253,253,0,
Zoology,9-ODA and HOB,27,7,261,261,0,
Zoology,9-ODA and HOB,27,7,259,267,8,
Zoology,9-ODA and HOB,27,7,268,271,3,
Zoology,9-ODA and HOB,27,7,273,283,10,4:51 - bee sits on paper licking other bee until 4:51 but it stops paying attention to paper at 4:43
Zoology,9-ODA and HOB,27,7,291,294,3,
Zoology,9-ODA and HOB,27,7,296,297,1,
Zoology,9-ODA and HOB,27,7,299,302,3,
Zoology,9-ODA and HOB,27,7,316,316,0,
Zoology,9-ODA and HOB,27,7,323,323,0,
Zoology,9-ODA and HOB,27,7,335,337,2,
Zoology,9-ODA and HOB,27,7,372,372,0,
Zoology,9-ODA and HOB,27,7,375,377,2,
Zoology,9-ODA and HOB,27,7,377,377,0,
Zoology,9-ODA and HOB,27,7,380,380,0,
Zoology,9-ODA and HOB,27,7,400,402,2,
Zoology,9-ODA and HOB,27,7,435,436,1,
Zoology,9-ODA and HOB,27,7,450,451,1,
Zoology,9-ODA and HOB,27,7,478,482,4,
Zoology,9-ODA and HOB,27,7,521,521,0,
Zoology,9-ODA and HOB,27,7,539,539,0,
Zoology,9-ODA and HOB,27,7,547,548,1,
Zoology,9-ODA and HOB,27,7,547,547,0,
Zoology,9-ODA and HOB,27,7,559,563,4,
Zoology,9-ODA and HOB,27,7,563,565,2,
Zoology,9-ODA and HOB,27,7,577,577,0,
Zoology,9-ODA and HOB,27,7,596,597,1,
Zoology,9-ODA and HOB,27,7,612,612,0,
Zoology,9-ODA and HOB,27,7,631,633,2,
Zoology,9-ODA and HOB,27,7,647,649,2,
Zoology,9-ODA and HOB,27,7,682,682,0,
Zoology,9-ODA and HOB,27,7,692,692,0,
Zoology,9-ODA and HOB,27,7,694,696,2,
Zoology,9-ODA and HOB,27,7,702,702,0,
Zoology,9-ODA and HOB,27,7,711,716,5,
Zoology,9-ODA and HOB,27,7,770,773,3,
Zoology,9-ODA and HOB,27,7,771,774,3,
Zoology,9-ODA and HOB,27,7,811,812,1,
Zoology,9-ODA and HOB,27,7,818,818,0,
Zoology,9-ODA and HOB,27,7,858,861,3,
Zoology,9-ODA and HOB,27,7,921,922,1,
Zoology,9-ODA and HOB,27,7,973,975,2,
Zoology,9-ODA and HOB,27,7,1006,1008,2,
Zoology,9-ODA and HOB,27,7,1046,1049,3,
Zoology,9-ODA and HOB,27,7,1124,1124,0,
Zoology,9-ODA and HOB,27,7,1139,1139,0,
Zoology,9-ODA and HOB,27,7,1153,1155,2,
Zoology,9-ODA and HOB,27,7,1170,1170,0,
Zoology,9-ODA and HOB,27,7,1166,1179,13,
Zoology,9-ODA and HOB,27,7,1182,1211,29,
Zoology,9-ODA and HOB,27,7,1214,1235,21,
Zoology,9-ODA and HOB,27,7,1273,1273,0,
Zoology,9-ODA and HOB,27,7,1276,1276,0,
Zoology,9-ODA and HOB,27,7,1316,1329,13,
Zoology,9-ODA and HOB,27,7,1351,1352,1,
Zoology,9-ODA and HOB,27,7,1362,1364,2,
Zoology,9-ODA and HOB,27,7,1399,1399,0,
Zoology,9-ODA and HOB,27,7,1449,1451,2,
Zoology,9-ODA and HOB,27,7,1477,1477,0,
Zoology,9-ODA and HOB,27,7,1482,1483,1,
Zoology,9-ODA and HOB,27,7,1484,1494,10,
Zoology,9-ODA and HOB,27,7,1579,1579,0,
Zoology,9-ODA and HOB,27,7,1613,1614,1,
Zoology,9-ODA and HOB,27,7,1639,1639,0,
Zoology,9-ODA and HOB,27,7,1663,1663,0,
Zoology,9-ODA and HOB,27,7,1715,1723,8,
Zoology,9-ODA and HOB,27,7,1789,1800,11,
Zoology,9-ODA and HVA,4,3,100,103,3,
Zoology,9-ODA and HVA,4,3,106,106,0,
Zoology,9-ODA and HVA,4,3,111,112,1,
Zoology,9-ODA and HVA,4,3,142,142,0,
Zoology,9-ODA and HVA,4,3,160,163,3,
Zoology,9-ODA and HVA,4,3,186,192,6,
Zoology,9-ODA and HVA,4,3,204,205,1,
Zoology,9-ODA and HVA,4,3,214,216,2,
Zoology,9-ODA and HVA,4,3,217,221,4,
Zoology,9-ODA and HVA,4,3,222,224,2,
Zoology,9-ODA and HVA,4,3,231,231,0,
Zoology,9-ODA and HVA,4,3,235,240,5,
Zoology,9-ODA and HVA,4,3,243,243,0,
Zoology,9-ODA and HVA,4,3,284,286,2,
Zoology,9-ODA and HVA,4,3,289,294,5,
Zoology,9-ODA and HVA,4,3,313,313,0,
Zoology,9-ODA and HVA,4,3,325,326,1,
Zoology,9-ODA and HVA,4,3,404,405,1,
Zoology,9-ODA and HVA,4,3,415,418,3,
Zoology,9-ODA and HVA,4,3,420,426,6,
Zoology,9-ODA and HVA,4,3,434,434,0,
Zoology,9-ODA and HVA,4,3,440,443,3,
Zoology,9-ODA and HVA,4,3,441,444,3,
Zoology,9-ODA and HVA,4,3,452,454,2,
Zoology,9-ODA and HVA,4,3,478,478,0,
Zoology,9-ODA and HVA,4,3,531,531,0,
Zoology,9-ODA and HVA,4,3,638,638,0,
Zoology,9-ODA and HVA,4,3,654,656,2,
Zoology,9-ODA and HVA,4,3,669,669,0,
Zoology,9-ODA and HVA,4,3,678,680,2,
Zoology,9-ODA and HVA,4,3,712,714,2,
Zoology,9-ODA and HVA,4,3,740,742,2,
Zoology,9-ODA and HVA,4,3,753,753,0,
Zoology,9-ODA and HVA,4,3,758,758,0,
Zoology,9-ODA and HVA,4,3,815,815,0,
Zoology,9-ODA and HVA,4,3,860,864,4,
Zoology,9-ODA and HVA,4,3,870,872,2,
Zoology,9-ODA and HVA,4,3,894,895,1,
Zoology,9-ODA and HVA,4,3,910,910,0,
Zoology,9-ODA and HVA,4,3,924,925,1,
Zoology,9-ODA and HVA,4,3,934,935,1,
Zoology,9-ODA and HVA,4,3,944,948,4,
Zoology,9-ODA and HVA,4,3,961,962,1,
Zoology,9-ODA and HVA,4,3,966,968,2,
Zoology,9-ODA and HVA,4,3,968,982,14,
Zoology,9-ODA and HVA,4,3,990,997,7,
Zoology,9-ODA and HVA,4,3,1001,1027,26,
Zoology,9-ODA and HVA,4,3,1004,1010,6,
Zoology,9-ODA and HVA,4,3,1010,1011,1,
Zoology,9-ODA and HVA,4,3,1029,1030,1,
Zoology,9-ODA and HVA,4,3,1049,1052,3,
Zoology,9-ODA and HVA,4,3,1119,1121,2,
Zoology,9-ODA and HVA,4,3,1125,1125,0,
Zoology,9-ODA and HVA,4,3,1115,1117,2,
Zoology,9-ODA and HVA,4,3,1204,1204,0,
Zoology,9-ODA and HVA,4,3,1218,1219,1,
Zoology,9-ODA and HVA,4,3,1227,1230,3,
Zoology,9-ODA and HVA,4,3,1239,1250,11,maybe - bee sniffing from a distance
Zoology,9-ODA and HVA,4,3,1288,1313,25,
Zoology,9-ODA and HVA,4,3,1318,1319,1,
Zoology,9-ODA and HVA,4,3,1333,1358,25,
Zoology,9-ODA and HVA,4,3,1345,1347,2,
Zoology,9-ODA and HVA,4,3,1349,1353,4,
Zoology,9-ODA and HVA,4,3,1383,1385,2,
Zoology,9-ODA and HVA,4,3,1390,1392,2,
Zoology,9-ODA and HVA,4,3,1404,1405,1,
Zoology,9-ODA and HVA,4,3,1418,1420,2,
Zoology,9-ODA and HVA,4,3,1433,1438,5,
Zoology,9-ODA and HVA,4,3,1451,1453,2,
Zoology,9-ODA and HVA,4,3,1453,1459,6,
Zoology,9-ODA and HVA,4,3,1480,1510,30,
Zoology,9-ODA and HVA,4,3,1513,1514,1,
Zoology,9-ODA and HVA,4,3,1519,1519,0,
Zoology,9-ODA and HVA,4,3,1525,1683,158,
Zoology,9-ODA and HVA,4,3,1696,1698,2,
Zoology,9-ODA and HVA,5,4,3,3,0,
Zoology,9-ODA and HVA,5,4,12,16,4,
Zoology,9-ODA and HVA,5,4,14,17,3,
Zoology,9-ODA and HVA,5,4,33,33,0,
Zoology,9-ODA and HVA,5,4,45,47,2,
Zoology,9-ODA and HVA,5,4,55,56,1,
Zoology,9-ODA and HVA,5,4,67,67,0,
Zoology,9-ODA and HVA,5,4,70,71,1,
Zoology,9-ODA and HVA,5,4,129,129,0,
Zoology,9-ODA and HVA,5,4,140,142,2,
Zoology,9-ODA and HVA,5,4,155,155,0,
Zoology,9-ODA and HVA,5,4,205,206,1,
Zoology,9-ODA and HVA,5,4,238,238,0,
Zoology,9-ODA and HVA,5,4,242,242,0,
Zoology,9-ODA and HVA,5,4,270,271,1,
Zoology,9-ODA and HVA,5,4,322,322,0,
Zoology,9-ODA and HVA,5,4,339,339,0,
Zoology,9-ODA and HVA,5,4,382,383,1,
Zoology,9-ODA and HVA,5,4,401,403,2,
Zoology,9-ODA and HVA,5,4,474,476,2,
Zoology,9-ODA and HVA,5,4,571,575,4,
Zoology,9-ODA and HVA,5,4,605,607,2,
Zoology,9-ODA and HVA,5,4,614,615,1,
Zoology,9-ODA and HVA,5,4,618,618,0,
Zoology,9-ODA and HVA,5,4,638,638,0,
Zoology,9-ODA and HVA,5,4,670,670,0,
Zoology,9-ODA and HVA,5,4,695,697,2,
Zoology,9-ODA and HVA,5,4,750,750,0,
Zoology,9-ODA and HVA,5,4,797,803,6,
Zoology,9-ODA and HVA,5,4,809,814,5,
Zoology,9-ODA and HVA,5,4,858,859,1,
Zoology,9-ODA and HVA,5,4,868,869,1,
Zoology,9-ODA and HVA,5,4,878,878,0,
Zoology,9-ODA and HVA,5,4,885,885,0,
Zoology,9-ODA and HVA,5,4,910,910,0,
Zoology,9-ODA and HVA,5,4,920,921,1,
Zoology,9-ODA and HVA,5,4,925,925,0,
Zoology,9-ODA and HVA,5,4,957,957,0,
Zoology,9-ODA and HVA,5,4,999,999,0,
Zoology,9-ODA and HVA,5,4,1012,1012,0,
Zoology,9-ODA and HVA,5,4,1039,1039,0,
Zoology,9-ODA and HVA,5,4,1045,1046,1,
Zoology,9-ODA and HVA,5,4,1050,1052,2,
Zoology,9-ODA and HVA,5,4,1062,1063,1,
Zoology,9-ODA and HVA,5,4,1069,1070,1,
Zoology,9-ODA and HVA,5,4,1130,1131,1,
Zoology,9-ODA and HVA,5,4,1148,1149,1,
Zoology,9-ODA and HVA,5,4,1218,1219,1,
Zoology,9-ODA and HVA,5,4,1249,1249,0,
Zoology,9-ODA and HVA,5,4,1268,1276,8,
Zoology,9-ODA and HVA,5,4,1282,1282,0,
Zoology,9-ODA and HVA,5,4,1299,1299,0,
Zoology,9-ODA and HVA,5,4,1315,1316,1,
Zoology,9-ODA and HVA,5,4,1349,1349,0,
Zoology,9-ODA and HVA,5,4,1390,1392,2,
Zoology,9-ODA and HVA,5,4,1399,1401,2,
Zoology,9-ODA and HVA,5,4,1417,1421,4,
Zoology,9-ODA and HVA,5,4,1423,1423,0,
Zoology,9-ODA and HVA,5,4,1437,1437,0,
Zoology,9-ODA and HVA,5,4,1442,1442,0,
Zoology,9-ODA and HVA,5,4,1451,1454,3,maybe sniff from afar
Zoology,9-ODA and HVA,5,4,1462,1462,0,
Zoology,9-ODA and HVA,5,4,1479,1479,0,
Zoology,9-ODA and HVA,5,4,1507,1507,0,
Zoology,9-ODA and HVA,5,4,1528,1529,1,
Zoology,9-ODA and HVA,5,4,1544,1545,1,
Zoology,9-ODA and HVA,5,4,1556,1556,0,
Zoology,9-ODA and HVA,5,4,1596,1596,0,
Zoology,9-ODA and HVA,5,4,1602,1602,0,
Zoology,9-ODA and HVA,5,4,1621,1621,0,
Zoology,9-ODA and HVA,5,4,1623,1623,0,
Zoology,9-ODA and HVA,5,4,1632,1633,1,
Zoology,9-ODA and HVA,5,4,1653,1654,1,
Zoology,9-ODA and HVA,5,4,1741,1741,0,
Zoology,9-ODA and HVA,5,4,1744,1744,0,
Zoology,9-ODA and HVA,5,4,1795,1798,3,
Zoology,9-ODA and HVA,6,6,21,21,0,
Zoology,9-ODA and HVA,6,6,31,32,1,
Zoology,9-ODA and HVA,6,6,38,38,0,
Zoology,9-ODA and HVA,6,6,49,49,0,
Zoology,9-ODA and HVA,6,6,65,70,5,
Zoology,9-ODA and HVA,6,6,92,93,1,
Zoology,9-ODA and HVA,6,6,149,150,1,
Zoology,9-ODA and HVA,6,6,175,175,0,
Zoology,9-ODA and HVA,6,6,229,229,0,
Zoology,9-ODA and HVA,6,6,245,245,0,
Zoology,9-ODA and HVA,6,6,255,255,0,
Zoology,9-ODA and HVA,6,6,261,263,2,
Zoology,9-ODA and HVA,6,6,294,296,2,
Zoology,9-ODA and HVA,6,6,313,315,2,bee walks very close to the paper - seems sort of interrested in it
Zoology,9-ODA and HVA,6,6,359,359,0,
Zoology,9-ODA and HVA,6,6,378,378,0,
Zoology,9-ODA and HVA,6,6,443,443,0,
Zoology,9-ODA and HVA,6,6,472,472,0,
Zoology,9-ODA and HVA,6,6,475,475,0,
Zoology,9-ODA and HVA,6,6,495,495,0,
Zoology,9-ODA and HVA,6,6,649,651,2,
Zoology,9-ODA and HVA,6,6,673,674,1,bee sort of brushes against paper as it walks
Zoology,9-ODA and HVA,6,6,705,705,0,
Zoology,9-ODA and HVA,6,6,744,748,4,
Zoology,9-ODA and HVA,6,6,758,762,4,
Zoology,9-ODA and HVA,6,6,764,770,6,
Zoology,9-ODA and HVA,6,6,781,781,0,
Zoology,9-ODA and HVA,6,6,779,780,1,bee sort of brushes against paper as it walks
Zoology,9-ODA and HVA,6,6,788,788,0,
Zoology,9-ODA and HVA,6,6,846,846,0,
Zoology,9-ODA and HVA,6,6,864,864,0,
Zoology,9-ODA and HVA,6,6,872,873,1,
Zoology,9-ODA and HVA,6,6,956,956,0,
Zoology,9-ODA and HVA,6,6,970,971,1,
Zoology,9-ODA and HVA,6,6,987,988,1,
Zoology,9-ODA and HVA,6,6,1051,1052,1,
Zoology,9-ODA and HVA,6,6,1115,1115,0,
Zoology,9-ODA and HVA,6,6,1113,1114,1,bee sort of sniffs from afar
Zoology,9-ODA and HVA,6,6,1182,1182,0,
Zoology,9-ODA and HVA,6,6,1362,1363,1,
Zoology,9-ODA and HVA,6,6,1372,1372,0,
Zoology,9-ODA and HVA,6,6,1440,1440,0,
Zoology,9-ODA and HVA,6,6,1452,1452,0,
Zoology,9-ODA and HVA,6,6,1456,1456,0,
Zoology,9-ODA and HVA,6,6,1668,1668,0,
Zoology,9-ODA and HVA,6,6,1679,1680,1,
Zoology,9-ODA and HVA,6,6,483,484,1,
Zoology,9-ODA and HVA,6,6,1689,1690,1,
Zoology,9-ODA and HVA,6,6,1729,1730,1,
Zoology,9-ODA and HVA,6,6,1748,1753,5,
Zoology,9-ODA and HVA,6,6,1761,1766,5,
Zoology,9-ODA and HVA,6,6,1776,1777,1,
Zoology,9-ODA and HVA,6,6,1780,1780,0,
Zoology,9-ODA and HVA,7,11,59,59,0,
Zoology,9-ODA and HVA,7,11,141,141,0,
Zoology,9-ODA and HVA,7,11,200,200,0,
Zoology,9-ODA and HVA,7,11,248,248,0,
Zoology,9-ODA and HVA,7,11,284,284,0,
Zoology,9-ODA and HVA,7,11,309,309,0,
Zoology,9-ODA and HVA,7,11,332,334,2,
Zoology,9-ODA and HVA,7,11,334,335,1,
Zoology,9-ODA and HVA,7,11,467,467,0,
Zoology,9-ODA and HVA,7,11,572,581,9,
Zoology,9-ODA and HVA,7,11,589,592,3,
Zoology,9-ODA and HVA,7,11,592,593,1,
Zoology,9-ODA and HVA,7,11,670,675,5,
Zoology,9-ODA and HVA,7,11,704,704,0,
Zoology,9-ODA and HVA,7,11,747,748,1,
Zoology,9-ODA and HVA,7,11,801,802,1,
Zoology,9-ODA and HVA,7,11,896,897,1,
Zoology,9-ODA and HVA,7,11,964,966,2,
Zoology,9-ODA and HVA,7,11,976,978,2,
Zoology,9-ODA and HVA,7,11,981,983,2,
Zoology,9-ODA and HVA,7,11,1014,1014,0,
Zoology,9-ODA and HVA,7,11,1073,1073,0,
Zoology,9-ODA and HVA,7,11,1075,1075,0,
Zoology,9-ODA and HVA,7,11,1128,1129,1,
Zoology,9-ODA and HVA,7,11,1134,1136,2,
Zoology,9-ODA and HVA,7,11,1160,1160,0,"maybe, bee sort of bumps in to the paper"
Zoology,9-ODA and HVA,7,11,1190,1191,1,
Zoology,9-ODA and HVA,7,11,1211,1211,0,
Zoology,9-ODA and HVA,7,11,1220,1220,0,
Zoology,9-ODA and HVA,7,11,1444,1452,8,
Zoology,9-ODA and HVA,7,11,1537,1539,2,
Zoology,9-ODA and HVA,7,11,1624,1625,1,
Zoology,9-ODA and HVA,7,11,1633,1635,2,
Zoology,9-ODA and HVA,7,11,1662,1662,0,
Zoology,9-ODA and HVA,7,11,1702,1702,0,
Zoology,9-ODA and HVA,7,11,1719,1719,0,
Zoology,9-ODA and HVA,7,11,1742,1742,0,
Zoology,9-ODA and HVA,7,11,1777,1778,1,
Zoology,9-ODA and HVA,7,11,1799,1799,0,
Zoology,9-ODA and HVA,8,3,136,136,0,
Zoology,9-ODA and HVA,8,3,196,196,0,
Zoology,9-ODA and HVA,8,3,205,205,0,
Zoology,9-ODA and HVA,8,3,222,230,8,
Zoology,9-ODA and HVA,8,3,255,255,0,
Zoology,9-ODA and HVA,8,3,257,257,0,
Zoology,9-ODA and HVA,8,3,273,273,0,
Zoology,9-ODA and HVA,8,3,283,283,0,
Zoology,9-ODA and HVA,8,3,354,355,1,
Zoology,9-ODA and HVA,8,3,402,412,10,
Zoology,9-ODA and HVA,8,3,530,533,3,
Zoology,9-ODA and HVA,8,3,533,534,1,
Zoology,9-ODA and HVA,8,3,543,543,0,very fast touch not sure about it
Zoology,9-ODA and HVA,8,3,639,640,1,
Zoology,9-ODA and HVA,8,3,668,668,0,
Zoology,9-ODA and HVA,8,3,709,710,1,
Zoology,9-ODA and HVA,8,3,746,746,0,
Zoology,9-ODA and HVA,8,3,763,765,2,
Zoology,9-ODA and HVA,8,3,791,797,6,
Zoology,9-ODA and HVA,8,3,841,846,5,
Zoology,9-ODA and HVA,8,3,844,854,10,
Zoology,9-ODA and HVA,8,3,847,849,2,
Zoology,9-ODA and HVA,8,3,863,863,0,
Zoology,9-ODA and HVA,8,3,880,894,14,bee sitting still facing the paper
Zoology,9-ODA and HVA,8,3,903,903,0,
Zoology,9-ODA and HVA,8,3,953,953,0,
Zoology,9-ODA and HVA,8,3,986,992,6,
Zoology,9-ODA and HVA,8,3,1019,1024,5,
Zoology,9-ODA and HVA,8,3,421,427,6,
Zoology,9-ODA and HVA,8,3,1034,1036,2,
Zoology,9-ODA and HVA,8,3,1044,1046,2,
Zoology,9-ODA and HVA,8,3,1048,1050,2,
Zoology,9-ODA and HVA,8,3,1062,1063,1,
Zoology,9-ODA and HVA,8,3,1069,1071,2,
Zoology,9-ODA and HVA,8,3,1092,1093,1,
Zoology,9-ODA and HVA,8,3,1124,1131,7,
Zoology,9-ODA and HVA,8,3,1142,1145,3,
Zoology,9-ODA and HVA,8,3,1170,1173,3,
Zoology,9-ODA and HVA,8,3,1240,1241,1,
Zoology,9-ODA and HVA,8,3,1290,1892,602,
Zoology,9-ODA and HVA,8,3,1302,1306,4,
Zoology,9-ODA and HVA,8,3,1308,1308,0,
Zoology,9-ODA and HVA,8,3,1336,1336,0,"sort of interrested, not quite touching"
Zoology,9-ODA and HVA,8,3,1373,1373,0,
Zoology,9-ODA and HVA,8,3,1438,1438,0,
Zoology,9-ODA and HVA,8,3,1453,1453,0,
Zoology,9-ODA and HVA,8,3,1457,1459,2,
Zoology,9-ODA and HVA,8,3,1462,1464,2,
Zoology,9-ODA and HVA,8,3,1504,1504,0,
Zoology,9-ODA and HVA,8,3,1668,1669,1,
Zoology,9-ODA and HVA,8,3,1793,1800,7,
Zoology,9-ODA and HVA,9,2,46,47,1,
Zoology,9-ODA and HVA,9,2,49,49,0,very fast touch - maybe doesn't count
Zoology,9-ODA and HVA,9,2,54,56,2,
Zoology,9-ODA and HVA,9,2,77,77,0,
Zoology,9-ODA and HVA,9,2,78,78,0,
Zoology,9-ODA and HVA,9,2,86,88,2,
Zoology,9-ODA and HVA,9,2,95,95,0,
Zoology,9-ODA and HVA,9,2,98,99,1,
Zoology,9-ODA and HVA,9,2,103,104,1,
Zoology,9-ODA and HVA,9,2,136,136,0,
Zoology,9-ODA and HVA,9,2,147,149,2,
Zoology,9-ODA and HVA,9,2,174,175,1,
Zoology,9-ODA and HVA,9,2,175,178,3,
Zoology,9-ODA and HVA,9,2,191,193,2,
Zoology,9-ODA and HVA,9,2,206,214,8,
Zoology,9-ODA and HVA,9,2,214,217,3,
Zoology,9-ODA and HVA,9,2,266,268,2,
Zoology,9-ODA and HVA,9,2,269,269,0,
Zoology,9-ODA and HVA,9,2,274,275,1,
Zoology,9-ODA and HVA,9,2,276,278,2,
Zoology,9-ODA and HVA,9,2,280,281,1,
Zoology,9-ODA and HVA,9,2,306,306,0,
Zoology,9-ODA and HVA,9,2,346,347,1,
Zoology,9-ODA and HVA,9,2,383,383,0,very fast touch - maybe doesn't count
Zoology,9-ODA and HVA,9,2,403,403,0,
Zoology,9-ODA and HVA,9,2,447,447,0,
Zoology,9-ODA and HVA,9,2,460,460,0,
Zoology,9-ODA and HVA,9,2,475,475,0,
Zoology,9-ODA and HVA,9,2,520,531,11,
Zoology,9-ODA and HVA,9,2,535,536,1,
Zoology,9-ODA and HVA,9,2,546,546,0,very fast touch - maybe doesn't count
Zoology,9-ODA and HVA,9,2,553,560,7,
Zoology,9-ODA and HVA,9,2,554,555,1,
Zoology,9-ODA and HVA,9,2,565,568,3,
Zoology,9-ODA and HVA,9,2,569,569,0,very fast touch - maybe doesn't count
Zoology,9-ODA and HVA,9,2,580,580,0,
Zoology,9-ODA and HVA,9,2,590,590,0,
Zoology,9-ODA and HVA,9,2,592,593,1,
Zoology,9-ODA and HVA,9,2,595,595,0,
Zoology,9-ODA and HVA,9,2,604,605,1,
Zoology,9-ODA and HVA,9,2,617,617,0,
Zoology,9-ODA and HVA,9,2,619,619,0,
Zoology,9-ODA and HVA,9,2,643,643,0,
Zoology,9-ODA and HVA,9,2,650,651,1,
Zoology,9-ODA and HVA,9,2,715,716,1,
Zoology,9-ODA and HVA,9,2,719,719,0,
Zoology,9-ODA and HVA,9,2,731,733,2,
Zoology,9-ODA and HVA,9,2,736,738,2,
Zoology,9-ODA and HVA,9,2,741,741,0,
Zoology,9-ODA and HVA,9,2,747,749,2,
Zoology,9-ODA and HVA,9,2,758,759,1,
Zoology,9-ODA and HVA,9,2,780,780,0,very fast touch - maybe doesn't count
Zoology,9-ODA and HVA,9,2,800,807,7,
Zoology,9-ODA and HVA,9,2,832,832,0,
Zoology,9-ODA and HVA,9,2,841,841,0,
Zoology,9-ODA and HVA,9,2,857,857,0,
Zoology,9-ODA and HVA,9,2,885,885,0,
Zoology,9-ODA and HVA,9,2,898,898,0,
Zoology,9-ODA and HVA,9,2,906,906,0,
Zoology,9-ODA and HVA,9,2,917,917,0,very fast touch - maybe doesn't count
Zoology,9-ODA and HVA,9,2,938,939,1,
Zoology,9-ODA and HVA,9,2,995,998,3,bee sits on paper until 16:41
Zoology,9-ODA and HVA,9,2,1008,1009,1,
Zoology,9-ODA and HVA,9,2,1065,1065,0,
Zoology,9-ODA and HVA,9,2,1067,1068,1,
Zoology,9-ODA and HVA,9,2,1092,1092,0,
Zoology,9-ODA and HVA,9,2,1100,1103,3,
Zoology,9-ODA and HVA,9,2,1104,1104,0,
Zoology,9-ODA and HVA,9,2,1105,1105,0,
Zoology,9-ODA and HVA,9,2,1106,1107,1,
Zoology,9-ODA and HVA,9,2,1104,1120,16,bee facing the paper very close
Zoology,9-ODA and HVA,9,2,1116,1122,6,
Zoology,9-ODA and HVA,9,2,1123,1124,1,
Zoology,9-ODA and HVA,9,2,1152,1152,0,very fast touch - maybe doesn't count
Zoology,9-ODA and HVA,9,2,1177,1177,0,
Zoology,9-ODA and HVA,9,2,1247,1248,1,
Zoology,9-ODA and HVA,9,2,1327,1329,2,
Zoology,9-ODA and HVA,9,2,1334,1336,2,
Zoology,9-ODA and HVA,9,2,1336,1339,3,
Zoology,9-ODA and HVA,9,2,1350,1350,0,
Zoology,9-ODA and HVA,9,2,1354,1355,1,
Zoology,9-ODA and HVA,9,2,1390,1390,0,
Zoology,9-ODA and HVA,9,2,1397,1399,2,
Zoology,9-ODA and HVA,9,2,1409,1412,3,
Zoology,9-ODA and HVA,9,2,1417,1418,1,
Zoology,9-ODA and HVA,9,2,1428,1428,0,
Zoology,9-ODA and HVA,9,2,1457,1458,1,
Zoology,9-ODA and HVA,9,2,1468,1468,0,very fast touch - maybe doesn't count
Zoology,9-ODA and HVA,9,2,1487,1488,1,
Zoology,9-ODA and HVA,9,2,1515,1515,0,
Zoology,9-ODA and HVA,9,2,1567,1567,0,
Zoology,9-ODA and HVA,9,2,1651,1654,3,
Zoology,9-ODA and HVA,9,2,1677,1677,0,
Zoology,9-ODA and HVA,9,2,1690,1690,0,
Zoology,9-ODA and HVA,9,2,1693,1693,0,
Zoology,9-ODA and HVA,9,2,1737,1737,0,very fast touch - maybe doesn't count
Zoology,9-ODA and HVA,9,2,1743,1743,0,
Zoology,9-ODA and HVA,9,2,1744,1744,0,
Zoology,9-ODA and HVA,9,2,1772,1773,1,
Zoology,9-ODA and HVA,11,6,27,27,0,
Zoology,9-ODA and HVA,11,6,60,60,0,
Zoology,9-ODA and HVA,11,6,85,85,0,
Zoology,9-ODA and HVA,11,6,92,92,0,
Zoology,9-ODA and HVA,11,6,108,109,1,
Zoology,9-ODA and HVA,11,6,183,183,0,maybe accidental bump
Zoology,9-ODA and HVA,11,6,197,199,2,
Zoology,9-ODA and HVA,11,6,211,212,1,
Zoology,9-ODA and HVA,11,6,215,255,40,bee sits parallel to paper (not facing it)> Not sure it counts
Zoology,9-ODA and HVA,11,6,339,341,2,
Zoology,9-ODA and HVA,11,6,358,359,1,
Zoology,9-ODA and HVA,11,6,378,378,0,
Zoology,9-ODA and HVA,11,6,383,384,1,
Zoology,9-ODA and HVA,11,6,386,386,0,
Zoology,9-ODA and HVA,11,6,390,392,2,
Zoology,9-ODA and HVA,11,6,396,396,0,
Zoology,9-ODA and HVA,11,6,413,413,0,
Zoology,9-ODA and HVA,11,6,415,416,1,
Zoology,9-ODA and HVA,11,6,419,420,1,
Zoology,9-ODA and HVA,11,6,441,441,0,
Zoology,9-ODA and HVA,11,6,443,443,0,
Zoology,9-ODA and HVA,11,6,456,456,0,
Zoology,9-ODA and HVA,11,6,476,476,0,
Zoology,9-ODA and HVA,11,6,481,481,0,
Zoology,9-ODA and HVA,11,6,518,519,1,
Zoology,9-ODA and HVA,11,6,535,535,0,
Zoology,9-ODA and HVA,11,6,507,568,61,
Zoology,9-ODA and HVA,11,6,578,578,0,
Zoology,9-ODA and HVA,11,6,597,598,1,
Zoology,9-ODA and HVA,11,6,610,611,1,
Zoology,9-ODA and HVA,11,6,647,647,0,
Zoology,9-ODA and HVA,11,6,677,677,0,
Zoology,9-ODA and HVA,11,6,727,728,1,
Zoology,9-ODA and HVA,11,6,752,752,0,
Zoology,9-ODA and HVA,11,6,766,766,0,
Zoology,9-ODA and HVA,11,6,789,790,1,
Zoology,9-ODA and HVA,11,6,796,796,0,
Zoology,9-ODA and HVA,11,6,844,845,1,
Zoology,9-ODA and HVA,11,6,881,881,0,
Zoology,9-ODA and HVA,11,6,895,898,3,
Zoology,9-ODA and HVA,11,6,905,905,0,
Zoology,9-ODA and HVA,11,6,929,929,0,
Zoology,9-ODA and HVA,11,6,944,945,1,
Zoology,9-ODA and HVA,11,6,954,954,0,
Zoology,9-ODA and HVA,11,6,966,967,1,
Zoology,9-ODA and HVA,11,6,968,971,3,
Zoology,9-ODA and HVA,11,6,980,980,0,
Zoology,9-ODA and HVA,11,6,980,981,1,
Zoology,9-ODA and HVA,11,6,984,985,1,
Zoology,9-ODA and HVA,11,6,997,997,0,
Zoology,9-ODA and HVA,11,6,1021,1021,0,
Zoology,9-ODA and HVA,11,6,1022,1027,5,
Zoology,9-ODA and HVA,11,6,1027,1027,0,
Zoology,9-ODA and HVA,11,6,1072,1072,0,
Zoology,9-ODA and HVA,11,6,1079,1079,0,
Zoology,9-ODA and HVA,11,6,1126,1126,0,
Zoology,9-ODA and HVA,11,6,1221,1222,1,
Zoology,9-ODA and HVA,11,6,1260,1260,0,
Zoology,9-ODA and HVA,11,6,1304,1305,1,
Zoology,9-ODA and HVA,11,6,1325,1326,1,
Zoology,9-ODA and HVA,11,6,1362,1362,0,
Zoology,9-ODA and HVA,11,6,1381,1381,0,
Zoology,9-ODA and HVA,11,6,1386,1386,0,not actually touching - almost
Zoology,9-ODA and HVA,11,6,1433,1433,0,
Zoology,9-ODA and HVA,11,6,1453,1453,0,
Zoology,9-ODA and HVA,11,6,1457,1457,0,
Zoology,9-ODA and HVA,11,6,1477,1479,2,
Zoology,9-ODA and HVA,11,6,1477,1479,2,
Zoology,9-ODA and HVA,11,6,1505,1506,1,
Zoology,9-ODA and HVA,11,6,1524,1527,3,
Zoology,9-ODA and HVA,11,6,1529,1531,2,
Zoology,9-ODA and HVA,11,6,1555,1556,1,
Zoology,9-ODA and HVA,11,6,1568,1569,1,
Zoology,9-ODA and HVA,11,6,1579,1579,0,
Zoology,9-ODA and HVA,11,6,1616,1617,1,
Zoology,9-ODA and HVA,11,6,1640,1641,1,
Zoology,9-ODA and HVA,11,6,1644,1644,0,
Zoology,9-ODA and HVA,11,6,1647,1647,0,
Zoology,9-ODA and HVA,11,6,1713,1713,0,
Zoology,9-ODA and HVA,14,7,0,0,0,
Zoology,9-ODA and HVA,14,7,18,19,1,
Zoology,9-ODA and HVA,14,7,32,33,1,
Zoology,9-ODA and HVA,14,7,64,69,5,
Zoology,9-ODA and HVA,14,7,71,75,4,
Zoology,9-ODA and HVA,14,7,107,116,9,
Zoology,9-ODA and HVA,14,7,119,123,4,
Zoology,9-ODA and HVA,14,7,185,192,7,not touching but very interrested
Zoology,9-ODA and HVA,14,7,195,197,2,
Zoology,9-ODA and HVA,14,7,214,220,6,
Zoology,9-ODA and HVA,14,7,219,222,3,
Zoology,9-ODA and HVA,14,7,264,275,11,
Zoology,9-ODA and HVA,14,7,292,294,2,bee being weird right near paper
Zoology,9-ODA and HVA,14,7,341,342,1,
Zoology,9-ODA and HVA,14,7,347,347,0,
Zoology,9-ODA and HVA,14,7,348,351,3,
Zoology,9-ODA and HVA,14,7,351,353,2,
Zoology,9-ODA and HVA,14,7,352,356,4,
Zoology,9-ODA and HVA,14,7,368,368,0,bee touches paper as its turning around
Zoology,9-ODA and HVA,14,7,508,508,0,
Zoology,9-ODA and HVA,14,7,531,535,4,
Zoology,9-ODA and HVA,14,7,666,666,0,
Zoology,9-ODA and HVA,14,7,754,754,0,
Zoology,9-ODA and HVA,14,7,818,819,1,
Zoology,9-ODA and HVA,14,7,827,827,0,bee touches paper as its turning around
Zoology,9-ODA and HVA,14,7,949,953,4,
Zoology,9-ODA and HVA,14,7,1029,1034,5,17:16 when bee walks off paper
Zoology,9-ODA and HVA,14,7,1081,1110,29,
Zoology,9-ODA and HVA,14,7,1124,1127,3,
Zoology,9-ODA and HVA,14,7,1155,1158,3,
Zoology,9-ODA and HVA,14,7,1163,1167,4,
Zoology,9-ODA and HVA,14,7,1242,1668,426,
Zoology,9-ODA and HVA,14,7,1260,1261,1,bee walks over paper
Zoology,9-ODA and HVA,14,7,1343,1344,1,
Zoology,9-ODA and HVA,14,7,1421,1422,1,
Zoology,9-ODA and HVA,14,7,1463,1468,5,
Zoology,9-ODA and HVA,14,7,1554,1554,0,
Zoology,9-ODA and HVA,14,7,1688,1690,2,
Zoology,9-ODA and HVA,14,7,1687,1721,34,
Zoology,9-ODA and HVA,14,7,1747,1762,15,30:00 bee sort of sits motionless facign paper then turns to parallel with paper at 29:22. Not sure if it counts - kinda think it dosen't
Zoology,9-ODA and HVA,18,5,30,32,2,bee sniffs from afar
Zoology,9-ODA and HVA,18,5,37,38,1,
Zoology,9-ODA and HVA,18,5,58,59,1,
Zoology,9-ODA and HVA,18,5,60,63,3,
Zoology,9-ODA and HVA,18,5,62,62,0,
Zoology,9-ODA and HVA,18,5,71,76,5,
Zoology,9-ODA and HVA,18,5,78,82,4,
Zoology,9-ODA and HVA,18,5,82,84,2,
Zoology,9-ODA and HVA,18,5,94,96,2,
Zoology,9-ODA and HVA,18,5,229,230,1,
Zoology,9-ODA and HVA,18,5,314,314,0,
Zoology,9-ODA and HVA,18,5,288,289,1,
Zoology,9-ODA and HVA,18,5,289,355,66,
Zoology,9-ODA and HVA,18,5,353,361,8,bee's butt stays on paper untill 6:03
Zoology,9-ODA and HVA,18,5,374,375,1,
Zoology,9-ODA and HVA,18,5,388,388,0,
Zoology,9-ODA and HVA,18,5,439,441,2,
Zoology,9-ODA and HVA,18,5,479,481,2,
Zoology,9-ODA and HVA,18,5,651,655,4,
Zoology,9-ODA and HVA,18,5,689,691,2,
Zoology,9-ODA and HVA,18,5,770,771,1,
Zoology,9-ODA and HVA,18,5,799,801,2,
Zoology,9-ODA and HVA,18,5,813,813,0,
Zoology,9-ODA and HVA,18,5,876,880,4,
Zoology,9-ODA and HVA,18,5,935,935,0,
Zoology,9-ODA and HVA,18,5,1059,1069,10,
Zoology,9-ODA and HVA,18,5,1080,1080,0,not sure
Zoology,9-ODA and HVA,18,5,1100,1100,0,
Zoology,9-ODA and HVA,18,5,1151,1151,0,
Zoology,9-ODA and HVA,18,5,1218,1221,3,
Zoology,9-ODA and HVA,18,5,1221,1221,0,
Zoology,9-ODA and HVA,18,5,1224,1230,6,
Zoology,9-ODA and HVA,18,5,1315,1316,1,
Zoology,9-ODA and HVA,18,5,1348,1349,1,
Zoology,9-ODA and HVA,18,5,1389,1391,2,
Zoology,9-ODA and HVA,18,5,1456,1456,0,
Zoology,9-ODA and HVA,18,5,1500,1502,2,
Zoology,9-ODA and HVA,18,5,1555,1555,0,
Zoology,9-ODA and HVA,18,5,1560,1562,2,
Zoology,9-ODA and HVA,18,5,1599,1600,1,
Zoology,9-ODA and HVA,18,5,1680,1680,0,
Zoology,9-ODA and HVA,18,5,1745,1747,2,
Zoology,9-ODA and HVA,19,8,14,14,0,
Zoology,9-ODA and HVA,19,8,25,27,2,
Zoology,9-ODA and HVA,19,8,33,33,0,
Zoology,9-ODA and HVA,19,8,107,108,1,
Zoology,9-ODA and HVA,19,8,161,161,0,
Zoology,9-ODA and HVA,19,8,165,165,0,
Zoology,9-ODA and HVA,19,8,186,186,0,
Zoology,9-ODA and HVA,19,8,198,199,1,
Zoology,9-ODA and HVA,19,8,218,221,3,
Zoology,9-ODA and HVA,19,8,236,236,0,
Zoology,9-ODA and HVA,19,8,286,297,11,
Zoology,9-ODA and HVA,19,8,377,378,1,
Zoology,9-ODA and HVA,19,8,385,404,19,
Zoology,9-ODA and HVA,19,8,387,397,10,
Zoology,9-ODA and HVA,19,8,493,494,1,
Zoology,9-ODA and HVA,19,8,506,509,3,
Zoology,9-ODA and HVA,19,8,552,552,0,
Zoology,9-ODA and HVA,19,8,612,615,3,
Zoology,9-ODA and HVA,19,8,627,627,0,
Zoology,9-ODA and HVA,19,8,633,634,1,
Zoology,9-ODA and HVA,19,8,687,687,0,
Zoology,9-ODA and HVA,19,8,690,690,0,
Zoology,9-ODA and HVA,19,8,710,711,1,
Zoology,9-ODA and HVA,19,8,719,719,0,
Zoology,9-ODA and HVA,19,8,727,728,1,
Zoology,9-ODA and HVA,19,8,743,748,5,
Zoology,9-ODA and HVA,19,8,749,750,1,
Zoology,9-ODA and HVA,19,8,826,826,0,
Zoology,9-ODA and HVA,19,8,843,845,2,
Zoology,9-ODA and HVA,19,8,845,846,1,
Zoology,9-ODA and HVA,19,8,1050,1052,2,
Zoology,9-ODA and HVA,19,8,1089,1091,2,
Zoology,9-ODA and HVA,19,8,1124,1129,5,
Zoology,9-ODA and HVA,19,8,1172,1185,13,
Zoology,9-ODA and HVA,19,8,1189,1210,21,
Zoology,9-ODA and HVA,19,8,1227,1228,1,
Zoology,9-ODA and HVA,19,8,1277,1278,1,
Zoology,9-ODA and HVA,19,8,1285,1288,3,
Zoology,9-ODA and HVA,19,8,1299,1300,1,
Zoology,9-ODA and HVA,19,8,1313,1315,2,
Zoology,9-ODA and HVA,19,8,1319,1319,0,
Zoology,9-ODA and HVA,19,8,1326,1329,3,
Zoology,9-ODA and HVA,19,8,1338,1341,3,
Zoology,9-ODA and HVA,19,8,1405,1405,0,
Zoology,9-ODA and HVA,19,8,1428,1428,0,
Zoology,9-ODA and HVA,19,8,1449,1456,7,
Zoology,9-ODA and HVA,19,8,1457,1459,2,
Zoology,9-ODA and HVA,19,8,1465,1466,1,
Zoology,9-ODA and HVA,19,8,1470,1474,4,
Zoology,9-ODA and HVA,19,8,1472,1475,3,
Zoology,9-ODA and HVA,19,8,1488,1492,4,
Zoology,9-ODA and HVA,19,8,1499,1501,2,
Zoology,9-ODA and HVA,19,8,1505,1505,0,
Zoology,9-ODA and HVA,19,8,1526,1527,1,
Zoology,9-ODA and HVA,19,8,1529,1529,0,
Zoology,9-ODA and HVA,19,8,1571,1572,1,
Zoology,9-ODA and HVA,19,8,1601,1602,1,
Zoology,9-ODA and HVA,19,8,1612,1612,0,
Zoology,9-ODA and HVA,19,8,1663,1665,2,
Zoology,9-ODA and HVA,19,8,1667,1667,0,
Zoology,9-ODA and HVA,19,8,1703,1703,0,
Zoology,9-ODA and HVA,19,8,1718,1718,0,
Zoology,9-ODA and HVA,19,8,1751,1751,0,
Zoology,9-ODA and HVA,19,8,1785,1785,0,
Zoology,9-ODA and HVA,23,6,38,39,1,
Zoology,9-ODA and HVA,23,6,53,59,6,
Zoology,9-ODA and HVA,23,6,65,68,3,
Zoology,9-ODA and HVA,23,6,67,80,13,
Zoology,9-ODA and HVA,23,6,82,84,2,
Zoology,9-ODA and HVA,23,6,84,86,2,
Zoology,9-ODA and HVA,23,6,92,97,5,
Zoology,9-ODA and HVA,23,6,99,103,4,
Zoology,9-ODA and HVA,23,6,111,118,7,
Zoology,9-ODA and HVA,23,6,128,131,3,
Zoology,9-ODA and HVA,23,6,143,163,20,
Zoology,9-ODA and HVA,23,6,199,201,2,
Zoology,9-ODA and HVA,23,6,208,214,6,
Zoology,9-ODA and HVA,23,6,212,213,1,
Zoology,9-ODA and HVA,23,6,221,225,4,
Zoology,9-ODA and HVA,23,6,227,231,4,
Zoology,9-ODA and HVA,23,6,241,241,0,
Zoology,9-ODA and HVA,23,6,275,280,5,
Zoology,9-ODA and HVA,23,6,278,278,0,
Zoology,9-ODA and HVA,23,6,303,313,10,
Zoology,9-ODA and HVA,23,6,338,344,6,
Zoology,9-ODA and HVA,23,6,410,421,11,
Zoology,9-ODA and HVA,23,6,423,423,0,
Zoology,9-ODA and HVA,23,6,433,433,0,
Zoology,9-ODA and HVA,23,6,450,453,3,
Zoology,9-ODA and HVA,23,6,467,469,2,
Zoology,9-ODA and HVA,23,6,493,493,0,
Zoology,9-ODA and HVA,23,6,493,498,5,
Zoology,9-ODA and HVA,23,6,513,513,0,
Zoology,9-ODA and HVA,23,6,526,527,1,bee sniffing from afar
Zoology,9-ODA and HVA,23,6,661,668,7,
Zoology,9-ODA and HVA,23,6,710,710,0,bee sniffing from afar (I think)
Zoology,9-ODA and HVA,23,6,764,764,0,
Zoology,9-ODA and HVA,23,6,818,818,0,
Zoology,9-ODA and HVA,23,6,871,881,10,bee sniffing from afar (I think)
Zoology,9-ODA and HVA,23,6,902,913,11,bee sniffing from afar (I think)
Zoology,9-ODA and HVA,23,6,1381,1381,0,
Zoology,9-ODA and HVA,23,6,1389,1390,1,
Zoology,9-ODA and HVA,23,6,1405,1405,0,
Zoology,9-ODA and HVA,23,6,1415,1418,3,bee sniffing from afar (I think)
Zoology,9-ODA and HVA,23,6,1479,1480,1,
Zoology,9-ODA and HVA,23,6,1501,1504,3,
Zoology,9-ODA and HVA,23,6,1508,1508,0,
Zoology,9-ODA and HVA,23,6,1549,1550,1,
Zoology,9-ODA and HVA,23,6,1415,1653,238,"bee sits almost motionless fcting the paper, very close to it. It definitely is interrested from 27:28 to 27:33"
Zoology,9-ODA and HVA,23,6,1655,1655,0,
Zoology,9-ODA and HVA,23,6,1686,1687,1,
Zoology,9-ODA and HVA,23,6,1686,1689,3,
Zoology,9-ODA and HVA,23,6,1753,1753,0,
Zoology,9-ODA and HVA,23,6,1771,1772,1,
Zoology,9-ODA and HVA,23,6,1782,1784,2,
Zoology,9-ODA and HVA,23,6,1792,1792,0,
Zoology,9-ODA and HVA,32,7,3,3,0,
Zoology,9-ODA and HVA,32,7,15,17,2,
Zoology,9-ODA and HVA,32,7,56,56,0,
Zoology,9-ODA and HVA,32,7,89,90,1,
Zoology,9-ODA and HVA,32,7,176,176,0,
Zoology,9-ODA and HVA,32,7,202,204,2,
Zoology,9-ODA and HVA,32,7,321,321,0,
Zoology,9-ODA and HVA,32,7,476,476,0,
Zoology,9-ODA and HVA,32,7,573,573,0,
Zoology,9-ODA and HVA,32,7,626,626,0,
Zoology,9-ODA and HVA,32,7,765,765,0,
Zoology,9-ODA and HVA,32,7,845,845,0,
Zoology,9-ODA and HVA,32,7,1202,1202,0,
Zoology,9-ODA and HVA,32,7,1290,1294,4,
Zoology,9-ODA and HVA,32,7,1318,1318,0,
Zoology,9-ODA and HVA,32,7,1375,1375,0,
Zoology,9-ODA and HVA,32,7,1419,1419,0,
Zoology,9-ODA and HVA,32,7,1441,1442,1,
Zoology,9-ODA and HVA,32,7,1465,1465,0,
Zoology,9-ODA and HVA,32,7,1475,1475,0,
Zoology,9-ODA and HVA,32,7,1710,1710,0,
Zoology,9-ODA and HVA,32,7,1726,1726,0,
Zoology,9-ODA and 9-HDA,4,5,129,130,1,
Zoology,9-ODA and 9-HDA,4,5,363,365,2,
Zoology,9-ODA and 9-HDA,4,5,398,398,0,
Zoology,9-ODA and 9-HDA,4,5,441,441,0,
Zoology,9-ODA and 9-HDA,4,5,542,542,0,
Zoology,9-ODA and 9-HDA,4,5,641,644,3,
Zoology,9-ODA and 9-HDA,4,5,793,794,1,
Zoology,9-ODA and 9-HDA,4,5,831,831,0,
Zoology,9-ODA and 9-HDA,4,5,920,921,1,
Zoology,9-ODA and 9-HDA,4,5,939,939,0,
Zoology,9-ODA and 9-HDA,4,5,1051,1054,3,
Zoology,9-ODA and 9-HDA,4,5,1087,1089,2,
Zoology,9-ODA and 9-HDA,4,5,1127,1129,2,
Zoology,9-ODA and 9-HDA,4,5,1216,1216,0,
Zoology,9-ODA and 9-HDA,4,5,1219,1234,15,
Zoology,9-ODA and 9-HDA,4,5,1236,1243,7,
Zoology,9-ODA and 9-HDA,4,5,1298,1311,13,
Zoology,9-ODA and 9-HDA,4,5,1361,1453,92,bee sits still next to paper with its head not really near the paper but it sniffs it occasionally.
Zoology,9-ODA and 9-HDA,4,5,1461,1474,13,
Zoology,9-ODA and 9-HDA,4,5,1419,1419,0,
Zoology,9-ODA and 9-HDA,4,5,1501,1501,0,
Zoology,9-ODA and 9-HDA,4,5,1501,1503,2,
Zoology,9-ODA and 9-HDA,4,5,1542,1542,0,
Zoology,9-ODA and 9-HDA,4,5,1623,1625,2,
Zoology,9-ODA and 9-HDA,4,5,1626,1627,1,
Zoology,9-ODA and 9-HDA,4,5,1647,1650,3,
Zoology,9-ODA and 9-HDA,4,5,1693,1695,2,
Zoology,9-ODA and 9-HDA,4,5,1703,1704,1,
Zoology,9-ODA and 9-HDA,4,5,1756,1757,1,
Zoology,9-ODA and 9-HDA,4,5,1768,1768,0,
Zoology,9-ODA and 9-HDA,5,9,3,5,2,
Zoology,9-ODA and 9-HDA,5,9,8,8,0,
Zoology,9-ODA and 9-HDA,5,9,12,14,2,
Zoology,9-ODA and 9-HDA,5,9,17,18,1,
Zoology,9-ODA and 9-HDA,5,9,45,45,0,
Zoology,9-ODA and 9-HDA,5,9,37,57,20,bee sort of sniffing from afar maybe
Zoology,9-ODA and 9-HDA,5,9,66,66,0,
Zoology,9-ODA and 9-HDA,5,9,74,76,2,bee sort of sniffing from afar maybe
Zoology,9-ODA and 9-HDA,5,9,78,80,2,
Zoology,9-ODA and 9-HDA,5,9,82,82,0,
Zoology,9-ODA and 9-HDA,5,9,87,89,2,
Zoology,9-ODA and 9-HDA,5,9,131,131,0,
Zoology,9-ODA and 9-HDA,5,9,134,134,0,
Zoology,9-ODA and 9-HDA,5,9,138,138,0,
Zoology,9-ODA and 9-HDA,5,9,138,140,2,
Zoology,9-ODA and 9-HDA,5,9,164,164,0,maybe
Zoology,9-ODA and 9-HDA,5,9,192,192,0,
Zoology,9-ODA and 9-HDA,5,9,197,197,0,
Zoology,9-ODA and 9-HDA,5,9,215,215,0,
Zoology,9-ODA and 9-HDA,5,9,233,233,0,
Zoology,9-ODA and 9-HDA,5,9,193,242,49,
Zoology,9-ODA and 9-HDA,5,9,259,260,1,
Zoology,9-ODA and 9-HDA,5,9,341,344,3,
Zoology,9-ODA and 9-HDA,5,9,365,365,0,
Zoology,9-ODA and 9-HDA,5,9,365,366,1,
Zoology,9-ODA and 9-HDA,5,9,365,366,1,
Zoology,9-ODA and 9-HDA,5,9,407,407,0,
Zoology,9-ODA and 9-HDA,5,9,456,458,2,
Zoology,9-ODA and 9-HDA,5,9,458,459,1,
Zoology,9-ODA and 9-HDA,5,9,460,461,1,
Zoology,9-ODA and 9-HDA,5,9,464,465,1,
Zoology,9-ODA and 9-HDA,5,9,470,471,1,
Zoology,9-ODA and 9-HDA,5,9,486,486,0,
Zoology,9-ODA and 9-HDA,5,9,493,516,23,
Zoology,9-ODA and 9-HDA,5,9,515,515,0,
Zoology,9-ODA and 9-HDA,5,9,519,520,1,
Zoology,9-ODA and 9-HDA,5,9,566,576,10,
Zoology,9-ODA and 9-HDA,5,9,585,585,0,
Zoology,9-ODA and 9-HDA,5,9,625,626,1,
Zoology,9-ODA and 9-HDA,5,9,637,640,3,
Zoology,9-ODA and 9-HDA,5,9,698,698,0,
Zoology,9-ODA and 9-HDA,5,9,694,695,1,
Zoology,9-ODA and 9-HDA,5,9,711,713,2,
Zoology,9-ODA and 9-HDA,5,9,728,729,1,
Zoology,9-ODA and 9-HDA,5,9,745,745,0,
Zoology,9-ODA and 9-HDA,5,9,759,761,2,
Zoology,9-ODA and 9-HDA,5,9,761,761,0,
Zoology,9-ODA and 9-HDA,5,9,794,794,0,
Zoology,9-ODA and 9-HDA,5,9,862,862,0,
Zoology,9-ODA and 9-HDA,5,9,866,866,0,
Zoology,9-ODA and 9-HDA,5,9,878,878,0,
Zoology,9-ODA and 9-HDA,5,9,900,900,0,
Zoology,9-ODA and 9-HDA,5,9,928,928,0,
Zoology,9-ODA and 9-HDA,5,9,930,930,0,
Zoology,9-ODA and 9-HDA,5,9,975,976,1,
Zoology,9-ODA and 9-HDA,5,9,991,991,0,
Zoology,9-ODA and 9-HDA,5,9,999,999,0,
Zoology,9-ODA and 9-HDA,5,9,1009,1009,0,
Zoology,9-ODA and 9-HDA,5,9,1010,1010,0,
Zoology,9-ODA and 9-HDA,5,9,1031,1041,10,
Zoology,9-ODA and 9-HDA,5,9,1048,1049,1,
Zoology,9-ODA and 9-HDA,5,9,1070,1070,0,
Zoology,9-ODA and 9-HDA,5,9,1107,1107,0,
Zoology,9-ODA and 9-HDA,5,9,1128,1128,0,
Zoology,9-ODA and 9-HDA,5,9,1154,1155,1,
Zoology,9-ODA and 9-HDA,5,9,1177,1177,0,
Zoology,9-ODA and 9-HDA,5,9,1182,1187,5,
Zoology,9-ODA and 9-HDA,5,9,1184,1184,0,
Zoology,9-ODA and 9-HDA,5,9,1184,1187,3,
Zoology,9-ODA and 9-HDA,5,9,1240,1245,5,
Zoology,9-ODA and 9-HDA,5,9,1261,1264,3,
Zoology,9-ODA and 9-HDA,5,9,1266,1266,0,
Zoology,9-ODA and 9-HDA,5,9,1296,1296,0,
Zoology,9-ODA and 9-HDA,5,9,1303,1303,0,
Zoology,9-ODA and 9-HDA,5,9,1305,1305,0,
Zoology,9-ODA and 9-HDA,5,9,1333,1335,2,
Zoology,9-ODA and 9-HDA,5,9,1333,1335,2,
Zoology,9-ODA and 9-HDA,5,9,1344,1345,1,
Zoology,9-ODA and 9-HDA,5,9,1346,1347,1,
Zoology,9-ODA and 9-HDA,5,9,1352,1352,0,
Zoology,9-ODA and 9-HDA,5,9,1364,1364,0,
Zoology,9-ODA and 9-HDA,5,9,1369,1370,1,
Zoology,9-ODA and 9-HDA,5,9,1374,1374,0,
Zoology,9-ODA and 9-HDA,5,9,1387,1387,0,
Zoology,9-ODA and 9-HDA,5,9,1425,1425,0,
Zoology,9-ODA and 9-HDA,5,9,1446,1447,1,
Zoology,9-ODA and 9-HDA,5,9,1466,1466,0,
Zoology,9-ODA and 9-HDA,5,9,1529,1532,3,
Zoology,9-ODA and 9-HDA,5,9,1532,1533,1,
Zoology,9-ODA and 9-HDA,5,9,1550,1551,1,
Zoology,9-ODA and 9-HDA,5,9,1556,1556,0,
Zoology,9-ODA and 9-HDA,5,9,1674,1674,0,
Zoology,9-ODA and 9-HDA,5,9,1685,1685,0,
Zoology,9-ODA and 9-HDA,5,9,1714,1714,0,
Zoology,9-ODA and 9-HDA,5,9,1727,1735,8,
Zoology,9-ODA and 9-HDA,5,9,1732,1732,0,
Zoology,9-ODA and 9-HDA,5,9,1746,1748,2,
Zoology,9-ODA and 9-HDA,5,9,1749,1749,0,
Zoology,9-ODA and 9-HDA,5,9,1767,1767,0,
Zoology,9-ODA and 9-HDA,5,9,1773,1773,0,
Zoology,9-ODA and 9-HDA,5,9,1775,1778,3,
Zoology,9-ODA and 9-HDA,6,12,4,5,1,
Zoology,9-ODA and 9-HDA,6,12,50,50,0,
Zoology,9-ODA and 9-HDA,6,12,56,57,1,
Zoology,9-ODA and 9-HDA,6,12,12,13,1,
Zoology,9-ODA and 9-HDA,6,12,150,150,0,bumps in to paper as its turning around
Zoology,9-ODA and 9-HDA,6,12,186,186,0,
Zoology,9-ODA and 9-HDA,6,12,189,190,1,
Zoology,9-ODA and 9-HDA,6,12,263,263,0,
Zoology,9-ODA and 9-HDA,6,12,281,283,2,
Zoology,9-ODA and 9-HDA,6,12,306,307,1,
Zoology,9-ODA and 9-HDA,6,12,400,400,0,
Zoology,9-ODA and 9-HDA,6,12,431,431,0,
Zoology,9-ODA and 9-HDA,6,12,457,458,1,
Zoology,9-ODA and 9-HDA,6,12,489,490,1,
Zoology,9-ODA and 9-HDA,6,12,577,577,0,
Zoology,9-ODA and 9-HDA,6,12,671,672,1,
Zoology,9-ODA and 9-HDA,6,12,682,683,1,
Zoology,9-ODA and 9-HDA,6,12,683,684,1,
Zoology,9-ODA and 9-HDA,6,12,684,685,1,
Zoology,9-ODA and 9-HDA,6,12,690,691,1,
Zoology,9-ODA and 9-HDA,6,12,698,699,1,
Zoology,9-ODA and 9-HDA,6,12,710,712,2,
Zoology,9-ODA and 9-HDA,6,12,714,718,4,bee sort of sniffs as it walks towards paper
Zoology,9-ODA and 9-HDA,6,12,739,740,1,
Zoology,9-ODA and 9-HDA,6,12,746,746,0,
Zoology,9-ODA and 9-HDA,6,12,764,766,2,
Zoology,9-ODA and 9-HDA,6,12,769,770,1,
Zoology,9-ODA and 9-HDA,6,12,783,783,0,
Zoology,9-ODA and 9-HDA,6,12,784,784,0,
Zoology,9-ODA and 9-HDA,6,12,793,793,0,
Zoology,9-ODA and 9-HDA,6,12,821,822,1,
Zoology,9-ODA and 9-HDA,6,12,850,851,1,
Zoology,9-ODA and 9-HDA,6,12,870,876,6,
Zoology,9-ODA and 9-HDA,6,12,872,874,2,
Zoology,9-ODA and 9-HDA,6,12,913,915,2,
Zoology,9-ODA and 9-HDA,6,12,918,918,0,bumps in to paper as its turning around
Zoology,9-ODA and 9-HDA,6,12,922,923,1,
Zoology,9-ODA and 9-HDA,6,12,937,937,0,
Zoology,9-ODA and 9-HDA,6,12,978,978,0,
Zoology,9-ODA and 9-HDA,6,12,1006,1017,11,bee sits a little distance form the paper
Zoology,9-ODA and 9-HDA,6,12,1116,1117,1,
Zoology,9-ODA and 9-HDA,6,12,1128,1128,0,
Zoology,9-ODA and 9-HDA,6,12,1144,1153,9,
Zoology,9-ODA and 9-HDA,6,12,1154,1157,3,
Zoology,9-ODA and 9-HDA,6,12,1179,1180,1,
Zoology,9-ODA and 9-HDA,6,12,1216,1217,1,
Zoology,9-ODA and 9-HDA,6,12,645,1246,601,
Zoology,9-ODA and 9-HDA,6,12,1262,1262,0,
Zoology,9-ODA and 9-HDA,6,12,1272,1273,1,
Zoology,9-ODA and 9-HDA,6,12,1276,1277,1,
Zoology,9-ODA and 9-HDA,6,12,1305,1306,1,
Zoology,9-ODA and 9-HDA,6,12,1392,1392,0,
Zoology,9-ODA and 9-HDA,6,12,1409,1411,2,
Zoology,9-ODA and 9-HDA,6,12,1424,1425,1,
Zoology,9-ODA and 9-HDA,6,12,1433,1434,1,
Zoology,9-ODA and 9-HDA,6,12,1443,1444,1,
Zoology,9-ODA and 9-HDA,6,12,1476,1476,0,
Zoology,9-ODA and 9-HDA,6,12,1591,1594,3,
Zoology,9-ODA and 9-HDA,6,12,1615,1615,0,
Zoology,9-ODA and 9-HDA,6,12,1710,1710,0,
Zoology,9-ODA and 9-HDA,6,12,1727,1730,3,
Zoology,9-ODA and 9-HDA,6,12,1731,1732,1,
Zoology,9-ODA and 9-HDA,6,12,543,543,0,
Zoology,9-ODA and 9-HDA,7,2,44,44,0,
Zoology,9-ODA and 9-HDA,7,2,52,53,1,
Zoology,9-ODA and 9-HDA,7,2,66,70,4,
Zoology,9-ODA and 9-HDA,7,2,113,113,0,
Zoology,9-ODA and 9-HDA,7,2,137,139,2,
Zoology,9-ODA and 9-HDA,7,2,149,150,1,
Zoology,9-ODA and 9-HDA,7,2,196,196,0,
Zoology,9-ODA and 9-HDA,7,2,271,272,1,
Zoology,9-ODA and 9-HDA,7,2,275,276,1,
Zoology,9-ODA and 9-HDA,7,2,297,298,1,
Zoology,9-ODA and 9-HDA,7,2,300,301,1,
Zoology,9-ODA and 9-HDA,7,2,313,313,0,
Zoology,9-ODA and 9-HDA,7,2,325,325,0,
Zoology,9-ODA and 9-HDA,7,2,342,344,2,
Zoology,9-ODA and 9-HDA,7,2,378,379,1,
Zoology,9-ODA and 9-HDA,7,2,384,384,0,
Zoology,9-ODA and 9-HDA,7,2,402,403,1,
Zoology,9-ODA and 9-HDA,7,2,404,404,0,
Zoology,9-ODA and 9-HDA,7,2,407,410,3,
Zoology,9-ODA and 9-HDA,7,2,451,453,2,
Zoology,9-ODA and 9-HDA,7,2,483,483,0,
Zoology,9-ODA and 9-HDA,7,2,517,518,1,
Zoology,9-ODA and 9-HDA,7,2,522,522,0,
Zoology,9-ODA and 9-HDA,7,2,503,563,60,
Zoology,9-ODA and 9-HDA,7,2,587,587,0,
Zoology,9-ODA and 9-HDA,7,2,598,600,2,
Zoology,9-ODA and 9-HDA,7,2,613,613,0,
Zoology,9-ODA and 9-HDA,7,2,645,645,0,
Zoology,9-ODA and 9-HDA,7,2,657,658,1,
Zoology,9-ODA and 9-HDA,7,2,672,672,0,
Zoology,9-ODA and 9-HDA,7,2,755,755,0,
Zoology,9-ODA and 9-HDA,7,2,759,764,5,
Zoology,9-ODA and 9-HDA,7,2,787,789,2,
Zoology,9-ODA and 9-HDA,7,2,819,819,0,
Zoology,9-ODA and 9-HDA,7,2,839,840,1,
Zoology,9-ODA and 9-HDA,7,2,851,851,0,
Zoology,9-ODA and 9-HDA,7,2,878,884,6,
Zoology,9-ODA and 9-HDA,7,2,930,931,1,
Zoology,9-ODA and 9-HDA,7,2,948,948,0,
Zoology,9-ODA and 9-HDA,7,2,1e3,1001,1,
Zoology,9-ODA and 9-HDA,7,2,1005,1006,1,
Zoology,9-ODA and 9-HDA,7,2,952,1014,62,
Zoology,9-ODA and 9-HDA,7,2,1043,1044,1,
Zoology,9-ODA and 9-HDA,7,2,1094,1095,1,
Zoology,9-ODA and 9-HDA,7,2,1097,1097,0,
Zoology,9-ODA and 9-HDA,7,2,1131,1132,1,
Zoology,9-ODA and 9-HDA,7,2,1172,1173,1,
Zoology,9-ODA and 9-HDA,7,2,1184,1184,0,
Zoology,9-ODA and 9-HDA,7,2,1226,1227,1,
Zoology,9-ODA and 9-HDA,7,2,1239,1239,0,
Zoology,9-ODA and 9-HDA,7,2,1249,1249,0,
Zoology,9-ODA and 9-HDA,7,2,1310,1311,1,
Zoology,9-ODA and 9-HDA,7,2,1314,1315,1,
Zoology,9-ODA and 9-HDA,7,2,1402,1403,1,
Zoology,9-ODA and 9-HDA,7,2,1419,1421,2,
Zoology,9-ODA and 9-HDA,7,2,1424,1426,2,
Zoology,9-ODA and 9-HDA,7,2,1425,1427,2,
Zoology,9-ODA and 9-HDA,7,2,1468,1469,1,
Zoology,9-ODA and 9-HDA,7,2,1490,1490,0,
Zoology,9-ODA and 9-HDA,7,2,1506,1506,0,
Zoology,9-ODA and 9-HDA,7,2,1539,1539,0,
Zoology,9-ODA and 9-HDA,7,2,1539,1539,0,
Zoology,9-ODA and 9-HDA,7,2,1564,1564,0,
Zoology,9-ODA and 9-HDA,7,2,1566,1566,0,
Zoology,9-ODA and 9-HDA,7,2,1631,1632,1,
Zoology,9-ODA and 9-HDA,7,2,1725,1725,0,
Zoology,9-ODA and 9-HDA,8,1,81,81,0,seems to sort of bump into paper
Zoology,9-ODA and 9-HDA,8,1,98,101,3,
Zoology,9-ODA and 9-HDA,8,1,98,100,2,
Zoology,9-ODA and 9-HDA,8,1,73,134,61,
Zoology,9-ODA and 9-HDA,8,1,194,200,6,
Zoology,9-ODA and 9-HDA,8,1,235,243,8,
Zoology,9-ODA and 9-HDA,8,1,251,251,0,
Zoology,9-ODA and 9-HDA,8,1,265,267,2,
Zoology,9-ODA and 9-HDA,8,1,278,278,0,
Zoology,9-ODA and 9-HDA,8,1,362,363,1,
Zoology,9-ODA and 9-HDA,8,1,379,381,2,
Zoology,9-ODA and 9-HDA,8,1,426,426,0,
Zoology,9-ODA and 9-HDA,8,1,435,441,6,
Zoology,9-ODA and 9-HDA,8,1,478,479,1,
Zoology,9-ODA and 9-HDA,8,1,493,493,0,
Zoology,9-ODA and 9-HDA,8,1,516,516,0,
Zoology,9-ODA and 9-HDA,8,1,542,545,3,
Zoology,9-ODA and 9-HDA,8,1,562,562,0,
Zoology,9-ODA and 9-HDA,8,1,618,619,1,
Zoology,9-ODA and 9-HDA,8,1,667,667,0,"very breif touch, maybe not a proper touch"
Zoology,9-ODA and 9-HDA,8,1,714,714,0,
Zoology,9-ODA and 9-HDA,8,1,727,727,0,
Zoology,9-ODA and 9-HDA,8,1,733,733,0,
Zoology,9-ODA and 9-HDA,8,1,738,738,0,"very breif touch, maybe not a proper touch"
Zoology,9-ODA and 9-HDA,8,1,772,772,0,
Zoology,9-ODA and 9-HDA,8,1,805,805,0,
Zoology,9-ODA and 9-HDA,8,1,819,819,0,
Zoology,9-ODA and 9-HDA,8,1,822,823,1,
Zoology,9-ODA and 9-HDA,8,1,849,850,1,
Zoology,9-ODA and 9-HDA,8,1,883,883,0,
Zoology,9-ODA and 9-HDA,8,1,896,897,1,
Zoology,9-ODA and 9-HDA,8,1,971,971,0,
Zoology,9-ODA and 9-HDA,8,1,983,983,0,
Zoology,9-ODA and 9-HDA,8,1,1022,1026,4,
Zoology,9-ODA and 9-HDA,8,1,1035,1044,9,not quite touching seems interrested
Zoology,9-ODA and 9-HDA,8,1,1030,1031,1,
Zoology,9-ODA and 9-HDA,8,1,1061,1061,0,Not very sure - quick touch
Zoology,9-ODA and 9-HDA,8,1,1133,1134,1,
Zoology,9-ODA and 9-HDA,8,1,1152,1152,0,Not very sure - quick touch
Zoology,9-ODA and 9-HDA,8,1,1155,1155,0,
Zoology,9-ODA and 9-HDA,8,1,1172,1172,0,
Zoology,9-ODA and 9-HDA,8,1,1197,1197,0,
Zoology,9-ODA and 9-HDA,8,1,1214,1215,1,
Zoology,9-ODA and 9-HDA,8,1,1232,1234,2,
Zoology,9-ODA and 9-HDA,8,1,1355,1355,0,
Zoology,9-ODA and 9-HDA,8,1,1360,1360,0,
Zoology,9-ODA and 9-HDA,8,1,1386,1387,1,
Zoology,9-ODA and 9-HDA,8,1,1387,1389,2,
Zoology,9-ODA and 9-HDA,8,1,1397,1399,2,
Zoology,9-ODA and 9-HDA,8,1,1421,1422,1,
Zoology,9-ODA and 9-HDA,8,1,1505,1505,0,
Zoology,9-ODA and 9-HDA,8,1,1507,1507,0,
Zoology,9-ODA and 9-HDA,8,1,1531,1532,1,
Zoology,9-ODA and 9-HDA,8,1,1551,1552,1,
Zoology,9-ODA and 9-HDA,8,1,1595,1598,3,bee walks over paper
Zoology,9-ODA and 9-HDA,8,1,1613,1616,3,bee walks around paper - moves it a bit not really sniffing
Zoology,9-ODA and 9-HDA,8,1,1622,1622,0,
Zoology,9-ODA and 9-HDA,8,1,1689,1691,2,
Zoology,9-ODA and 9-HDA,8,1,1784,1784,0,
Zoology,9-ODA and 9-HDA,9,4,6,6,0,
Zoology,9-ODA and 9-HDA,9,4,24,24,0,
Zoology,9-ODA and 9-HDA,9,4,48,48,0,
Zoology,9-ODA and 9-HDA,9,4,69,69,0,
Zoology,9-ODA and 9-HDA,9,4,81,81,0,"maybe, seems to bump in to paper as it turns around"
Zoology,9-ODA and 9-HDA,9,4,129,129,0,
Zoology,9-ODA and 9-HDA,9,4,145,148,3,
Zoology,9-ODA and 9-HDA,9,4,145,146,1,
Zoology,9-ODA and 9-HDA,9,4,203,204,1,
Zoology,9-ODA and 9-HDA,9,4,231,231,0,
Zoology,9-ODA and 9-HDA,9,4,267,267,0,
Zoology,9-ODA and 9-HDA,9,4,320,320,0,
Zoology,9-ODA and 9-HDA,9,4,438,438,0,very fast touch - maybe dosen't count
Zoology,9-ODA and 9-HDA,9,4,472,472,0,
Zoology,9-ODA and 9-HDA,9,4,561,561,0,
Zoology,9-ODA and 9-HDA,9,4,566,566,0,
Zoology,9-ODA and 9-HDA,9,4,611,613,2,
Zoology,9-ODA and 9-HDA,9,4,613,613,0,
Zoology,9-ODA and 9-HDA,9,4,663,663,0,
Zoology,9-ODA and 9-HDA,9,4,661,667,6,
Zoology,9-ODA and 9-HDA,9,4,736,738,2,
Zoology,9-ODA and 9-HDA,9,4,771,772,1,
Zoology,9-ODA and 9-HDA,9,4,772,773,1,
Zoology,9-ODA and 9-HDA,9,4,771,774,3,
Zoology,9-ODA and 9-HDA,9,4,776,776,0,
Zoology,9-ODA and 9-HDA,9,4,778,778,0,
Zoology,9-ODA and 9-HDA,9,4,781,781,0,
Zoology,9-ODA and 9-HDA,9,4,788,788,0,
Zoology,9-ODA and 9-HDA,9,4,830,830,0,
Zoology,9-ODA and 9-HDA,9,4,847,848,1,
Zoology,9-ODA and 9-HDA,9,4,858,858,0,
Zoology,9-ODA and 9-HDA,9,4,868,911,43,bee sort of sniffing from afar - erring on the side of not counting it
Zoology,9-ODA and 9-HDA,9,4,952,953,1,
Zoology,9-ODA and 9-HDA,9,4,956,956,0,
Zoology,9-ODA and 9-HDA,9,4,986,988,2,
Zoology,9-ODA and 9-HDA,9,4,989,990,1,
Zoology,9-ODA and 9-HDA,9,4,996,997,1,
Zoology,9-ODA and 9-HDA,9,4,1001,1001,0,
Zoology,9-ODA and 9-HDA,9,4,1022,1025,3,
Zoology,9-ODA and 9-HDA,9,4,1086,1087,1,
Zoology,9-ODA and 9-HDA,9,4,1098,1098,0,
Zoology,9-ODA and 9-HDA,9,4,1165,1166,1,
Zoology,9-ODA and 9-HDA,9,4,1171,1171,0,
Zoology,9-ODA and 9-HDA,9,4,1206,1206,0,maybe
Zoology,9-ODA and 9-HDA,9,4,638,639,1,
Zoology,9-ODA and 9-HDA,9,4,1256,1256,0,
Zoology,9-ODA and 9-HDA,9,4,1294,1295,1,
Zoology,9-ODA and 9-HDA,9,4,1316,1316,0,
Zoology,9-ODA and 9-HDA,9,4,1339,1341,2,
Zoology,9-ODA and 9-HDA,9,4,1370,1371,1,
Zoology,9-ODA and 9-HDA,9,4,1404,1406,2,
Zoology,9-ODA and 9-HDA,9,4,1449,1451,2,
Zoology,9-ODA and 9-HDA,9,4,1538,1539,1,
Zoology,9-ODA and 9-HDA,9,4,1602,1602,0,
Zoology,9-ODA and 9-HDA,9,4,1671,1673,2,
Zoology,9-ODA and 9-HDA,9,4,1679,1680,1,
Zoology,9-ODA and 9-HDA,9,4,1663,1671,8,maybe - quite far from the paper. maybe sniffing
Zoology,9-ODA and 9-HDA,9,4,1683,1693,10,maybe - same bee as previous entry
Zoology,9-ODA and 9-HDA,9,4,1700,1700,0,maybe
Zoology,9-ODA and 9-HDA,9,4,1775,1777,2,
Zoology,9-ODA and 9-HDA,11,4,32,32,0,
Zoology,9-ODA and 9-HDA,11,4,37,38,1,
Zoology,9-ODA and 9-HDA,11,4,50,51,1,
Zoology,9-ODA and 9-HDA,11,4,125,126,1,
Zoology,9-ODA and 9-HDA,11,4,126,126,0,
Zoology,9-ODA and 9-HDA,11,4,137,138,1,
Zoology,9-ODA and 9-HDA,11,4,190,190,0,
Zoology,9-ODA and 9-HDA,11,4,287,288,1,
Zoology,9-ODA and 9-HDA,11,4,308,308,0,
Zoology,9-ODA and 9-HDA,11,4,348,350,2,
Zoology,9-ODA and 9-HDA,11,4,354,354,0,
Zoology,9-ODA and 9-HDA,11,4,362,362,0,
Zoology,9-ODA and 9-HDA,11,4,375,375,0,
Zoology,9-ODA and 9-HDA,11,4,451,452,1,
Zoology,9-ODA and 9-HDA,11,4,478,478,0,
Zoology,9-ODA and 9-HDA,11,4,488,490,2,
Zoology,9-ODA and 9-HDA,11,4,591,591,0,
Zoology,9-ODA and 9-HDA,11,4,608,608,0,
Zoology,9-ODA and 9-HDA,11,4,649,649,0,
Zoology,9-ODA and 9-HDA,11,4,689,689,0,
Zoology,9-ODA and 9-HDA,11,4,748,748,0,
Zoology,9-ODA and 9-HDA,11,4,765,765,0,
Zoology,9-ODA and 9-HDA,11,4,792,792,0,
Zoology,9-ODA and 9-HDA,11,4,817,818,1,
Zoology,9-ODA and 9-HDA,11,4,876,876,0,
Zoology,9-ODA and 9-HDA,11,4,877,877,0,
Zoology,9-ODA and 9-HDA,11,4,884,893,9,
Zoology,9-ODA and 9-HDA,11,4,921,921,0,
Zoology,9-ODA and 9-HDA,11,4,937,1036,99,bee sitting kinda still a little distance from paper
Zoology,9-ODA and 9-HDA,11,4,948,949,1,
Zoology,9-ODA and 9-HDA,11,4,952,952,0,
Zoology,9-ODA and 9-HDA,11,4,974,976,2,
Zoology,9-ODA and 9-HDA,11,4,1002,1003,1,
Zoology,9-ODA and 9-HDA,11,4,1045,1082,37,bee sitting kinda still a little distance from paper
Zoology,9-ODA and 9-HDA,11,4,1047,1048,1,
Zoology,9-ODA and 9-HDA,11,4,1088,1089,1,
Zoology,9-ODA and 9-HDA,11,4,1164,1164,0,
Zoology,9-ODA and 9-HDA,11,4,1295,1296,1,
Zoology,9-ODA and 9-HDA,11,4,1298,1301,3,
Zoology,9-ODA and 9-HDA,11,4,1457,1464,7,
Zoology,9-ODA and 9-HDA,11,4,1489,1490,1,maybe - walking past the paper - seems a little interrested
Zoology,9-ODA and 9-HDA,11,4,1521,1521,0,
Zoology,9-ODA and 9-HDA,11,4,1523,1525,2,bee sort of seems interrested - not touching
Zoology,9-ODA and 9-HDA,11,4,1534,1534,0,
Zoology,9-ODA and 9-HDA,11,4,1538,1538,0,
Zoology,9-ODA and 9-HDA,11,4,1546,1546,0,
Zoology,9-ODA and 9-HDA,11,4,1547,1547,0,
Zoology,9-ODA and 9-HDA,11,4,1554,1554,0,
Zoology,9-ODA and 9-HDA,11,4,1619,1619,0,
Zoology,9-ODA and 9-HDA,11,4,1693,1694,1,
Zoology,9-ODA and 9-HDA,11,4,1732,1732,0,
Zoology,9-ODA and 9-HDA,11,4,1744,1744,0,
Zoology,9-ODA and 9-HDA,14,11,5,5,0,
Zoology,9-ODA and 9-HDA,14,11,120,120,0,
Zoology,9-ODA and 9-HDA,14,11,122,122,0,
Zoology,9-ODA and 9-HDA,14,11,131,131,0,
Zoology,9-ODA and 9-HDA,14,11,149,150,1,
Zoology,9-ODA and 9-HDA,14,11,159,160,1,
Zoology,9-ODA and 9-HDA,14,11,215,215,0,maybe bumps in to paper
Zoology,9-ODA and 9-HDA,14,11,236,242,6,
Zoology,9-ODA and 9-HDA,14,11,238,239,1,
Zoology,9-ODA and 9-HDA,14,11,249,249,0,
Zoology,9-ODA and 9-HDA,14,11,326,326,0,
Zoology,9-ODA and 9-HDA,14,11,462,469,7,
Zoology,9-ODA and 9-HDA,14,11,528,528,0,
Zoology,9-ODA and 9-HDA,14,11,636,636,0,
Zoology,9-ODA and 9-HDA,14,11,665,665,0,maybe bumps in to paper
Zoology,9-ODA and 9-HDA,14,11,715,716,1,
Zoology,9-ODA and 9-HDA,14,11,742,742,0,
Zoology,9-ODA and 9-HDA,14,11,806,807,1,
Zoology,9-ODA and 9-HDA,14,11,849,852,3,
Zoology,9-ODA and 9-HDA,14,11,869,873,4,
Zoology,9-ODA and 9-HDA,14,11,989,991,2,
Zoology,9-ODA and 9-HDA,14,11,1046,1046,0,
Zoology,9-ODA and 9-HDA,14,11,1128,1128,0,
Zoology,9-ODA and 9-HDA,14,11,1246,1246,0,
Zoology,9-ODA and 9-HDA,14,11,1354,1357,3,
Zoology,9-ODA and 9-HDA,14,11,1371,1379,8,
Zoology,9-ODA and 9-HDA,14,11,1382,1389,7,
Zoology,9-ODA and 9-HDA,14,11,1392,1393,1,
Zoology,9-ODA and 9-HDA,14,11,1418,1418,0,maybe bumps in to paper
Zoology,9-ODA and 9-HDA,14,11,1534,1535,1,
Zoology,9-ODA and 9-HDA,14,11,1556,1558,2,bee sniffs from afar
Zoology,9-ODA and 9-HDA,14,11,1561,1561,0,
Zoology,9-ODA and 9-HDA,14,11,1578,1578,0,bee sniffs from afar
Zoology,9-ODA and 9-HDA,14,11,1641,1642,1,
Zoology,9-ODA and 9-HDA,14,11,1734,1735,1,
Zoology,9-ODA and 9-HDA,14,11,1761,1762,1,
Zoology,9-ODA and 9-HDA,14,11,1783,1783,0,maybe bumps in to paper
Zoology,9-ODA and 9-HDA,14,11,1792,1793,1,
Zoology,9-ODA and 9-HDA,18,4,5,10,5,
Zoology,9-ODA and 9-HDA,18,4,15,18,3,
Zoology,9-ODA and 9-HDA,18,4,21,25,4,
Zoology,9-ODA and 9-HDA,18,4,56,56,0,
Zoology,9-ODA and 9-HDA,18,4,119,121,2,
Zoology,9-ODA and 9-HDA,18,4,145,149,4,
Zoology,9-ODA and 9-HDA,18,4,204,206,2,
Zoology,9-ODA and 9-HDA,18,4,254,260,6,bee's butt stays on paper until 4:27
Zoology,9-ODA and 9-HDA,18,4,293,295,2,
Zoology,9-ODA and 9-HDA,18,4,310,315,5,
Zoology,9-ODA and 9-HDA,18,4,486,486,0,
Zoology,9-ODA and 9-HDA,18,4,506,509,3,
Zoology,9-ODA and 9-HDA,18,4,667,667,0,bee walks in to paper as it goes past
Zoology,9-ODA and 9-HDA,18,4,670,670,0,
Zoology,9-ODA and 9-HDA,18,4,815,816,1,
Zoology,9-ODA and 9-HDA,18,4,843,843,0,
Zoology,9-ODA and 9-HDA,18,4,848,850,2,
Zoology,9-ODA and 9-HDA,18,4,936,936,0,
Zoology,9-ODA and 9-HDA,18,4,947,947,0,
Zoology,9-ODA and 9-HDA,18,4,956,960,4,bee sniffs and then walks around the edge of the paper
Zoology,9-ODA and 9-HDA,18,4,965,966,1,
Zoology,9-ODA and 9-HDA,18,4,973,973,0,
Zoology,9-ODA and 9-HDA,18,4,981,981,0,
Zoology,9-ODA and 9-HDA,18,4,1002,1008,6,
Zoology,9-ODA and 9-HDA,18,4,1120,1125,5,
Zoology,9-ODA and 9-HDA,18,4,1150,1152,2,
Zoology,9-ODA and 9-HDA,18,4,1165,1170,5,
Zoology,9-ODA and 9-HDA,18,4,1183,1183,0,
Zoology,9-ODA and 9-HDA,18,4,1270,1273,3,
Zoology,9-ODA and 9-HDA,18,4,1288,1288,0,
Zoology,9-ODA and 9-HDA,18,4,1326,1330,4,
Zoology,9-ODA and 9-HDA,18,4,1405,1406,1,
Zoology,9-ODA and 9-HDA,18,4,1441,1442,1,bee walks over paper
Zoology,9-ODA and 9-HDA,18,4,1455,1456,1,
Zoology,9-ODA and 9-HDA,18,4,1528,1531,3,
Zoology,9-ODA and 9-HDA,18,4,1628,1631,3,
Zoology,9-ODA and 9-HDA,18,4,1648,1650,2,
Zoology,9-ODA and 9-HDA,18,4,1708,1710,2,
Zoology,9-ODA and 9-HDA,18,4,1759,1764,5,
Zoology,9-ODA and 9-HDA,19,12,4,8,4,
Zoology,9-ODA and 9-HDA,19,12,36,39,3,
Zoology,9-ODA and 9-HDA,19,12,38,38,0,
Zoology,9-ODA and 9-HDA,19,12,55,55,0,
Zoology,9-ODA and 9-HDA,19,12,82,82,0,
Zoology,9-ODA and 9-HDA,19,12,99,100,1,
Zoology,9-ODA and 9-HDA,19,12,116,117,1,
Zoology,9-ODA and 9-HDA,19,12,146,147,1,
Zoology,9-ODA and 9-HDA,19,12,166,167,1,
Zoology,9-ODA and 9-HDA,19,12,188,188,0,
Zoology,9-ODA and 9-HDA,19,12,197,198,1,
Zoology,9-ODA and 9-HDA,19,12,203,205,2,
Zoology,9-ODA and 9-HDA,19,12,217,218,1,
Zoology,9-ODA and 9-HDA,19,12,309,309,0,
Zoology,9-ODA and 9-HDA,19,12,313,313,0,
Zoology,9-ODA and 9-HDA,19,12,332,333,1,
Zoology,9-ODA and 9-HDA,19,12,361,365,4,
Zoology,9-ODA and 9-HDA,19,12,436,437,1,
Zoology,9-ODA and 9-HDA,19,12,467,470,3,
Zoology,9-ODA and 9-HDA,19,12,485,486,1,
Zoology,9-ODA and 9-HDA,19,12,515,515,0,
Zoology,9-ODA and 9-HDA,19,12,529,529,0,
Zoology,9-ODA and 9-HDA,19,12,553,554,1,
Zoology,9-ODA and 9-HDA,19,12,559,559,0,
Zoology,9-ODA and 9-HDA,19,12,559,560,1,
Zoology,9-ODA and 9-HDA,19,12,591,594,3,
Zoology,9-ODA and 9-HDA,19,12,598,600,2,
Zoology,9-ODA and 9-HDA,19,12,616,616,0,
Zoology,9-ODA and 9-HDA,19,12,705,706,1,
Zoology,9-ODA and 9-HDA,19,12,752,752,0,
Zoology,9-ODA and 9-HDA,19,12,771,772,1,
Zoology,9-ODA and 9-HDA,19,12,781,782,1,
Zoology,9-ODA and 9-HDA,19,12,795,795,0,
Zoology,9-ODA and 9-HDA,19,12,813,814,1,
Zoology,9-ODA and 9-HDA,19,12,817,817,0,
Zoology,9-ODA and 9-HDA,19,12,820,823,3,
Zoology,9-ODA and 9-HDA,19,12,832,833,1,
Zoology,9-ODA and 9-HDA,19,12,837,837,0,
Zoology,9-ODA and 9-HDA,19,12,844,845,1,
Zoology,9-ODA and 9-HDA,19,12,850,852,2,
Zoology,9-ODA and 9-HDA,19,12,853,854,1,
Zoology,9-ODA and 9-HDA,19,12,877,877,0,
Zoology,9-ODA and 9-HDA,19,12,900,903,3,
Zoology,9-ODA and 9-HDA,19,12,906,906,0,
Zoology,9-ODA and 9-HDA,19,12,935,936,1,
Zoology,9-ODA and 9-HDA,19,12,946,947,1,
Zoology,9-ODA and 9-HDA,19,12,971,971,0,
Zoology,9-ODA and 9-HDA,19,12,979,979,0,
Zoology,9-ODA and 9-HDA,19,12,995,997,2,
Zoology,9-ODA and 9-HDA,19,12,1002,1004,2,
Zoology,9-ODA and 9-HDA,19,12,1018,1018,0,
Zoology,9-ODA and 9-HDA,19,12,1018,1019,1,
Zoology,9-ODA and 9-HDA,19,12,1053,1054,1,
Zoology,9-ODA and 9-HDA,19,12,1064,1065,1,
Zoology,9-ODA and 9-HDA,19,12,1116,1121,5,
Zoology,9-ODA and 9-HDA,19,12,1162,1162,0,
Zoology,9-ODA and 9-HDA,19,12,1167,1172,5,
Zoology,9-ODA and 9-HDA,19,12,1166,1166,0,
Zoology,9-ODA and 9-HDA,19,12,1172,1172,0,
Zoology,9-ODA and 9-HDA,19,12,1214,1216,2,
Zoology,9-ODA and 9-HDA,19,12,1233,1234,1,
Zoology,9-ODA and 9-HDA,19,12,1245,1246,1,
Zoology,9-ODA and 9-HDA,19,12,1275,1275,0,
Zoology,9-ODA and 9-HDA,19,12,1318,1318,0,
Zoology,9-ODA and 9-HDA,19,12,1398,1401,3,
Zoology,9-ODA and 9-HDA,19,12,1420,1420,0,
Zoology,9-ODA and 9-HDA,19,12,1428,1429,1,
Zoology,9-ODA and 9-HDA,19,12,1437,1437,0,
Zoology,9-ODA and 9-HDA,19,12,1456,1456,0,
Zoology,9-ODA and 9-HDA,19,12,1475,1475,0,
Zoology,9-ODA and 9-HDA,19,12,1497,1497,0,
Zoology,9-ODA and 9-HDA,19,12,1544,1548,4,
Zoology,9-ODA and 9-HDA,19,12,1577,1578,1,
Zoology,9-ODA and 9-HDA,19,12,1578,1581,3,
Zoology,9-ODA and 9-HDA,19,12,1584,1584,0,
Zoology,9-ODA and 9-HDA,19,12,1594,1594,0,
Zoology,9-ODA and 9-HDA,19,12,1617,1620,3,
Zoology,9-ODA and 9-HDA,19,12,1631,1633,2,
Zoology,9-ODA and 9-HDA,19,12,1694,1694,0,
Zoology,9-ODA and 9-HDA,19,12,1733,1735,2,
Zoology,9-ODA and 9-HDA,19,12,1773,1775,2,
Zoology,9-ODA and 9-HDA,23,8,0,2,2,
Zoology,9-ODA and 9-HDA,23,8,2,2,0,
Zoology,9-ODA and 9-HDA,23,8,17,17,0,
Zoology,9-ODA and 9-HDA,23,8,21,24,3,
Zoology,9-ODA and 9-HDA,23,8,55,58,3,
Zoology,9-ODA and 9-HDA,23,8,80,80,0,
Zoology,9-ODA and 9-HDA,23,8,0,84,84,bee sits still (mostly) facing the paper very close
Zoology,9-ODA and 9-HDA,23,8,89,92,3,
Zoology,9-ODA and 9-HDA,23,8,124,131,7,
Zoology,9-ODA and 9-HDA,23,8,138,141,3,
Zoology,9-ODA and 9-HDA,23,8,186,193,7,
Zoology,9-ODA and 9-HDA,23,8,194,294,100,
Zoology,9-ODA and 9-HDA,23,8,317,420,103,
Zoology,9-ODA and 9-HDA,23,8,438,444,6,
Zoology,9-ODA and 9-HDA,23,8,448,450,2,
Zoology,9-ODA and 9-HDA,23,8,455,463,8,
Zoology,9-ODA and 9-HDA,23,8,466,470,4,
Zoology,9-ODA and 9-HDA,23,8,477,479,2,
Zoology,9-ODA and 9-HDA,23,8,486,486,0,
Zoology,9-ODA and 9-HDA,23,8,498,503,5,
Zoology,9-ODA and 9-HDA,23,8,541,548,7,
Zoology,9-ODA and 9-HDA,23,8,556,563,7,
Zoology,9-ODA and 9-HDA,23,8,570,573,3,
Zoology,9-ODA and 9-HDA,23,8,648,648,0,
Zoology,9-ODA and 9-HDA,23,8,669,670,1,
Zoology,9-ODA and 9-HDA,23,8,683,687,4,
Zoology,9-ODA and 9-HDA,23,8,670,697,27,
Zoology,9-ODA and 9-HDA,23,8,702,703,1,
Zoology,9-ODA and 9-HDA,23,8,709,711,2,
Zoology,9-ODA and 9-HDA,23,8,713,716,3,
Zoology,9-ODA and 9-HDA,23,8,742,742,0,
Zoology,9-ODA and 9-HDA,23,8,758,758,0,
Zoology,9-ODA and 9-HDA,23,8,887,887,0,
Zoology,9-ODA and 9-HDA,23,8,1288,1289,1,
Zoology,9-ODA and 9-HDA,23,8,1296,1297,1,
Zoology,9-ODA and 9-HDA,23,8,1068,1332,264,bee sits pretty much motionless facing the paper (not sure if it counts at all - i'm tempted to say no though)
Zoology,9-ODA and 9-HDA,23,8,1339,1600,261,"26:17 to 26:40 bee is definitely interrested, otherwise it just sort of sits there - occasionally snifgfing the paper next to it"
Zoology,9-ODA and 9-HDA,23,8,1345,1345,0,
Zoology,9-ODA and 9-HDA,23,8,1405,1406,1,
Zoology,9-ODA and 9-HDA,23,8,1439,1441,2,
Zoology,9-ODA and 9-HDA,23,8,1472,1472,0,
Zoology,9-ODA and 9-HDA,23,8,1476,1476,0,
Zoology,9-ODA and 9-HDA,23,8,1593,1595,2,
Zoology,9-ODA and 9-HDA,23,8,1594,1599,5,
Zoology,9-ODA and 9-HDA,23,8,1594,1594,0,
Zoology,9-ODA and 9-HDA,23,8,1655,1655,0,
Zoology,9-ODA and 9-HDA,23,8,1665,1666,1,
Zoology,9-ODA and 9-HDA,23,8,1671,1673,2,
Zoology,9-ODA and 9-HDA,23,8,1675,1675,0,
Zoology,9-ODA and 9-HDA,23,8,1701,1701,0,
Zoology,9-ODA and 9-HDA,23,8,1705,1706,1,
Zoology,9-ODA and 9-HDA,23,8,1730,1736,6,
Zoology,9-ODA and 9-HDA,23,8,1738,1740,2,
Zoology,9-ODA and 9-HDA,32,3,43,43,0,
Zoology,9-ODA and 9-HDA,32,3,44,44,0,
Zoology,9-ODA and 9-HDA,32,3,79,79,0,
Zoology,9-ODA and 9-HDA,32,3,104,110,6,
Zoology,9-ODA and 9-HDA,32,3,153,153,0,
Zoology,9-ODA and 9-HDA,32,3,206,206,0,
Zoology,9-ODA and 9-HDA,32,3,206,209,3,
Zoology,9-ODA and 9-HDA,32,3,258,259,1,
Zoology,9-ODA and 9-HDA,32,3,281,283,2,
Zoology,9-ODA and 9-HDA,32,3,298,298,0,
Zoology,9-ODA and 9-HDA,32,3,334,334,0,
Zoology,9-ODA and 9-HDA,32,3,369,369,0,
Zoology,9-ODA and 9-HDA,32,3,434,434,0,
Zoology,9-ODA and 9-HDA,32,3,500,500,0,
Zoology,9-ODA and 9-HDA,32,3,510,511,1,
Zoology,9-ODA and 9-HDA,32,3,541,543,2,
Zoology,9-ODA and 9-HDA,32,3,543,545,2,
Zoology,9-ODA and 9-HDA,32,3,549,551,2,
Zoology,9-ODA and 9-HDA,32,3,556,556,0,
Zoology,9-ODA and 9-HDA,32,3,632,632,0,
Zoology,9-ODA and 9-HDA,32,3,699,699,0,
Zoology,9-ODA and 9-HDA,32,3,711,713,2,
Zoology,9-ODA and 9-HDA,32,3,807,810,3,at this point paper is moved from the centre bees sort of just start crawling all over it I will not record all the times it was trampled over- just the ones where bees actually stopped and sniffed
Zoology,9-ODA and 9-HDA,32,3,817,847,30,bee sits on top of it
Zoology,9-ODA and 9-HDA,32,3,858,858,0,
Zoology,9-ODA and 9-HDA,32,3,861,865,4,
Zoology,9-ODA and 9-HDA,32,3,866,866,0,
Zoology,9-ODA and 9-HDA,32,3,885,894,9,
Zoology,9-ODA and 9-HDA,32,3,902,1042,140,Bee sits on it
Zoology,9-ODA and 9-HDA,32,3,943,943,0,bee approaches other bee sitting on it probs doesn't count
Zoology,9-ODA and 9-HDA,32,3,993,993,0,two bees walsk over it probs shouldn't count
Zoology,9-ODA and 9-HDA,32,3,1141,1147,6,
Zoology,9-ODA and 9-HDA,32,3,1206,1216,10,
Zoology,9-ODA and 9-HDA,32,3,1247,1247,0,
Zoology,9-ODA and 9-HDA,32,3,1323,1330,7,bee kind of rubs on it
